Variant	Num_Cells	Total_Coverage	Ref_Count	Alt_Count	Median_Coverage	Median_Ref	Median_Alt
chr1:35715733:G:T	18	29	7	22	2.0	0.0	2.0
chr1:46280445:GGCACTATCCAGG:C	38	38	25	13	1.0	1.0	0.0
chr1:89186404:CCATTTGGGCC:TGAGTTGAGCT	7	13	1	12	2	0	2
chr2:216482821:A:T	31	32	30	2	1	1	0
chr3:52406883:C:T	9	9	9	0	1	1	0
chr3:56682981:G:T	322	331	331	0	1.0	1.0	0.0
chr4:150849453:AGTA:CGTC	14	14	14	0	1.0	1.0	0.0
chr5:169717426:T:C	40	43	37	6	1.0	1.0	0.0
chr6:30620004:T:G	22	22	22	0	1.0	1.0	0.0
chr9:136496196:CAG:C	10	10	10	0	1.0	1.0	0.0
chr9:136496531:TG:T	3	3	3	0	1	1	0
chr11:489716:C:T	26	34	18	16	1.0	1.0	0.0
chr11:57699108:C:T	13	15	11	4	1	1	0
chr11:129885576:C:T	66	105	28	77	2.0	0.0	2.0
chr12:76348326:C:T	16	17	15	2	1.0	1.0	0.0
chr13:95186762:A:G	8	10	6	4	1.0	1.0	0.0
chr15:56094707:A:G	8	8	8	0	1.0	1.0	0.0
chr15:60423668:T:C	53	74	32	42	1	1	0
chr16:75093653:G:A	2	2	2	0	1.0	1.0	0.0
chr16:85921247:TC:T	1103	1243	1243	0	1	1	0
chr17:5433630:C:G	0	0	0	0	0	0	0
chr19:47260390:T:A	47	49	45	4	1	1	0
chr22:31621683:G:T	14	17	11	6	1.0	1.0	0.0
chrX:47185449:C:T	43	45	43	2	1	1	0
chrX:47513106:G:A	5	5	5	0	1	1	0
chrX:77593702:T:G	33	33	33	0	1	1	0
chrX:101356176:C:G	271	284	282	2	1	1	0
chrX:101356177:A:T	271	284	284	0	1	1	0
