Variant	Num_Cells	Total_Coverage	Ref_Count	Alt_Count	Median_Coverage	Median_Ref	Median_Alt
chr1:35715733:G:T	4	7	1	6	2.0	0.0	2.0
chr1:46280445:GGCACTATCCAGG:C	11	11	11	0	1	1	0
chr1:89186404:CCATTTGGGCC:TGAGTTGAGCT	7	13	1	12	2	0	2
chr2:216482821:A:T	8	12	4	8	1.5	0.5	1.0
chr3:52406883:C:T	5	6	4	2	1	1	0
chr3:56682981:G:T	194	247	153	94	1.0	1.0	0.0
chr4:150849453:AGTA:CGTC	19	19	19	0	1	1	0
chr5:169717426:T:C	28	38	18	20	1.0	1.0	0.0
chr6:30620004:T:G	40	49	33	16	1.0	1.0	0.0
chr9:136496196:CAG:C	13	13	13	0	1	1	0
chr9:136496531:TG:T	5	5	5	0	1	1	0
chr11:489716:C:T	8	8	8	0	1.0	1.0	0.0
chr11:57699108:C:T	26	35	17	18	1.0	1.0	0.0
chr11:129885576:C:T	43	62	24	38	1	1	0
chr12:76348326:C:T	10	12	8	4	1.0	1.0	0.0
chr13:95186762:A:G	1	2	0	2	2	0	2
chr15:56094707:A:G	7	7	7	0	1	1	0
chr15:60423668:T:C	19	33	9	24	2	0	2
chr16:75093653:G:A	0	0	0	0	0	0	0
chr16:85921247:TC:T	494	507	507	0	1.0	1.0	0.0
chr17:5433630:C:G	3	3	3	0	1	1	0
chr19:47260390:T:A	53	73	33	40	1	1	0
chr22:31621683:G:T	5	8	2	6	2	0	2
chrX:47185449:C:T	38	59	17	42	2.0	0.0	2.0
chrX:47513106:G:A	3	3	3	0	1	1	0
chrX:77593702:T:G	14	15	13	2	1.0	1.0	0.0
chrX:101356176:C:G	72	83	59	24	1.0	1.0	0.0
chrX:101356177:A:T	72	134	36	98	2.0	0.0	2.0
