Variant	Num_Cells	Total_Coverage	Ref_Count	Alt_Count	Median_Coverage	Median_Ref	Median_Alt
chr1:212858832:A:G	49	76	22	54	2	0	2
chr1:219983198:A:T	130	136	132	4	1.0	1.0	0.0
chr2:8682348:G:A	2	7	7	0	3.5	3.5	0.0
chr2:197402110:T:C	276	415	149	266	1.0	1.0	0.0
chr2:197402661:A:G	260	268	264	4	1.0	1.0	0.0
chr5:32724780:C:T	0	0	0	0	0	0	0
chr5:151804116:A:G	323	337	327	10	1	1	0
chr5:154870705:C:T	238	247	243	4	1.0	1.0	0.0
chr5:157731485:C:T	451	696	281	415	1	1	0
chr6:44262573:T:G	175	183	179	4	1	1	0
chr7:124863616:G:C	40	59	21	38	1.0	1.0	0.0
chr8:143868474:G:C	0	0	0	0	0	0	0
chr9:136496196:CAG:C	15	15	15	0	1	1	0
chr11:46703142:G:C	26	33	19	14	1.0	1.0	0.0
chr13:43859914:C:T	125	130	128	2	1	1	0
chr19:1049321:G:C	13	14	12	2	1	1	0
chr20:34260506:A:G	117	148	94	54	1	1	0
chr20:43460759:G:A	305	461	179	282	1	1	0
chr20:49884011:C:T	2	2	2	0	1.0	1.0	0.0
chrX:101356176:C:G	441	462	462	0	1	1	0
