Variant	Num_Cells	Total_Coverage	Ref_Count	Alt_Count	Median_Coverage	Median_Ref	Median_Alt
chr1:212858832:A:G	40	46	34	12	1.0	1.0	0.0
chr1:219983198:A:T	96	125	75	50	1.0	1.0	0.0
chr2:8682348:G:A	45	87	87	0	1	1	0
chr2:197402110:T:C	174	220	130	90	1.0	1.0	0.0
chr2:197402661:A:G	149	176	122	54	1	1	0
chr5:32724780:C:T	14	15	15	0	1.0	1.0	0.0
chr5:151804116:A:G	296	381	251	130	1.0	1.0	0.0
chr5:154870705:C:T	173	209	147	62	1	1	0
chr5:157731485:C:T	320	414	262	152	1.0	1.0	0.0
chr6:44262573:T:G	83	85	81	4	1	1	0
chr7:124863616:G:C	19	23	15	8	1	1	0
chr8:143868474:G:C	1	2	0	2	2	0	2
chr9:136496196:CAG:C	19	19	19	0	1	1	0
chr11:46703142:G:C	15	16	14	2	1	1	0
chr13:43859914:C:T	127	158	118	40	1	1	0
chr19:1049321:G:C	10	11	9	2	1.0	1.0	0.0
chr20:34260506:A:G	59	67	57	10	1	1	0
chr20:43460759:G:A	244	331	185	146	1.0	1.0	0.0
chr20:49884011:C:T	2	3	1	2	1.5	0.5	1.0
chrX:101356176:C:G	395	558	268	290	1	1	0
