Variant	Num_Cells	Total_Coverage	Ref_Count	Alt_Count	Median_Coverage	Median_Ref	Median_Alt
chr4:65366041:T:C	0	0	0	0	0	0	0
chr12:79621131:G:C	49	76	22	54	2	0	2
chrX:101356176:C:G	52	99	11	88	2.0	0.0	2.0
chr1:36890980:T:A	1	1	1	0	1	1	0
chr1:186112887:A:G	0	0	0	0	0	0	0
chr1:203179514:G:A	0	0	0	0	0	0	0
chr2:234067247:A:T	0	0	0	0	0	0	0
chr2:238083327:G:A	5	7	3	4	1	1	0
chr3:50367810:A:C	24	28	22	6	1.0	1.0	0.0
chr4:40822095:C:T	4	5	3	2	1.0	1.0	0.0
chr4:89248652:T:TC	0	0	0	0	0	0	0
chr6:87530795:G:A	83	101	71	30	1	1	0
chr6:151458475:T:G	73	92	60	32	1	1	0
chr8:48043111:G:A	100	111	95	16	1.0	1.0	0.0
chr10:51074754:C:G	0	0	0	0	0	0	0
chr11:71982927:A:T	3	3	3	0	1	1	0
chr14:95132586:T:A	216	260	192	68	1.0	1.0	0.0
chr14:98972958:C:T	40	41	41	0	1.0	1.0	0.0
chr16:4114739:T:G	1	1	1	0	1	1	0
chr16:31464985:G:C	6	7	5	2	1.0	1.0	0.0
chr17:38719464:C:T	0	0	0	0	0	0	0
chr19:53912807:C:T	0	0	0	0	0	0	0
chr20:38969205:G:C	166	202	138	64	1.0	1.0	0.0
chr22:27860231:G:A	79	103	71	32	1	1	0
chr22:50197987:C:A	298	336	292	44	1.0	1.0	0.0
chrX:85271447:A:T	0	0	0	0	0	0	0
chrX:116172511:G:T	0	0	0	0	0	0	0
chrX:153778017:C:A	0	0	0	0	0	0	0
chr2:151869276:CAG:C	0	0	0	0	0	0	0
chr14:64468996:A:G	3	3	3	0	1	1	0
chrX:101356177:A:T	53	109	90	19	2	2	0
