Variant	Num_Cells	Total_Coverage	Ref_Count	Alt_Count	Median_Coverage	Median_Ref	Median_Alt
chr1:54241493:G:A	19	26	12	14	1	1	0
chr1:91719454:T:G	6	9	3	6	1.5	0.5	1.0
chr1:151287589:G:A	7	13	1	12	2	0	2
chr1:169424851:A:T	1	2	0	2	2	0	2
chr2:27615191:C:A	89	143	53	90	1	1	0
chr2:96500832:G:A	6	7	5	2	1.0	1.0	0.0
chr2:197402637:T:C	130	193	77	116	1.0	1.0	0.0
chr2:218664014:T:G	104	110	109	1	1.0	1.0	0.0
chr2:219381982:T:A	234	336	150	186	1.0	1.0	0.0
chr3:25601189:C:G	116	169	75	94	1.0	1.0	0.0
chr3:51638407:T:C	1	2	0	2	2	0	2
chr3:138235062:A:T	389	602	228	374	1	1	0
chr3:142524133:C:T	9	12	6	6	1	1	0
chr4:1238298:C:T	9	9	9	0	1	1	0
chr4:128107869:T:A	1	1	1	0	1	1	0
chr5:71549572:A:C	32	46	18	28	1.0	1.0	0.0
chr7:98194383:C:T	9	10	8	2	1	1	0
chr7:108184304:A:T	6	12	0	12	2.0	0.0	2.0
chr8:38968625:A:T	73	133	15	118	2	0	2
chr8:76983244:G:A	469	751	281	470	2	1	0
chr8:99111158:A:T	110	168	66	102	1.0	1.0	0.0
chr8:106770027:C:T	3	4	2	2	1	1	0
chr8:144829244:G:A	23	35	13	22	1	1	0
chr9:15459912:T:C	39	54	24	30	1	1	0
chr9:100253132:A:T	13	19	7	12	1	1	0
chr9:120913454:C:A	14	21	7	14	1.5	0.5	1.0
chr9:128922324:A:G	2	4	0	4	2.0	0.0	2.0
chr10:73125214:C:G	12	19	5	14	2.0	0.0	2.0
chr10:92311217:A:G	340	507	239	268	1.0	1.0	0.0
chr10:119932231:G:A	35	47	25	22	1	1	0
chr11:57332463:C:T	92	143	59	84	1.0	1.0	0.0
chr11:65116599:G:A	103	148	68	80	1	1	0
chr11:65209811:G:T	2	3	1	2	1.5	0.5	1.0
chr11:66859019:C:T	3	4	2	2	1	1	0
chr11:86278401:G:A	136	197	81	116	1.0	1.0	0.0
chr12:26656510:C:A	68	93	45	48	1.0	1.0	0.0
chr12:30729110:T:A	12	16	8	8	1.0	1.0	0.0
chr12:46364583:T:A	26	41	13	28	2.0	0.5	2.0
chr12:48838010:C:T	231	333	158	175	1	1	0
chr12:49037629:T:G	12	20	6	14	1.5	0.5	1.0
chr12:54241871:T:C	344	504	236	268	1.0	1.0	0.0
chr12:103735495:T:C	0	0	0	0	0	0	0
chr12:112193067:C:T	3	6	0	6	2	0	2
chr12:117467144:G:T	3	5	1	4	2	0	2
chr12:121253254:GAGGC:G	1	1	0	1	1	0	1
chr13:52377370:T:A	4	6	2	4	1.5	0.5	1.0
chr13:98797224:A:C	12	12	12	0	1.0	1.0	0.0
chr14:81143485:A:G	2	3	1	2	1.5	0.5	1.0
chr15:43416490:A:G	11	15	7	8	1	1	0
chr16:2530308:G:C	24	40	8	32	2.0	0.0	2.0
chr16:3738580:A:C	215	296	160	136	1	1	0
chr16:14552056:A:T	77	108	52	56	1	1	0
chr16:48561666:T:A	459	770	260	510	2	1	2
chr16:56408005:AGCCGGTGATGGAGCAGAC:G	210	220	133	87	1.0	1.0	0.0
chr16:57458190:C:A	5	5	5	0	1	1	0
chr17:1812060:C:A	63	87	43	44	1	1	0
chr17:79833995:GC:G	221	241	150	91	1	1	0
chr19:7632415:C:T	10	18	2	16	2.0	0.0	2.0
chr19:10110359:C:A	104	119	99	20	1.0	1.0	0.0
chr19:39839009:G:A	10	19	5	14	1.5	0.5	1.0
chr19:45072143:G:A	48	86	12	74	2.0	0.0	2.0
chr19:49118375:A:C	284	491	123	368	2.0	0.0	2.0
chr20:25012617:G:A	29	41	17	24	1	1	0
chr20:32434620:G:GGCCA	4	4	2	2	1.0	0.5	0.5
chr20:62315160:C:T	2	3	1	2	1.5	0.5	1.0
chr22:29050724:G:A	9	14	4	10	2	0	2
chr22:29561592:G:T	231	323	151	172	1	1	0
chrX:101356176:C:G	191	376	32	344	2	0	2
chrX:119759185:G:A	43	71	17	54	2	0	2
