Variant	Num_Cells	Total_Coverage	Ref_Count	Alt_Count	Median_Coverage	Median_Ref	Median_Alt
chr1:54241493:G:A	32	44	20	24	1.0	1.0	0.0
chr1:91719454:T:G	16	17	17	0	1.0	1.0	0.0
chr1:151287589:G:A	2	2	2	0	1.0	1.0	0.0
chr1:169424851:A:T	0	0	0	0	0	0	0
chr2:27615191:C:A	74	106	45	61	1.0	1.0	0.0
chr2:96500832:G:A	0	0	0	0	0	0	0
chr2:197402637:T:C	160	170	166	4	1.0	1.0	0.0
chr2:218664014:T:G	80	82	80	2	1.0	1.0	0.0
chr2:219381982:T:A	185	233	147	86	1	1	0
chr3:25601189:C:G	211	227	217	10	1	1	0
chr3:51638407:T:C	3	3	3	0	1	1	0
chr3:138235062:A:T	384	493	325	168	1.0	1.0	0.0
chr3:142524133:C:T	8	8	8	0	1.0	1.0	0.0
chr4:1238298:C:T	7	8	6	2	1	1	0
chr4:128107869:T:A	6	6	6	0	1.0	1.0	0.0
chr5:71549572:A:C	26	37	15	22	1.0	1.0	0.0
chr7:98194383:C:T	9	10	8	2	1	1	0
chr7:108184304:A:T	4	8	0	8	2.0	0.0	2.0
chr8:38968625:A:T	63	68	60	8	1	1	0
chr8:76983244:G:A	366	466	316	150	1.0	1.0	0.0
chr8:99111158:A:T	76	82	74	8	1.0	1.0	0.0
chr8:106770027:C:T	0	0	0	0	0	0	0
chr8:144829244:G:A	28	31	27	4	1.0	1.0	0.0
chr9:15459912:T:C	69	72	72	0	1	1	0
chr9:100253132:A:T	11	11	11	0	1	1	0
chr9:120913454:C:A	23	28	22	6	1	1	0
chr9:128922324:A:G	0	0	0	0	0	0	0
chr10:73125214:C:G	12	12	12	0	1.0	1.0	0.0
chr10:92311217:A:G	245	263	247	16	1	1	0
chr10:119932231:G:A	54	82	32	50	2.0	1.0	0.0
chr11:57332463:C:T	102	166	49	117	2.0	0.0	2.0
chr11:65116599:G:A	56	80	36	44	1.0	1.0	0.0
chr11:65209811:G:T	7	9	5	4	1	1	0
chr11:66859019:C:T	7	9	5	4	1	1	0
chr11:86278401:G:A	106	114	106	8	1.0	1.0	0.0
chr12:26656510:C:A	56	66	48	18	1.0	1.0	0.0
chr12:30729110:T:A	23	26	22	4	1	1	0
chr12:46364583:T:A	34	38	36	2	1.0	1.0	0.0
chr12:48838010:C:T	306	344	326	18	1.0	1.0	0.0
chr12:49037629:T:G	9	9	9	0	1	1	0
chr12:54241871:T:C	296	328	314	14	1.0	1.0	0.0
chr12:103735495:T:C	1	2	0	2	2	0	2
chr12:112193067:C:T	1	1	1	0	1	1	0
chr12:117467144:G:T	2	4	0	4	2.0	0.0	2.0
chr12:121253254:GAGGC:G	2	2	1	1	1.0	0.5	0.5
chr13:52377370:T:A	6	6	6	0	1.0	1.0	0.0
chr13:98797224:A:C	16	19	13	6	1.0	1.0	0.0
chr14:81143485:A:G	1	1	1	0	1	1	0
chr15:43416490:A:G	4	5	3	2	1.0	1.0	0.0
chr16:2530308:G:C	33	41	25	16	1	1	0
chr16:3738580:A:C	222	237	225	12	1.0	1.0	0.0
chr16:14552056:A:T	114	126	116	10	1.0	1.0	0.0
chr16:48561666:T:A	323	493	203	290	1	1	0
chr16:56408005:AGCCGGTGATGGAGCAGAC:G	242	249	196	53	1.0	1.0	0.0
chr16:57458190:C:A	5	5	5	0	1	1	0
chr17:1812060:C:A	73	74	74	0	1	1	0
chr17:79833995:GC:G	211	225	175	50	1	1	0
chr19:7632415:C:T	10	13	7	6	1.0	1.0	0.0
chr19:10110359:C:A	102	103	103	0	1.0	1.0	0.0
chr19:39839009:G:A	9	9	9	0	1	1	0
chr19:45072143:G:A	59	106	24	82	2	0	2
chr19:49118375:A:C	256	421	131	290	2.0	0.5	2.0
chr20:25012617:G:A	42	47	37	10	1.0	1.0	0.0
chr20:32434620:G:GGCCA	7	7	3	4	1	0	1
chr20:62315160:C:T	0	0	0	0	0	0	0
chr22:29050724:G:A	3	5	1	4	2	0	2
chr22:29561592:G:T	170	180	170	10	1.0	1.0	0.0
chrX:101356176:C:G	430	463	463	0	1.0	1.0	0.0
chrX:119759185:G:A	115	127	110	17	1	1	0
