Variant	Num_Cells	Num_Alt_Cells	Total_Coverage	Ref_Count	Alt_Count	Median_Coverage	Median_Ref	Median_Alt
1:137825:G:A	0	0	0	0	0	0	0	0
1:970920:G:A	0	0	0	0	0	0	0	0
1:979472:G:C	0	0	0	0	0	0	0	0
1:979560:T:C	0	0	0	0	0	0	0	0
1:1084003:C:T	1	0	1	1	0	1	1	0
1:1142994:G:A	0	0	0	0	0	0	0	0
1:1176209:C:T	0	0	0	0	0	0	0	0
1:1281314:G:A	0	0	0	0	0	0	0	0
1:1310993:G:A	1	1	1	0	1	1	0	1
1:1454394:C:A	0	0	0	0	0	0	0	0
1:1455495:C:T	0	0	0	0	0	0	0	0
1:1468434:C:T	0	0	0	0	0	0	0	0
1:1482624:T:C	0	0	0	0	0	0	0	0
1:1486151:C:A	4	1	4	3	1	1.0	1.0	0.0
1:1487887:A:G	6	4	8	3	5	1.0	0.0	1.0
1:1490320:T:C	5	3	5	2	3	1	0	1
1:1495605:C:T	7	4	8	4	4	1	0	1
1:1626874:G:A	2	2	2	0	2	1.0	0.0	1.0
1:2408761:T:C	95	55	102	42	60	1	0	1
1:2487186:C:T	1	0	1	1	0	1	1	0
1:2499178:C:T	1	0	1	1	0	1	1	0
1:2502461:C:T	0	0	0	0	0	0	0	0
1:2521130:T:C	17	9	19	9	10	1	0	1
1:2559503:C:A	5	3	6	2	4	1	0	1
1:2595307:A:G	0	0	0	0	0	0	0	0
1:2641760:A:G	0	0	0	0	0	0	0	0
1:3067523:C:A	0	0	0	0	0	0	0	0
1:3385157:C:T	0	0	0	0	0	0	0	0
1:3473163:C:T	0	0	0	0	0	0	0	0
1:3478475:G:A	0	0	0	0	0	0	0	0
1:3505333:A:G	0	0	0	0	0	0	0	0
1:3508619:G:A	1	1	1	0	1	1	0	1
1:3595370:A:G	0	0	0	0	0	0	0	0
1:3627623:C:T	20	11	28	17	11	1.0	0.0	1.0
1:3635228:G:A	7	1	9	8	1	1	1	0
1:3729573:C:T	0	0	0	0	0	0	0	0
1:3729628:G:A	0	0	0	0	0	0	0	0
1:3729650:T:C	0	0	0	0	0	0	0	0
1:3761369:T:C	0	0	0	0	0	0	0	0
1:3836572:A:T	9	1	14	12	2	1	1	0
1:3844915:C:T	4	3	7	1	6	1.0	0.0	1.0
1:3847652:C:T	1	1	1	0	1	1	0	1
1:5866447:T:C	1	0	1	1	0	1	1	0
1:5867109:G:A	0	0	0	0	0	0	0	0
1:5905321:C:T	0	0	0	0	0	0	0	0
1:6098502:A:G	13	7	14	7	7	1	0	1
1:6144101:G:A	0	0	0	0	0	0	0	0
1:6445611:G:A	0	0	0	0	0	0	0	0
1:6633037:A:G	1	0	1	1	0	1	1	0
1:6645884:C:T	7	2	11	9	2	1	1	0
1:6651086:T:C	1	0	2	2	0	2	2	0
1:6887657:C:T	78	27	93	59	34	1.0	1.0	0.0
1:7809988:T:C	0	0	0	0	0	0	0	0
1:7827433:T:C	0	0	0	0	0	0	0	0
1:7852969:A:G	0	0	0	0	0	0	0	0
1:7853385:C:T	0	0	0	0	0	0	0	0
1:8951551:G:A	0	0	0	0	0	0	0	0
1:9264611:A:G	0	0	0	0	0	0	0	0
1:9582366:G:C	5	3	10	5	5	1	0	1
1:10258594:C:G	0	0	0	0	0	0	0	0
1:10375266:C:A	1	1	1	0	1	1	0	1
1:10399722:G:A	1	1	1	0	1	1	0	1
1:10400428:T:C	343	192	437	189	248	1	0	1
1:10413139:C:T	15	8	16	8	8	1	0	1
1:10419621:G:A	0	0	0	0	0	0	0	0
1:10469269:A:G	319	180	431	211	220	1	0	1
1:11256187:C:G	16	6	30	20	10	2.0	1.5	0.0
1:11501107:G:A	2	2	2	0	2	1.0	0.0	1.0
1:11519447:G:C	0	0	0	0	0	0	0	0
1:11529854:G:A	0	0	0	0	0	0	0	0
1:11536398:C:T	0	0	0	0	0	0	0	0
1:11711931:A:G	0	0	0	0	0	0	0	0
1:11768181:G:A	0	0	0	0	0	0	0	0
1:11771558:C:T	0	0	0	0	0	0	0	0
1:11772232:C:A	0	0	0	0	0	0	0	0
1:11775499:C:T	0	0	0	0	0	0	0	0
1:11778952:C:T	0	0	0	0	0	0	0	0
1:11778977:G:A	0	0	0	0	0	0	0	0
1:11779866:C:T	0	0	0	0	0	0	0	0
1:11794749:G:A	5	4	12	4	8	3	0	1
1:11803000:G:A	54	25	58	32	26	1.0	1.0	0.0
1:11838802:G:A	0	0	0	0	0	0	0	0
1:12191751:T:G	0	0	0	0	0	0	0	0
1:12580622:C:T	0	0	0	0	0	0	0	0
1:12725527:T:G	0	0	0	0	0	0	0	0
1:12725782:C:T	0	0	0	0	0	0	0	0
1:12794279:C:T	0	0	0	0	0	0	0	0
1:12794395:T:C	0	0	0	0	0	0	0	0
1:12838910:C:T	0	0	0	0	0	0	0	0
1:12838922:CACT:GACA	0	0	0	0	0	0	0	0
1:13105548:G:A	0	0	0	0	0	0	0	0
1:13475969:G:A	0	0	0	0	0	0	0	0
1:13595905:A:G	0	0	0	0	0	0	0	0
1:13778644:T:A	39	14	86	55	31	1	1	0
1:13778803:G:A	19	9	35	16	19	1	1	0
1:13782619:A:G	47	12	50	38	12	1	1	0
1:14180562:A:G	0	0	0	0	0	0	0	0
1:15112494:G:A	0	0	0	0	0	0	0	0
1:15164369:T:A	0	0	0	0	0	0	0	0
1:15191973:G:A	0	0	0	0	0	0	0	0
1:15219581:G:A	0	0	0	0	0	0	0	0
1:15324566:A:G	0	0	0	0	0	0	0	0
1:15327067:C:T	0	0	0	0	0	0	0	0
1:15341780:G:A	0	0	0	0	0	0	0	0
1:15467418:G:A	0	0	0	0	0	0	0	0
1:15507865:A:G	2	1	6	5	1	3.0	2.5	0.5
1:15565920:A:C	8	4	18	7	11	1.0	0.5	0.5
1:15577823:C:T	15	8	15	7	8	1	0	1
1:15579006:G:A	39	17	103	54	49	2	1	0
1:15583249:C:T	68	32	82	46	36	1.0	1.0	0.0
1:15633482:C:T	4	2	11	2	9	1.5	0.5	1.0
1:15660052:T:C	4	2	22	17	5	3.0	1.0	0.5
1:15716271:T:C	2	0	2	2	0	1.0	1.0	0.0
1:15717906:G:A	3	3	3	0	3	1	0	1
1:15718592:C:T	4	0	5	5	0	1.0	1.0	0.0
1:15729869:G:A	8	3	8	5	3	1.0	1.0	0.0
1:15737916:T:C	0	0	0	0	0	0	0	0
1:15743149:C:T	0	0	0	0	0	0	0	0
1:15770439:C:T	0	0	0	0	0	0	0	0
1:15933318:A:G	9	7	24	11	13	2	0	1
1:15944765:G:A	10	5	11	6	5	1.0	0.5	0.5
1:16024780:A:G	0	0	0	0	0	0	0	0
1:16030006:G:A	0	0	0	0	0	0	0	0
1:16035421:G:A	0	0	0	0	0	0	0	0
1:16053748:A:G	0	0	0	0	0	0	0	0
1:16053757:C:T	0	0	0	0	0	0	0	0
1:16057247:C:G	0	0	0	0	0	0	0	0
1:16062531:T:C	0	0	0	0	0	0	0	0
1:16125272:G:A	0	0	0	0	0	0	0	0
1:16133250:G:A	0	0	0	0	0	0	0	0
1:16206308:G:A	35	21	40	14	26	1	0	1
1:16207760:C:G	0	0	0	0	0	0	0	0
1:16208151:C:G	0	0	0	0	0	0	0	0
1:16409637:T:C	0	0	0	0	0	0	0	0
1:16486487:A:C	25	19	63	21	42	2	0	1
1:16648142:T:C	0	0	0	0	0	0	0	0
1:16649698:C:T	1	0	1	1	0	1	1	0
1:16975285:A:G	0	0	0	0	0	0	0	0
1:16986662:G:A	0	0	0	0	0	0	0	0
1:16986848:G:A	3	2	3	1	2	1	0	1
1:16987159:C:T	4	2	5	3	2	1.0	0.5	0.5
1:16988447:G:A	3	2	3	1	2	1	0	1
1:17070208:T:C	0	0	0	0	0	0	0	0
1:17079314:G:A	0	0	0	0	0	0	0	0
1:17223626:G:A	0	0	0	0	0	0	0	0
1:17224403:A:T	0	0	0	0	0	0	0	0
1:17249150:A:C	0	0	0	0	0	0	0	0
1:17266821:G:A	0	0	0	0	0	0	0	0
1:17282953:G:T	0	0	0	0	0	0	0	0
1:17331121:T:C	0	0	0	0	0	0	0	0
1:17334004:G:C	0	0	0	0	0	0	0	0
1:17334633:A:C	0	0	0	0	0	0	0	0
1:17336167:T:C	0	0	0	0	0	0	0	0
1:17348042:C:A	0	0	0	0	0	0	0	0
1:17413090:G:A	6	2	7	5	2	1.0	1.0	0.0
1:17587562:G:A	0	0	0	0	0	0	0	0
1:18481444:C:A	0	0	0	0	0	0	0	0
1:18481459:C:A	0	0	0	0	0	0	0	0
1:18483990:GAA:AAC	0	0	0	0	0	0	0	0
1:18872954:G:T	2	0	3	3	0	1.5	1.5	0.0
1:18875462:A:G	1	0	1	1	0	1	1	0
1:18876423:T:C	0	0	0	0	0	0	0	0
1:18876432:T:C	0	0	0	0	0	0	0	0
1:19086767:T:A	16	6	33	18	15	1.0	1.0	0.0
1:19088810:C:T	19	9	20	10	10	1	1	0
1:19106955:A:G	3	2	3	1	2	1	0	1
1:19110691:G:T	0	0	0	0	0	0	0	0
1:19121349:C:G	4	1	14	3	11	1.0	1.0	0.0
1:19173066:T:C	5	1	6	5	1	1	1	0
1:19257142:C:T	226	107	392	207	185	1.0	1.0	0.0
1:19284733:G:A	0	0	0	0	0	0	0	0
1:19920383:C:T	0	0	0	0	0	0	0	0
1:19923569:G:C	0	0	0	0	0	0	0	0
1:19978433:G:A	0	0	0	0	0	0	0	0
1:20084839:C:T	0	0	0	0	0	0	0	0
1:20115561:T:C	3	2	7	4	3	2	0	1
1:20164025:T:C	0	0	0	0	0	0	0	0
1:20318593:T:A	0	0	0	0	0	0	0	0
1:20618562:C:T	1	1	1	0	1	1	0	1
1:20650507:A:C	3	2	3	1	2	1	0	1
1:20684809:C:T	0	0	0	0	0	0	0	0
1:20715540:T:C	0	0	0	0	0	0	0	0
1:20715622:G:A	0	0	0	0	0	0	0	0
1:20744926:G:A	38	13	40	26	14	1.0	1.0	0.0
1:20749781:G:A	25	12	38	17	21	1	1	0
1:21073646:C:T	2	0	5	5	0	2.5	2.5	0.0
1:21233587:A:G	9	5	10	5	5	1	0	1
1:21247229:G:A	6	4	11	3	8	1.5	0.0	1.0
1:21247362:G:A	10	5	12	6	6	1.0	0.5	0.5
1:21424721:G:A	1	0	7	7	0	7	7	0
1:21481666:G:A	1	1	1	0	1	1	0	1
1:21568242:T:C	0	0	0	0	0	0	0	0
1:21573678:A:G	0	0	0	0	0	0	0	0
1:21598453:T:C	0	0	0	0	0	0	0	0
1:21608865:C:T	0	0	0	0	0	0	0	0
1:21864961:G:A	0	0	0	0	0	0	0	0
1:21908161:C:T	0	0	0	0	0	0	0	0
1:21984232:G:C	0	0	0	0	0	0	0	0
1:21984314:A:G	0	0	0	0	0	0	0	0
1:22009812:CACG:TACA	0	0	0	0	0	0	0	0
1:22509184:A:G	5	4	8	1	7	1	0	1
1:22953931:G:T	0	0	0	0	0	0	0	0
1:23362440:A:G	0	0	0	0	0	0	0	0
1:23362590:G:A	0	0	0	0	0	0	0	0
1:23424647:G:T	1	1	1	0	1	1	0	1
1:23854472:T:C	5	2	9	6	3	1	1	0
1:23874604:G:C	12	4	16	9	7	1.0	1.0	0.0
1:23874619:C:T	13	5	20	11	9	1	1	0
1:23874772:A:G	22	6	49	41	8	1.0	1.0	0.0
1:23874867:A:G	22	7	35	19	16	1.0	1.0	0.0
1:23875221:G:T	14	7	27	16	11	1.0	0.5	0.5
1:24090925:T:C	0	0	0	0	0	0	0	0
1:24354425:C:T	0	0	0	0	0	0	0	0
1:24364274:T:A	0	0	0	0	0	0	0	0
1:24379779:A:G	4	3	4	1	3	1.0	0.0	1.0
1:24391585:T:C	28	6	30	24	6	1.0	1.0	0.0
1:24391589:C:A	29	22	31	7	24	1	0	1
1:24458903:C:T	7	4	14	3	11	1	0	1
1:24654948:A:G	67	31	101	53	48	1	1	0
1:24964519:A:T	1	0	2	2	0	2	2	0
1:25243590:T:C	98	41	179	98	81	1.0	1.0	0.0
1:25307714:G:A	0	0	0	0	0	0	0	0
1:25390874:C:G	0	0	0	0	0	0	0	0
1:25563698:A:G	12	3	21	14	7	1.5	1.0	0.0
1:26031165:C:A	0	0	0	0	0	0	0	0
1:26031176:G:A	0	0	0	0	0	0	0	0
1:26058512:T:C	0	0	0	0	0	0	0	0
1:26121956:A:G	1	0	2	2	0	2	2	0
1:26122358:T:C	0	0	0	0	0	0	0	0
1:26161449:A:G	0	0	0	0	0	0	0	0
1:26170160:T:C	529	260	713	401	312	1	1	0
1:26177545:G:A	0	0	0	0	0	0	0	0
1:26190776:A:G	0	0	0	0	0	0	0	0
1:26191303:A:G	0	0	0	0	0	0	0	0
1:26191400:C:T	0	0	0	0	0	0	0	0
1:26198029:G:A	0	0	0	0	0	0	0	0
1:26199948:A:G	0	0	0	0	0	0	0	0
1:26255600:G:A	2	1	3	2	1	1.5	1.0	0.5
1:26302851:G:A	50	23	58	29	29	1.0	1.0	0.0
1:26336871:C:T	1	1	2	0	2	2	0	2
1:26344118:C:T	0	0	0	0	0	0	0	0
1:26364683:C:A	0	0	0	0	0	0	0	0
1:26460136:G:A	3	2	3	1	2	1	0	1
1:26519704:C:T	0	0	0	0	0	0	0	0
1:26557020:A:C	14	9	26	11	15	1.0	0.0	1.0
1:26561101:T:C	17	7	27	14	13	1	1	0
1:26884230:T:C	6	2	7	5	2	1.0	1.0	0.0
1:27177171:T:A	0	0	0	0	0	0	0	0
1:27207685:G:T	0	0	0	0	0	0	0	0
1:27350434:G:A	25	12	28	14	14	1	1	0
1:27353463:G:A	31	18	60	27	33	1	0	1
1:27550907:G:A	0	0	0	0	0	0	0	0
1:28236165:A:G	126	74	134	57	77	1.0	0.0	1.0
1:28236573:C:T	40	16	40	24	16	1.0	1.0	0.0
1:28237768:A:G	27	10	47	29	18	1	1	0
1:28516806:A:G	32	13	53	30	23	1.0	1.0	0.0
1:30716054:A:G	0	0	0	0	0	0	0	0
1:32695043:T:G	0	0	0	0	0	0	0	0
1:32695277:C:T	0	0	0	0	0	0	0	0
1:32695611:T:C	0	0	0	0	0	0	0	0
1:32695663:C:T	0	0	0	0	0	0	0	0
1:32780201:C:G	5	2	6	4	2	1	1	0
1:32936941:G:C	9	3	9	6	3	1	1	0
1:32980236:C:T	0	0	0	0	0	0	0	0
1:33010366:G:A	13	0	13	13	0	1	1	0
1:33010638:T:C	12	0	12	12	0	1.0	1.0	0.0
1:33010691:A:G	14	0	15	15	0	1.0	1.0	0.0
1:33367264:A:G	0	0	0	0	0	0	0	0
1:33572614:T:C	0	0	0	0	0	0	0	0
1:33804897:G:A	0	0	0	0	0	0	0	0
1:33819741:G:A	0	0	0	0	0	0	0	0
1:33819780:C:T	0	0	0	0	0	0	0	0
1:33864466:A:C	0	0	0	0	0	0	0	0
1:34197579:G:A	0	0	0	0	0	0	0	0
1:34197607:C:G	0	0	0	0	0	0	0	0
1:34197810:C:G	0	0	0	0	0	0	0	0
1:34757690:C:T	0	0	0	0	0	0	0	0
1:34761561:C:T	0	0	0	0	0	0	0	0
1:36088072:A:G	0	0	0	0	0	0	0	0
1:36286832:C:T	32	19	33	14	19	1.0	0.0	1.0
1:36307804:T:G	5	2	10	4	6	2	1	0
1:36341880:C:T	0	0	0	0	0	0	0	0
1:36355326:G:A	6	1	8	7	1	1.0	1.0	0.0
1:36422101:C:T	0	0	0	0	0	0	0	0
1:36423404:G:A	0	0	0	0	0	0	0	0
1:36428367:A:G	0	0	0	0	0	0	0	0
1:36472277:C:T	0	0	0	0	0	0	0	0
1:36859876:A:C	0	0	0	0	0	0	0	0
1:37565095:T:C	1	1	1	0	1	1	0	1
1:37581461:C:G	0	0	0	0	0	0	0	0
1:38873777:C:T	0	0	0	0	0	0	0	0
1:38874610:C:T	0	0	0	0	0	0	0	0
1:40240054:A:T	5	2	5	3	2	1	1	0
1:40307451:G:C	13	6	18	11	7	1	1	0
1:40312436:C:T	9	3	10	7	3	1	1	0
1:40374681:A:G	7	4	12	5	7	1	0	1
1:40514887:G:A	0	0	0	0	0	0	0	0
1:40515059:G:T	1	1	1	0	1	1	0	1
1:40819415:T:C	0	0	0	0	0	0	0	0
1:40831156:T:G	0	0	0	0	0	0	0	0
1:41510858:C:T	1	0	1	1	0	1	1	0
1:41524790:G:A	0	0	0	0	0	0	0	0
1:41580076:T:C	2	1	2	1	1	1.0	0.5	0.5
1:42433172:A:G	0	0	0	0	0	0	0	0
1:42735184:G:A	0	0	0	0	0	0	0	0
1:42830524:C:T	13	4	13	9	4	1	1	0
1:43152925:G:A	0	0	0	0	0	0	0	0
1:43166865:C:T	11	7	11	4	7	1	0	1
1:43170813:C:G	11	6	12	5	7	1	0	1
1:43172739:G:C	0	0	0	0	0	0	0	0
1:43172786:T:A	0	0	0	0	0	0	0	0
1:43181753:C:T	0	0	0	0	0	0	0	0
1:43183665:T:C	0	0	0	0	0	0	0	0
1:43183722:T:C	0	0	0	0	0	0	0	0
1:43185353:C:G	0	0	0	0	0	0	0	0
1:43186771:G:C	0	0	0	0	0	0	0	0
1:43198547:C:T	0	0	0	0	0	0	0	0
1:43209796:G:A	0	0	0	0	0	0	0	0
1:43420823:C:T	1	0	2	2	0	2	2	0
1:43569681:C:T	0	0	0	0	0	0	0	0
1:43606347:C:T	0	0	0	0	0	0	0	0
1:43824858:A:G	1	0	4	4	0	4	4	0
1:43898332:G:A	0	0	0	0	0	0	0	0
1:43949743:C:T	0	0	0	0	0	0	0	0
1:43976849:A:C	5	3	7	3	4	1	0	1
1:43977258:A:G	3	3	3	0	3	1	0	1
1:43991633:G:A	4	1	7	5	2	1.5	1.0	0.0
1:44122223:C:T	2	0	2	2	0	1.0	1.0	0.0
1:44129738:A:G	0	0	0	0	0	0	0	0
1:44129754:G:A	0	0	0	0	0	0	0	0
1:44215047:G:C	4	2	13	11	2	3.0	2.5	0.5
1:44220650:T:C	4	1	4	3	1	1.0	1.0	0.0
1:44775915:G:A	65	32	66	34	32	1	1	0
1:44780571:C:A	89	10	89	79	10	1	1	0
1:44780661:T:C	2	0	2	2	0	1.0	1.0	0.0
1:44803661:A:G	11	6	13	5	8	1	0	1
1:44827194:G:A	0	0	0	0	0	0	0	0
1:44827846:A:G	0	0	0	0	0	0	0	0
1:45039048:G:C	0	0	0	0	0	0	0	0
1:45499635:G:A	16	3	33	30	3	1.0	1.0	0.0
1:45508256:G:A	1	1	1	0	1	1	0	1
1:45607817:G:A	0	0	0	0	0	0	0	0
1:46010915:T:G	0	0	0	0	0	0	0	0
1:46027788:T:G	0	0	0	0	0	0	0	0
1:46034941:T:C	0	0	0	0	0	0	0	0
1:46035321:A:G	0	0	0	0	0	0	0	0
1:46035687:A:G	0	0	0	0	0	0	0	0
1:46193432:T:C	0	0	0	0	0	0	0	0
1:46194623:T:C	1	0	1	1	0	1	1	0
1:46278228:C:T	0	0	0	0	0	0	0	0
1:46280492:C:T	5	3	5	2	3	1	0	1
1:46309111:A:G	1830	1040	3531	2007	1524	1.0	1.0	1.0
1:46344858:A:G	129	62	149	83	66	1	1	0
1:46361784:A:G	7	5	7	2	5	1	0	1
1:46405089:C:A	1	0	1	1	0	1	1	0
1:46511165:C:T	0	0	0	0	0	0	0	0
1:46614993:C:T	0	0	0	0	0	0	0	0
1:46615007:G:A	0	0	0	0	0	0	0	0
1:46615069:C:T	0	0	0	0	0	0	0	0
1:47994235:C:T	0	0	0	0	0	0	0	0
1:48247534:T:C	0	0	0	0	0	0	0	0
1:48298747:C:T	0	0	0	0	0	0	0	0
1:48436629:T:C	0	0	0	0	0	0	0	0
1:49845782:G:A	0	0	0	0	0	0	0	0
1:51800570:G:A	14	10	18	8	10	1.0	0.0	1.0
1:51825312:T:G	10	6	14	7	7	1.0	0.0	1.0
1:52033189:A:T	11	6	14	5	9	1	0	1
1:52160509:TAG:CAA	0	0	0	0	0	0	0	0
1:52525966:C:T	49	20	62	38	24	1	1	0
1:52784978:G:A	2	0	2	2	0	1.0	1.0	0.0
1:52976704:A:G	6	2	6	4	2	1.0	1.0	0.0
1:53071594:G:A	0	0	0	0	0	0	0	0
1:53078767:G:A	0	0	0	0	0	0	0	0
1:53078925:T:C	0	0	0	0	0	0	0	0
1:53213557:A:G	3	0	5	5	0	1	1	0
1:53216027:T:G	107	66	139	62	77	1	0	1
1:53218249:C:G	0	0	0	0	0	0	0	0
1:53250744:G:A	0	0	0	0	0	0	0	0
1:53266643:G:T	1	1	1	0	1	1	0	1
1:53275733:C:T	0	0	0	0	0	0	0	0
1:53326979:A:C	1	1	1	0	1	1	0	1
1:53464687:G:A	0	0	0	0	0	0	0	0
1:53966346:G:A	4	4	9	0	9	1.0	0.0	1.0
1:53975056:T:C	0	0	0	0	0	0	0	0
1:54139504:G:A	0	0	0	0	0	0	0	0
1:54179186:C:T	0	0	0	0	0	0	0	0
1:54220701:T:C	0	0	0	0	0	0	0	0
1:54220791:C:T	0	0	0	0	0	0	0	0
1:54536958:A:G	0	0	0	0	0	0	0	0
1:54670856:T:C	0	0	0	0	0	0	0	0
1:54852435:C:T	0	0	0	0	0	0	0	0
1:54992037:G:A	0	0	0	0	0	0	0	0
1:55008652:A:C	0	0	0	0	0	0	0	0
1:55052210:C:G	0	0	0	0	0	0	0	0
1:55058524:A:G	0	0	0	0	0	0	0	0
1:55058564:G:A	0	0	0	0	0	0	0	0
1:55063514:G:A	0	0	0	0	0	0	0	0
1:55172402:G:A	8	3	10	7	3	1.0	1.0	0.0
1:55222870:C:A	0	0	0	0	0	0	0	0
1:55223088:C:T	0	0	0	0	0	0	0	0
1:58048279:C:A	0	0	0	0	0	0	0	0
1:58048418:A:G	0	0	0	0	0	0	0	0
1:58630938:T:A	0	0	0	0	0	0	0	0
1:58630958:G:A	0	0	0	0	0	0	0	0
1:58630969:G:C	0	0	0	0	0	0	0	0
1:58630980:CGGCA:AGGCG	0	0	0	0	0	0	0	0
1:58630997:C:G	0	0	0	0	0	0	0	0
1:58631017:AACGG:GACGA	0	0	0	0	0	0	0	0
1:58631500:C:T	0	0	0	0	0	0	0	0
1:61277488:G:A	0	0	0	0	0	0	0	0
1:61787811:G:A	1	1	1	0	1	1	0	1
1:62114151:G:A	1	0	1	1	0	1	1	0
1:62178446:A:G	0	0	0	0	0	0	0	0
1:62247552:C:G	0	0	0	0	0	0	0	0
1:62263112:A:G	0	0	0	0	0	0	0	0
1:62263166:T:C	0	0	0	0	0	0	0	0
1:62263189:T:C	0	0	0	0	0	0	0	0
1:62263343:G:A	0	0	0	0	0	0	0	0
1:62266749:T:C	0	0	0	0	0	0	0	0
1:62274393:A:G	0	0	0	0	0	0	0	0
1:62274774:TGGT:CGGC	0	0	0	0	0	0	0	0
1:63415881:C:T	3	0	4	4	0	1	1	0
1:63629440:A:G	128	55	138	77	61	1.0	1.0	0.0
1:63843514:C:T	0	0	0	0	0	0	0	0
1:63843594:A:C	0	0	0	0	0	0	0	0
1:65395004:A:C	0	0	0	0	0	0	0	0
1:67386652:G:A	0	0	0	0	0	0	0	0
1:68126211:G:A	0	0	0	0	0	0	0	0
1:68137903:C:T	0	0	0	0	0	0	0	0
1:68162009:G:T	0	0	0	0	0	0	0	0
1:68162260:C:T	0	0	0	0	0	0	0	0
1:68162515:A:G	0	0	0	0	0	0	0	0
1:68162518:C:T	0	0	0	0	0	0	0	0
1:68162689:G:A	0	0	0	0	0	0	0	0
1:70354325:C:T	38	14	46	32	14	1.0	1.0	0.0
1:70429825:T:C	0	0	0	0	0	0	0	0
1:70439117:G:T	0	0	0	0	0	0	0	0
1:70531015:G:A	0	0	0	0	0	0	0	0
1:70865747:G:A	0	0	0	0	0	0	0	0
1:72274951:G:A	4	4	4	0	4	1.0	0.0	1.0
1:72275051:C:G	0	0	0	0	0	0	0	0
1:74199809:G:A	110	47	447	260	187	3.5	1.0	0.0
1:74204488:A:G	3	0	3	3	0	1	1	0
1:74710202:T:C	8	4	9	5	4	1.0	0.5	0.5
1:74748706:G:C	2	1	8	2	6	4.0	1.0	3.0
1:75234086:A:G	3	0	7	7	0	1	1	0
1:75251240:C:T	5	5	9	0	9	1	0	1
1:75641654:A:G	0	0	0	0	0	0	0	0
1:75641788:C:G	0	0	0	0	0	0	0	0
1:75879020:T:C	0	0	0	0	0	0	0	0
1:75898014:A:C	0	0	0	0	0	0	0	0
1:76627495:C:A	0	0	0	0	0	0	0	0
1:76700455:A:G	1	0	1	1	0	1	1	0
1:77293893:A:G	0	0	0	0	0	0	0	0
1:77713291:T:A	15	7	17	10	7	1	1	0
1:77942851:C:G	8	5	19	6	13	2.0	0.0	1.5
1:78492806:C:T	0	0	0	0	0	0	0	0
1:78891675:G:C	0	0	0	0	0	0	0	0
1:79055264:G:A	0	0	0	0	0	0	0	0
1:79055860:C:T	0	0	0	0	0	0	0	0
1:79055865:A:G	0	0	0	0	0	0	0	0
1:81427167:A:G	0	0	0	0	0	0	0	0
1:81427172:C:G	0	0	0	0	0	0	0	0
1:84398573:G:C	0	0	0	0	0	0	0	0
1:84414697:T:C	0	0	0	0	0	0	0	0
1:84574272:G:A	305	169	415	196	219	1	0	1
1:84647546:A:G	1	0	1	1	0	1	1	0
1:84655572:A:G	0	0	0	0	0	0	0	0
1:84996899:C:G	287	154	356	172	184	1	1	1
1:85022166:C:T	0	0	0	0	0	0	0	0
1:85276285:G:C	471	230	1637	864	773	3	1	0
1:85276329:G:C	692	390	1794	767	1027	1.0	0.0	1.0
1:85909971:C:G	1	1	1	0	1	1	0	1
1:86022549:G:A	0	0	0	0	0	0	0	0
1:86125458:A:G	0	0	0	0	0	0	0	0
1:86126154:G:A	0	0	0	0	0	0	0	0
1:86493490:T:C	0	0	0	0	0	0	0	0
1:86635692:C:G	0	0	0	0	0	0	0	0
1:88961219:G:A	10	6	15	8	7	1.0	0.0	1.0
1:89133354:A:G	4	4	4	0	4	1.0	0.0	1.0
1:89381813:G:T	0	0	0	0	0	0	0	0
1:89381852:C:T	0	0	0	0	0	0	0	0
1:89384183:A:T	0	0	0	0	0	0	0	0
1:89421155:A:G	1	0	1	1	0	1	1	0
1:89421535:A:C	0	0	0	0	0	0	0	0
1:89422971:C:T	1	1	2	0	2	2	0	2
1:89422993:T:A	1	1	1	0	1	1	0	1
1:89423026:CGGG:GGGT	0	0	0	0	0	0	0	0
1:90020853:T:G	33	14	80	37	43	1	1	0
1:90027467:G:A	7	3	7	4	3	1	1	0
1:91316454:G:A	0	0	0	0	0	0	0	0
1:91329226:T:C	0	0	0	0	0	0	0	0
1:91394244:A:G	0	0	0	0	0	0	0	0
1:91643342:C:T	0	0	0	0	0	0	0	0
1:91682670:C:G	0	0	0	0	0	0	0	0
1:91698089:G:A	0	0	0	0	0	0	0	0
1:91708703:A:G	2	2	2	0	2	1.0	0.0	1.0
1:91720100:C:T	1	0	1	1	0	1	1	0
1:92126359:G:A	0	0	0	0	0	0	0	0
1:92180464:G:A	1	0	1	1	0	1	1	0
1:92181666:A:G	1	1	1	0	1	1	0	1
1:92840760:G:A	12	6	60	30	30	4.0	1.0	1.0
1:93154836:G:A	11	6	18	10	8	1	0	1
1:93190938:A:G	6	2	28	16	12	4.0	2.5	0.0
1:93191031:A:G	8	2	36	19	17	3.0	2.0	0.0
1:93384726:C:A	0	0	0	0	0	0	0	0
1:93875711:A:G	68	35	80	39	41	1.0	1.0	1.0
1:93877008:C:A	55	30	127	56	71	1	0	1
1:93877467:A:G	35	20	40	20	20	1	0	1
1:93879160:C:T	11	5	13	6	7	1	1	0
1:94078678:T:C	0	0	0	0	0	0	0	0
1:94177975:T:C	0	0	0	0	0	0	0	0
1:94827558:C:A	0	0	0	0	0	0	0	0
1:95072868:C:T	31	13	40	25	15	1	1	0
1:97699535:T:C	0	0	0	0	0	0	0	0
1:97883329:A:G	2	0	2	2	0	1.0	1.0	0.0
1:99738137:G:A	0	0	0	0	0	0	0	0
1:99851033:A:G	57	34	62	24	38	1	0	1
1:99870805:C:T	2	0	5	5	0	2.5	2.5	0.0
1:99874669:G:A	1	0	5	5	0	5	5	0
1:100110377:G:A	10	7	19	4	15	1.5	0.0	1.0
1:100249898:G:A	0	0	0	0	0	0	0	0
1:100941583:T:C	0	0	0	0	0	0	0	0
1:104073253:A:G	0	0	0	0	0	0	0	0
1:104073337:A:G	0	0	0	0	0	0	0	0
1:105892749:T:C	0	0	0	0	0	0	0	0
1:105893150:T:G	0	0	0	0	0	0	0	0
1:107057296:C:T	3	2	3	1	2	1	0	1
1:108185862:T:C	64	39	79	31	48	1.0	0.0	1.0
1:108722407:G:T	0	0	0	0	0	0	0	0
1:108823664:C:T	0	0	0	0	0	0	0	0
1:108827293:G:T	0	0	0	0	0	0	0	0
1:108852356:G:A	0	0	0	0	0	0	0	0
1:108904128:G:A	0	0	0	0	0	0	0	0
1:108924236:G:A	4	0	9	9	0	2.5	2.5	0.0
1:108963407:C:G	22	10	27	16	11	1.0	1.0	0.0
1:109192676:T:C	0	0	0	0	0	0	0	0
1:109192794:A:C	0	0	0	0	0	0	0	0
1:109194441:C:T	0	0	0	0	0	0	0	0
1:109194468:G:A	0	0	0	0	0	0	0	0
1:109194510:T:C	0	0	0	0	0	0	0	0
1:109194550:C:T	0	0	0	0	0	0	0	0
1:109264212:C:T	0	0	0	0	0	0	0	0
1:109713453:A:G	0	0	0	0	0	0	0	0
1:109713598:A:C	0	0	0	0	0	0	0	0
1:109714906:A:T	0	0	0	0	0	0	0	0
1:109737079:C:T	0	0	0	0	0	0	0	0
1:109751367:A:G	0	0	0	0	0	0	0	0
1:109753150:T:C	0	0	0	0	0	0	0	0
1:109757069:G:A	0	0	0	0	0	0	0	0
1:110195674:G:A	0	0	0	0	0	0	0	0
1:110379093:T:G	1	1	3	0	3	3	0	3
1:110407817:C:T	2	1	3	1	2	1.5	0.5	1.0
1:111188279:C:T	15	8	27	11	16	1	0	1
1:111235703:C:T	66	31	75	39	36	1.0	1.0	0.0
1:111281633:C:T	0	0	0	0	0	0	0	0
1:111282604:C:T	0	0	0	0	0	0	0	0
1:111282639:G:A	0	0	0	0	0	0	0	0
1:111283401:C:G	0	0	0	0	0	0	0	0
1:111314586:G:A	0	0	0	0	0	0	0	0
1:111315329:A:G	0	0	0	0	0	0	0	0
1:111319352:T:C	0	0	0	0	0	0	0	0
1:111319452:C:T	0	0	0	0	0	0	0	0
1:111414623:G:A	0	0	0	0	0	0	0	0
1:111415071:A:G	0	0	0	0	0	0	0	0
1:111423669:C:T	1	1	2	0	2	2	0	2
1:111443384:C:A	9	4	12	7	5	1	1	0
1:111449473:C:T	25	11	25	14	11	1	1	0
1:111476035:G:A	781	449	1204	572	632	1	1	1
1:111648786:T:C	1	1	1	0	1	1	0	1
1:111739277:G:T	5	4	5	1	4	1	0	1
1:111766350:G:A	1	0	1	1	0	1	1	0
1:112449076:T:C	1	0	2	2	0	2	2	0
1:112456605:G:A	0	0	0	0	0	0	0	0
1:112520503:A:G	0	0	0	0	0	0	0	0
1:112540817:C:T	0	0	0	0	0	0	0	0
1:112705091:G:A	11	8	14	3	11	1	0	1
1:112913924:A:T	0	0	0	0	0	0	0	0
1:113169351:G:C	0	0	0	0	0	0	0	0
1:113391053:A:G	0	0	0	0	0	0	0	0
1:115062177:C:T	3	1	3	2	1	1	1	0
1:115286692:G:A	0	0	0	0	0	0	0	0
1:115663802:G:A	0	0	0	0	0	0	0	0
1:115768346:T:C	0	0	0	0	0	0	0	0
1:117011799:A:G	0	0	0	0	0	0	0	0
1:117033900:A:T	0	0	0	0	0	0	0	0
1:117523297:T:A	6	1	10	8	2	1.5	1.0	0.0
1:117623069:C:T	557	289	664	340	324	1	1	1
1:118023330:G:A	0	0	0	0	0	0	0	0
1:118040785:G:A	0	0	0	0	0	0	0	0
1:118101807:A:G	0	0	0	0	0	0	0	0
1:118150594:T:C	0	0	0	0	0	0	0	0
1:118926565:G:T	0	0	0	0	0	0	0	0
1:119085233:C:T	4	2	12	7	5	2.5	1.0	1.0
1:119511569:G:T	0	0	0	0	0	0	0	0
1:119514535:C:T	0	0	0	0	0	0	0	0
1:119514623:C:A	0	0	0	0	0	0	0	0
1:119534298:G:A	0	0	0	0	0	0	0	0
1:119601400:C:T	0	0	0	0	0	0	0	0
1:119724882:C:G	0	0	0	0	0	0	0	0
1:119794162:C:T	0	0	0	0	0	0	0	0
1:119794253:T:G	0	0	0	0	0	0	0	0
1:119836055:C:T	0	0	0	0	0	0	0	0
1:119841582:A:G	0	0	0	0	0	0	0	0
1:119844497:G:A	0	0	0	0	0	0	0	0
1:120460584:G:A	0	0	0	0	0	0	0	0
1:120466107:C:G	45	19	192	120	72	4	2	0
1:120491981:A:G	2	0	5	5	0	2.5	2.5	0.0
1:120793448:A:T	2	2	3	0	3	1.5	0.0	1.5
1:120805654:G:C	3	1	3	2	1	1	1	0
1:120889787:C:T	0	0	0	0	0	0	0	0
1:121118455:A:G	0	0	0	0	0	0	0	0
1:143554815:T:G	0	0	0	0	0	0	0	0
1:143595303:C:A	0	0	0	0	0	0	0	0
1:144426381:C:T	43	22	48	22	26	1	1	1
1:145400558:C:T	2	1	2	1	1	1.0	0.5	0.5
1:145892795:C:T	1	0	1	1	0	1	1	0
1:145898994:C:T	0	0	0	0	0	0	0	0
1:146228815:G:C	218	78	1444	1061	383	6.0	4.0	0.0
1:147052335:G:T	0	0	0	0	0	0	0	0
1:147052395:T:C	0	0	0	0	0	0	0	0
1:147052477:A:G	0	0	0	0	0	0	0	0
1:147114243:G:A	0	0	0	0	0	0	0	0
1:147117711:C:A	0	0	0	0	0	0	0	0
1:147117719:C:A	0	0	0	0	0	0	0	0
1:147264433:C:T	13	5	23	14	9	1	1	0
1:147268843:C:G	12	6	33	13	20	1.5	0.5	0.5
1:147319302:A:G	0	0	0	0	0	0	0	0
1:147319571:G:A	0	0	0	0	0	0	0	0
1:147758140:C:T	0	0	0	0	0	0	0	0
1:147841354:A:G	0	0	0	0	0	0	0	0
1:147842136:T:C	0	0	0	0	0	0	0	0
1:149064524:C:T	0	0	0	0	0	0	0	0
1:149082016:A:T	4	2	5	2	3	1.0	0.5	0.5
1:149906855:G:A	0	0	0	0	0	0	0	0
1:150262258:G:T	1	0	5	5	0	5	5	0
1:150328268:C:T	0	0	0	0	0	0	0	0
1:150510879:C:T	0	0	0	0	0	0	0	0
1:150511364:C:T	0	0	0	0	0	0	0	0
1:150512511:G:A	0	0	0	0	0	0	0	0
1:150755063:G:A	464	224	603	357	246	1.0	1.0	0.0
1:150836413:C:G	12	3	20	13	7	1.0	1.0	0.0
1:151034063:C:A	6	3	6	3	3	1.0	0.5	0.5
1:151046704:A:G	4	2	4	2	2	1.0	0.5	0.5
1:151133348:C:G	0	0	0	0	0	0	0	0
1:151135661:T:G	0	0	0	0	0	0	0	0
1:151236587:C:T	4	2	7	5	2	1.0	0.5	0.5
1:151266575:T:C	68	39	89	42	47	1.0	0.0	1.0
1:151281565:T:C	21	8	37	24	13	1	1	0
1:151315696:G:A	18	12	30	11	19	1.0	0.0	1.0
1:151342811:G:C	20	7	41	21	20	1.0	1.0	0.0
1:151399662:G:A	254	121	287	157	130	1.0	1.0	0.0
1:151401549:T:C	87	43	89	46	43	1	1	0
1:151540326:G:T	0	0	0	0	0	0	0	0
1:151714507:T:A	0	0	0	0	0	0	0	0
1:151760851:T:C	28	15	34	15	19	1.0	0.0	1.0
1:151760859:T:G	29	16	35	15	20	1	0	1
1:151895084:G:A	261	142	307	134	173	1	0	1
1:152018664:G:C	0	0	0	0	0	0	0	0
1:152112508:C:G	0	0	0	0	0	0	0	0
1:152154979:T:C	0	0	0	0	0	0	0	0
1:152156611:T:C	0	0	0	0	0	0	0	0
1:152218575:G:A	0	0	0	0	0	0	0	0
1:152220073:T:G	0	0	0	0	0	0	0	0
1:152220343:C:T	0	0	0	0	0	0	0	0
1:152220349:C:T	0	0	0	0	0	0	0	0
1:152220810:G:T	0	0	0	0	0	0	0	0
1:152303392:C:T	0	0	0	0	0	0	0	0
1:152307612:T:G	0	0	0	0	0	0	0	0
1:152309248:G:T	0	0	0	0	0	0	0	0
1:152313297:GAT:TAC	0	0	0	0	0	0	0	0
1:152350656:G:T	0	0	0	0	0	0	0	0
1:152353256:G:A	0	0	0	0	0	0	0	0
1:152356959:C:T	0	0	0	0	0	0	0	0
1:152358764:G:A	0	0	0	0	0	0	0	0
1:152409644:C:T	0	0	0	0	0	0	0	0
1:153261819:G:A	0	0	0	0	0	0	0	0
1:153304947:C:T	0	0	0	0	0	0	0	0
1:153631553:C:T	12	0	12	12	0	1.0	1.0	0.0
1:153852732:A:G	2	1	8	5	3	4.0	2.5	1.5
1:153941223:T:G	0	0	0	0	0	0	0	0
1:153969038:C:T	2	1	2	1	1	1.0	0.5	0.5
1:153982198:T:C	0	0	0	0	0	0	0	0
1:154022171:C:T	0	0	0	0	0	0	0	0
1:154254763:C:A	0	0	0	0	0	0	0	0
1:154263181:G:A	19	13	24	7	17	1	0	1
1:154321199:G:A	0	0	0	0	0	0	0	0
1:154323116:C:T	0	0	0	0	0	0	0	0
1:154331500:T:C	0	0	0	0	0	0	0	0
1:154337572:C:G	1	1	1	0	1	1	0	1
1:154501655:C:G	0	0	0	0	0	0	0	0
1:154589449:C:T	63	31	123	72	51	1	1	0
1:154601491:T:C	97	39	214	140	74	1	1	0
1:155057233:G:T	2	1	2	1	1	1.0	0.5	0.5
1:155133578:A:G	1	1	9	0	9	9	0	9
1:155133751:A:T	1	1	7	0	7	7	0	7
1:155134074:A:G	0	0	0	0	0	0	0	0
1:155173230:C:T	251	140	279	134	145	1	0	1
1:155177242:G:A	0	0	0	0	0	0	0	0
1:155192276:C:T	1	0	1	1	0	1	1	0
1:155260340:C:T	82	43	118	47	71	1.0	0.0	1.0
1:155261754:T:G	3	1	4	3	1	1	1	0
1:155290559:A:G	0	0	0	0	0	0	0	0
1:155290592:G:T	0	0	0	0	0	0	0	0
1:155660961:A:G	0	0	0	0	0	0	0	0
1:155688550:T:C	83	41	158	87	71	1	1	0
1:155765221:T:C	8	3	8	5	3	1.0	1.0	0.0
1:155859720:C:T	8	6	19	6	13	1.0	0.0	1.0
1:156055305:C:T	1025	551	1267	638	629	1	1	1
1:156176427:C:T	0	0	0	0	0	0	0	0
1:156246108:G:A	0	0	0	0	0	0	0	0
1:156285665:G:A	3	1	12	8	4	4	1	0
1:156294149:T:C	4	1	4	3	1	1.0	1.0	0.0
1:156294209:G:A	12	7	12	5	7	1.0	0.0	1.0
1:156337127:G:A	7	1	11	9	2	2	1	0
1:156530177:T:C	0	0	0	0	0	0	0	0
1:156556595:C:G	0	0	0	0	0	0	0	0
1:156595130:C:T	10	5	21	7	14	1.0	0.5	0.5
1:156596042:G:C	1	0	3	3	0	3	3	0
1:156669484:C:T	0	0	0	0	0	0	0	0
1:156671141:C:T	0	0	0	0	0	0	0	0
1:156671745:C:T	0	0	0	0	0	0	0	0
1:156791095:C:A	4	1	13	9	4	3.5	2.5	0.0
1:156815825:G:A	1	0	2	2	0	2	2	0
1:156879203:C:T	0	0	0	0	0	0	0	0
1:156913701:G:A	0	0	0	0	0	0	0	0
1:156932467:G:A	0	0	0	0	0	0	0	0
1:156937289:T:C	0	0	0	0	0	0	0	0
1:156937323:T:C	0	0	0	0	0	0	0	0
1:157059342:T:C	1	1	1	0	1	1	0	1
1:157059765:C:G	1	0	2	2	0	2	2	0
1:157060065:T:C	0	0	0	0	0	0	0	0
1:157060285:T:A	0	0	0	0	0	0	0	0
1:157060290:C:T	0	0	0	0	0	0	0	0
1:157060307:G:A	1	1	1	0	1	1	0	1
1:157060412:G:T	1	0	1	1	0	1	1	0
1:157073699:A:G	0	0	0	0	0	0	0	0
1:157074177:T:C	0	0	0	0	0	0	0	0
1:157092947:C:G	0	0	0	0	0	0	0	0
1:157539092:C:T	26	21	34	8	26	1.0	0.0	1.0
1:157539235:C:T	27	18	28	9	19	1	0	1
1:157544301:C:T	15	10	30	6	24	1	0	1
1:157544307:A:G	15	10	29	6	23	1	0	1
1:157678753:T:C	119	70	149	59	90	1	0	1
1:157689834:C:A	138	83	231	88	143	1.0	0.0	1.0
1:157698600:T:C	641	408	919	388	531	1	0	1
1:157700500:C:G	671	439	1774	738	1036	1	1	1
1:157802090:C:T	98	52	136	64	72	1.0	0.0	1.0
1:157834470:G:A	0	0	0	0	0	0	0	0
1:158096879:G:A	0	0	0	0	0	0	0	0
1:158097044:A:G	0	0	0	0	0	0	0	0
1:158177156:T:C	0	0	0	0	0	0	0	0
1:158612753:G:A	0	0	0	0	0	0	0	0
1:158612762:G:A	0	0	0	0	0	0	0	0
1:158612856:T:C	0	0	0	0	0	0	0	0
1:158614301:A:G	0	0	0	0	0	0	0	0
1:158638145:T:G	0	0	0	0	0	0	0	0
1:158642446:A:G	0	0	0	0	0	0	0	0
1:158717373:G:A	0	0	0	0	0	0	0	0
1:158717434:G:A	0	0	0	0	0	0	0	0
1:158718106:C:T	0	0	0	0	0	0	0	0
1:158755290:C:T	0	0	0	0	0	0	0	0
1:158765901:T:C	0	0	0	0	0	0	0	0
1:158766102:A:G	0	0	0	0	0	0	0	0
1:158844029:A:G	57	29	92	44	48	1	0	1
1:159205564:G:A	0	0	0	0	0	0	0	0
1:159440067:A:G	0	0	0	0	0	0	0	0
1:159535507:C:T	0	0	0	0	0	0	0	0
1:159588468:A:G	0	0	0	0	0	0	0	0
1:159809120:G:A	0	0	0	0	0	0	0	0
1:159815623:C:T	0	0	0	0	0	0	0	0
1:159815635:A:G	0	0	0	0	0	0	0	0
1:160153210:G:A	0	0	0	0	0	0	0	0
1:160155085:G:A	0	0	0	0	0	0	0	0
1:160266680:T:A	0	0	0	0	0	0	0	0
1:160277395:G:C	6	3	6	3	3	1.0	0.5	0.5
1:160333626:G:A	58	24	158	96	62	2.0	1.0	0.0
1:160823652:A:G	47	24	69	36	33	1	1	1
1:161000299:C:T	28	10	54	37	17	1.0	1.0	0.0
1:161118793:T:G	82	42	96	45	51	1.0	0.0	1.0
1:161169948:G:A	5	4	8	1	7	1	0	1
1:161174011:G:A	38	26	140	32	108	3.0	0.0	2.0
1:161191494:G:C	1	0	1	1	0	1	1	0
1:161202443:C:A	178	80	245	142	103	1.0	1.0	0.0
1:161232815:G:A	1	0	2	2	0	2	2	0
1:161526095:T:C	0	0	0	0	0	0	0	0
1:161707180:A:G	2	1	2	1	1	1.0	0.5	0.5
1:161710468:G:A	33	2	103	98	5	3	3	0
1:161711990:A:G	301	118	479	255	224	1	1	0
1:161726298:T:C	13	6	14	8	6	1	1	0
1:161751917:C:T	17	10	26	8	18	1	0	1
1:161781951:A:G	177	91	231	118	113	1	0	1
1:161998066:C:A	0	0	0	0	0	0	0	0
1:162805477:C:T	12	2	12	10	2	1.0	1.0	0.0
1:165676781:C:T	1	1	2	0	2	2	0	2
1:165724626:G:T	0	0	0	0	0	0	0	0
1:165725681:G:C	0	0	0	0	0	0	0	0
1:165726489:T:C	1	0	1	1	0	1	1	0
1:166748448:A:G	0	0	0	0	0	0	0	0
1:166936690:C:T	0	0	0	0	0	0	0	0
1:166992758:G:A	0	0	0	0	0	0	0	0
1:167438621:G:A	3	3	4	0	4	1	0	1
1:167439433:C:T	2	0	2	2	0	1.0	1.0	0.0
1:167870340:G:A	0	0	0	0	0	0	0	0
1:167880176:A:G	0	0	0	0	0	0	0	0
1:167924521:G:A	618	337	833	416	417	1.0	1.0	1.0
1:168004738:C:T	11	7	19	6	13	1	0	1
1:168044612:T:C	9	2	18	13	5	1	1	0
1:168056007:T:C	3	0	3	3	0	1	1	0
1:168056024:A:G	4	0	4	4	0	1.0	1.0	0.0
1:168056162:G:C	8	0	8	8	0	1.0	1.0	0.0
1:168056171:A:G	7	0	7	7	0	1	1	0
1:168056300:T:C	0	0	0	0	0	0	0	0
1:168578765:T:G	0	0	0	0	0	0	0	0
1:169707345:A:G	180	79	214	120	94	1.0	1.0	0.0
1:169798939:C:A	20	11	28	17	11	1.0	0.0	1.0
1:169830739:G:T	3	2	5	3	2	1	0	1
1:169854519:C:T	2	1	2	1	1	1.0	0.5	0.5
1:169854649:C:G	3	1	3	2	1	1	1	0
1:170166528:C:T	0	0	0	0	0	0	0	0
1:170166619:T:C	0	0	0	0	0	0	0	0
1:170166624:T:C	0	0	0	0	0	0	0	0
1:170959530:T:C	1	0	6	6	0	6	6	0
1:171185820:A:G	1	1	8	0	8	8	0	8
1:171199445:CA:TG	0	0	0	0	0	0	0	0
1:171339693:A:G	0	0	0	0	0	0	0	0
1:171339939:C:G	0	0	0	0	0	0	0	0
1:171517773:G:A	120	54	149	90	59	1.0	1.0	0.0
1:171683373:C:T	0	0	0	0	0	0	0	0
1:171683443:CA:TG	0	0	0	0	0	0	0	0
1:171683613:C:T	0	0	0	0	0	0	0	0
1:171783899:A:G	10	6	10	4	6	1.0	0.0	1.0
1:171786030:G:A	21	9	42	17	25	1	1	0
1:171786042:G:A	23	12	43	26	17	1	0	1
1:171794409:C:T	7	4	7	3	4	1	0	1
1:172442356:A:G	7	4	7	3	4	1	0	1
1:172453069:C:T	0	0	0	0	0	0	0	0
1:172532503:T:C	0	0	0	0	0	0	0	0
1:172578325:A:G	3	2	6	3	3	2	0	1
1:172589069:A:G	2	1	5	4	1	2.5	2.0	0.5
1:173870769:C:T	0	0	0	0	0	0	0	0
1:175045114:A:G	0	0	0	0	0	0	0	0
1:175085490:G:T	0	0	0	0	0	0	0	0
1:175123571:C:T	0	0	0	0	0	0	0	0
1:175330165:T:C	0	0	0	0	0	0	0	0
1:175355515:A:G	0	0	0	0	0	0	0	0
1:175406499:G:A	0	0	0	0	0	0	0	0
1:177932520:GCCC:ACCT	0	0	0	0	0	0	0	0
1:177933252:C:A	0	0	0	0	0	0	0	0
1:177933590:C:T	0	0	0	0	0	0	0	0
1:177936334:C:A	0	0	0	0	0	0	0	0
1:177960419:C:T	0	0	0	0	0	0	0	0
1:177960852:T:C	0	0	0	0	0	0	0	0
1:178093224:G:A	0	0	0	0	0	0	0	0
1:178521252:A:G	0	0	0	0	0	0	0	0
1:178747694:G:A	19	6	83	34	49	2	1	0
1:179456147:G:A	0	0	0	0	0	0	0	0
1:179457133:A:G	0	0	0	0	0	0	0	0
1:179551119:C:G	0	0	0	0	0	0	0	0
1:179551287:T:C	0	0	0	0	0	0	0	0
1:179551371:G:A	0	0	0	0	0	0	0	0
1:179564780:G:A	0	0	0	0	0	0	0	0
1:179587039:T:C	0	0	0	0	0	0	0	0
1:179593605:G:C	0	0	0	0	0	0	0	0
1:179635729:C:T	0	0	0	0	0	0	0	0
1:179882939:T:C	126	68	204	96	108	1.0	0.0	1.0
1:179907853:C:G	13	8	14	5	9	1	0	1
1:179968864:A:T	0	0	0	0	0	0	0	0
1:180003202:A:C	6	3	7	3	4	1.0	0.5	0.5
1:180020607:G:C	5	3	5	2	3	1	0	1
1:180031407:G:T	13	6	21	15	6	1	1	0
1:180175350:G:A	16	10	17	6	11	1.0	0.0	1.0
1:180178877:G:C	4	3	8	1	7	1.0	0.0	1.0
1:180190519:CCTC:TCTT	3	1	4	3	1	1	1	0
1:180194255:A:G	3	2	3	1	2	1	0	1
1:180248521:G:A	0	0	0	0	0	0	0	0
1:180271375:T:C	1	0	2	2	0	2	2	0
1:180274389:A:G	0	0	0	0	0	0	0	0
1:180936216:C:T	0	0	0	0	0	0	0	0
1:180936312:G:T	0	0	0	0	0	0	0	0
1:180984717:A:G	2	1	2	1	1	1.0	0.5	0.5
1:181055268:G:A	6	3	6	3	3	1.0	0.5	0.5
1:181089755:C:T	94	44	128	74	54	1.0	1.0	0.0
1:181737549:C:T	0	0	0	0	0	0	0	0
1:181755974:T:C	0	0	0	0	0	0	0	0
1:181772165:C:T	0	0	0	0	0	0	0	0
1:181790521:G:A	0	0	0	0	0	0	0	0
1:182454011:G:A	0	0	0	0	0	0	0	0
1:182527694:A:G	0	0	0	0	0	0	0	0
1:182585422:C:T	3	1	6	5	1	2	2	0
1:183103455:T:C	6	3	9	5	4	1.5	0.5	0.5
1:183116620:A:G	2	2	2	0	2	1.0	0.0	1.0
1:183117622:A:C	1	1	1	0	1	1	0	1
1:183124740:T:C	0	0	0	0	0	0	0	0
1:183125412:T:C	5	3	6	2	4	1	0	1
1:183136399:T:C	7	4	10	3	7	1	0	1
1:183136570:G:A	4	3	5	2	3	1.0	0.0	1.0
1:183228542:C:A	0	0	0	0	0	0	0	0
1:183546293:G:A	10	7	12	3	9	1.0	0.0	1.0
1:183563445:G:T	13	5	14	8	6	1	1	0
1:183573188:C:T	13	6	20	10	10	1	1	0
1:184567037:T:C	0	0	0	0	0	0	0	0
1:184567477:T:G	0	0	0	0	0	0	0	0
1:184694403:A:C	1	0	4	4	0	4	4	0
1:184708330:G:A	0	0	0	0	0	0	0	0
1:184794933:C:G	0	0	0	0	0	0	0	0
1:186015385:T:C	0	0	0	0	0	0	0	0
1:186057342:T:C	0	0	0	0	0	0	0	0
1:186061909:C:T	0	0	0	0	0	0	0	0
1:186132407:A:G	0	0	0	0	0	0	0	0
1:186304862:C:T	0	0	0	0	0	0	0	0
1:186307529:A:G	0	0	0	0	0	0	0	0
1:186308857:A:G	0	0	0	0	0	0	0	0
1:186393987:C:G	2	1	4	1	3	2.0	0.5	1.5
1:186679065:C:G	0	0	0	0	0	0	0	0
1:187563443:C:T	0	0	0	0	0	0	0	0
1:189989744:T:C	0	0	0	0	0	0	0	0
1:192247100:A:G	0	0	0	0	0	0	0	0
1:192247356:T:C	1	1	1	0	1	1	0	1
1:192247688:G:A	0	0	0	0	0	0	0	0
1:192247718:C:G	0	0	0	0	0	0	0	0
1:192579153:G:A	11	3	11	8	3	1	1	0
1:193085018:T:C	26	15	28	13	15	1.0	0.0	1.0
1:196673103:G:A	0	0	0	0	0	0	0	0
1:196685194:A:C	0	0	0	0	0	0	0	0
1:196690107:C:T	0	0	0	0	0	0	0	0
1:196726612:A:G	0	0	0	0	0	0	0	0
1:196740644:G:T	0	0	0	0	0	0	0	0
1:196774797:A:C	0	0	0	0	0	0	0	0
1:196774834:C:A	0	0	0	0	0	0	0	0
1:196788751:G:T	0	0	0	0	0	0	0	0
1:196825737:G:A	0	0	0	0	0	0	0	0
1:196830561:G:A	0	0	0	0	0	0	0	0
1:196831912:G:T	0	0	0	0	0	0	0	0
1:196831948:A:T	0	0	0	0	0	0	0	0
1:196907328:A:G	0	0	0	0	0	0	0	0
1:196998224:G:A	0	0	0	0	0	0	0	0
1:197040668:A:G	0	0	0	0	0	0	0	0
1:197101312:G:T	0	0	0	0	0	0	0	0
1:197101567:T:C	0	0	0	0	0	0	0	0
1:197101577:G:A	0	0	0	0	0	0	0	0
1:197103290:T:C	0	0	0	0	0	0	0	0
1:197124900:C:T	0	0	0	0	0	0	0	0
1:197328514:T:C	0	0	0	0	0	0	0	0
1:197511797:C:T	2	1	2	1	1	1.0	0.5	0.5
1:197735587:C:T	1	1	1	0	1	1	0	1
1:197905819:T:C	12	6	27	9	18	1.0	0.5	0.5
1:200342740:C:G	0	0	0	0	0	0	0	0
1:200898364:C:G	0	0	0	0	0	0	0	0
1:200912044:C:A	0	0	0	0	0	0	0	0
1:201004398:C:T	1	1	1	0	1	1	0	1
1:201043469:G:A	0	0	0	0	0	0	0	0
1:201047168:G:A	0	0	0	0	0	0	0	0
1:201091737:G:A	0	0	0	0	0	0	0	0
1:201143853:A:G	22	12	24	10	14	1.0	0.0	1.0
1:201206146:A:G	0	0	0	0	0	0	0	0
1:201208118:T:C	0	0	0	0	0	0	0	0
1:201208150:C:T	0	0	0	0	0	0	0	0
1:201209796:AAG:GAA	0	0	0	0	0	0	0	0
1:201209837:A:G	0	0	0	0	0	0	0	0
1:201210956:G:T	0	0	0	0	0	0	0	0
1:201212089:A:G	0	0	0	0	0	0	0	0
1:201215147:C:T	0	0	0	0	0	0	0	0
1:201317643:C:T	0	0	0	0	0	0	0	0
1:201319827:G:A	0	0	0	0	0	0	0	0
1:201520157:G:C	15	4	68	46	22	4	3	0
1:201520174:C:T	15	4	63	42	21	4	2	0
1:201520512:G:C	0	0	0	0	0	0	0	0
1:201520572:G:A	3	1	7	6	1	2	2	0
1:201870729:G:A	5	5	5	0	5	1	0	1
1:201891888:C:G	0	0	0	0	0	0	0	0
1:201965450:G:A	156	86	166	77	89	1.0	0.0	1.0
1:201978644:G:A	0	0	0	0	0	0	0	0
1:201983446:T:C	0	0	0	0	0	0	0	0
1:202123232:G:A	0	0	0	0	0	0	0	0
1:202123287:A:G	0	0	0	0	0	0	0	0
1:202123452:T:C	0	0	0	0	0	0	0	0
1:202187500:A:C	0	0	0	0	0	0	0	0
1:202318028:C:T	0	0	0	0	0	0	0	0
1:202318078:T:C	0	0	0	0	0	0	0	0
1:202318626:G:A	0	0	0	0	0	0	0	0
1:202318685:T:C	0	0	0	0	0	0	0	0
1:202596820:G:A	0	0	0	0	0	0	0	0
1:202605656:G:A	0	0	0	0	0	0	0	0
1:202736327:G:C	0	0	0	0	0	0	0	0
1:202749074:G:A	2	1	3	2	1	1.5	1.0	0.5
1:202764110:C:T	5	3	11	4	7	2	0	2
1:202825659:T:C	0	0	0	0	0	0	0	0
1:202962711:G:A	0	0	0	0	0	0	0	0
1:203184614:A:G	0	0	0	0	0	0	0	0
1:203502970:G:A	0	0	0	0	0	0	0	0
1:203798694:T:G	6	3	23	8	15	3.5	0.5	1.0
1:203849845:C:A	34	15	121	52	69	2.5	1.0	0.0
1:204037469:G:A	0	0	0	0	0	0	0	0
1:204190659:G:C	0	0	0	0	0	0	0	0
1:204273710:A:C	0	0	0	0	0	0	0	0
1:204410404:T:C	5	0	11	11	0	1	1	0
1:205001174:T:C	0	0	0	0	0	0	0	0
1:205009405:A:G	0	0	0	0	0	0	0	0
1:205058609:G:A	0	0	0	0	0	0	0	0
1:205072030:C:T	0	0	0	0	0	0	0	0
1:205160191:G:A	4	1	8	5	3	2.0	1.0	0.0
1:205163896:G:T	2	1	2	1	1	1.0	0.5	0.5
1:205303972:G:A	13	4	14	10	4	1	1	0
1:205584957:G:C	0	0	0	0	0	0	0	0
1:205584967:A:C	1	0	1	1	0	1	1	0
1:205592244:C:T	6	5	24	2	22	3.5	0.0	3.5
1:205798757:G:A	0	0	0	0	0	0	0	0
1:205810103:G:A	3	2	5	2	3	2	0	1
1:205849976:G:A	6	6	7	0	7	1.0	0.0	1.0
1:206110345:C:T	0	0	0	0	0	0	0	0
1:206110373:C:T	0	0	0	0	0	0	0	0
1:206430185:G:A	1	0	3	3	0	3	3	0
1:206492563:C:G	1	0	9	9	0	9	9	0
1:206507650:A:C	0	0	0	0	0	0	0	0
1:206636903:G:T	0	0	0	0	0	0	0	0
1:206937591:T:C	0	0	0	0	0	0	0	0
1:206967095:C:T	0	0	0	0	0	0	0	0
1:207096574:C:T	0	0	0	0	0	0	0	0
1:207506725:C:T	51	26	52	25	27	1	0	1
1:207587428:C:T	8	4	15	8	7	1.0	0.5	0.5
1:207609424:G:A	2	1	2	1	1	1.0	0.5	0.5
1:207609586:A:G	4	2	4	2	2	1.0	0.5	0.5
1:207669488:C:G	0	0	0	0	0	0	0	0
1:207669555:G:A	1	0	1	1	0	1	1	0
1:207678209:C:T	0	0	0	0	0	0	0	0
1:207678266:A:G	0	0	0	0	0	0	0	0
1:207683909:A:G	0	0	0	0	0	0	0	0
1:207694509:G:A	0	0	0	0	0	0	0	0
1:207694677:G:T	0	0	0	0	0	0	0	0
1:207715394:G:T	1	1	1	0	1	1	0	1
1:207717547:G:A	0	0	0	0	0	0	0	0
1:207876956:A:G	0	0	0	0	0	0	0	0
1:208034494:G:A	0	0	0	0	0	0	0	0
1:208217124:C:T	0	0	0	0	0	0	0	0
1:208217753:T:C	0	0	0	0	0	0	0	0
1:209611861:G:A	0	0	0	0	0	0	0	0
1:209634627:G:A	0	0	0	0	0	0	0	0
1:209783197:C:A	0	0	0	0	0	0	0	0
1:209795339:C:A	0	0	0	0	0	0	0	0
1:209830987:G:A	11	7	11	4	7	1	0	1
1:210163698:A:G	0	0	0	0	0	0	0	0
1:210233686:G:T	0	0	0	0	0	0	0	0
1:210266022:A:G	1	0	1	1	0	1	1	0
1:210404529:G:C	0	0	0	0	0	0	0	0
1:210404540:G:A	0	0	0	0	0	0	0	0
1:210859354:C:G	0	0	0	0	0	0	0	0
1:210859618:T:A	0	0	0	0	0	0	0	0
1:210860801:T:G	0	0	0	0	0	0	0	0
1:211173727:G:A	2	0	2	2	0	1.0	1.0	0.0
1:212342271:C:T	11	6	18	12	6	1	0	1
1:212445997:T:C	20	7	23	15	8	1.0	1.0	0.0
1:212625635:A:G	0	0	0	0	0	0	0	0
1:212626607:C:T	0	0	0	0	0	0	0	0
1:212782112:G:A	0	0	0	0	0	0	0	0
1:212895253:C:T	5	4	5	1	4	1	0	1
1:212967056:A:C	0	0	0	0	0	0	0	0
1:214482924:CA:TG	0	0	0	0	0	0	0	0
1:214482934:C:G	0	0	0	0	0	0	0	0
1:214482955:C:T	0	0	0	0	0	0	0	0
1:214483035:C:T	1	1	1	0	1	1	0	1
1:214483070:T:C	1	1	1	0	1	1	0	1
1:214483157:T:C	19	19	19	0	19	1	0	1
1:214483183:TG:CA	17	17	17	0	17	1	0	1
1:214483232:C:T	81	81	83	0	83	1	0	1
1:214613787:G:A	6	4	6	2	4	1.0	0.0	1.0
1:214641228:C:T	0	0	0	0	0	0	0	0
1:214645648:G:A	0	0	0	0	0	0	0	0
1:214646756:A:G	1	1	1	0	1	1	0	1
1:214657274:A:G	0	0	0	0	0	0	0	0
1:214663767:C:G	0	0	0	0	0	0	0	0
1:215675245:T:C	0	0	0	0	0	0	0	0
1:215741484:T:C	0	0	0	0	0	0	0	0
1:215743221:G:A	0	0	0	0	0	0	0	0
1:215786825:T:G	0	0	0	0	0	0	0	0
1:215838100:C:T	0	0	0	0	0	0	0	0
1:215999038:A:G	0	0	0	0	0	0	0	0
1:216418661:T:C	0	0	0	0	0	0	0	0
1:216421964:C:T	0	0	0	0	0	0	0	0
1:217620142:C:T	4	2	15	13	2	1.0	0.5	0.5
1:219983362:T:C	100	43	120	67	53	1.0	1.0	0.0
1:220314315:C:T	0	0	0	0	0	0	0	0
1:220754429:C:T	0	0	0	0	0	0	0	0
1:220761739:G:A	0	0	0	0	0	0	0	0
1:220783967:C:T	0	0	0	0	0	0	0	0
1:220796686:A:G	0	0	0	0	0	0	0	0
1:220880232:A:C	3	1	3	2	1	1	1	0
1:220884397:C:G	1	0	1	1	0	1	1	0
1:221706227:C:T	3	2	3	1	2	1	0	1
1:221739019:T:C	2	1	2	1	1	1.0	0.5	0.5
1:221739466:T:C	12	7	12	5	7	1.0	0.0	1.0
1:222629034:A:G	2	1	2	1	1	1.0	0.5	0.5
1:222629461:T:G	1	1	1	0	1	1	0	1
1:222629862:A:G	4	2	5	2	3	1.0	0.5	0.5
1:223110509:T:C	0	0	0	0	0	0	0	0
1:223111186:A:G	0	0	0	0	0	0	0	0
1:223544122:A:G	0	0	0	0	0	0	0	0
1:223545289:G:A	0	0	0	0	0	0	0	0
1:223545308:A:G	0	0	0	0	0	0	0	0
1:223951948:T:C	6	1	12	11	1	1.5	1.5	0.0
1:224175668:A:T	87	83	89	4	85	1	0	1
1:224305044:C:T	8	5	8	3	5	1.0	0.0	1.0
1:224308150:C:T	18	9	33	10	23	1.0	0.5	0.5
1:224330140:C:T	3	2	3	1	2	1	0	1
1:224574867:C:T	0	0	0	0	0	0	0	0
1:224955008:A:T	0	0	0	0	0	0	0	0
1:225023720:T:C	0	0	0	0	0	0	0	0
1:225082707:A:T	0	0	0	0	0	0	0	0
1:225265281:A:G	0	0	0	0	0	0	0	0
1:225333399:G:C	0	0	0	0	0	0	0	0
1:225346229:A:G	0	0	0	0	0	0	0	0
1:225346517:T:C	0	0	0	0	0	0	0	0
1:225377313:T:C	1	0	2	2	0	2	2	0
1:225392391:G:C	0	0	0	0	0	0	0	0
1:225412467:C:T	14	7	24	7	17	1.0	0.5	0.5
1:225419442:C:T	9	1	11	10	1	1	1	0
1:225423959:C:T	325	160	424	228	196	1	1	0
1:225497771:T:C	0	0	0	0	0	0	0	0
1:225519241:C:T	0	0	0	0	0	0	0	0
1:225803391:A:G	0	0	0	0	0	0	0	0
1:225844528:C:T	5	4	17	1	16	2	0	2
1:225867895:G:A	13	8	28	12	16	2	0	1
1:225988203:T:C	43	23	97	44	53	2	0	1
1:226385663:A:G	204	100	251	136	115	1.0	1.0	0.0
1:226736941:C:T	1	0	1	1	0	1	1	0
1:226881976:T:C	9	7	12	2	10	1	0	1
1:226882036:C:T	4	4	6	0	6	1.0	0.0	1.0
1:226883824:C:T	1	0	1	1	0	1	1	0
1:226961502:G:A	320	157	419	205	214	1.0	1.0	0.0
1:226984589:C:T	13	6	14	7	7	1	1	0
1:226986509:T:C	10	3	10	7	3	1.0	1.0	0.0
1:227028961:T:C	0	0	0	0	0	0	0	0
1:227264999:C:T	0	0	0	0	0	0	0	0
1:227265050:C:T	0	0	0	0	0	0	0	0
1:227434310:A:G	1	1	1	0	1	1	0	1
1:227493134:C:T	0	0	0	0	0	0	0	0
1:227493872:AG:CC	0	0	0	0	0	0	0	0
1:227493880:GGTACC:AGTATT	0	0	0	0	0	0	0	0
1:229326878:C:T	1	0	1	1	0	1	1	0
1:229487591:T:C	9	4	13	8	5	1	1	0
1:229495987:T:C	1	0	6	6	0	6	6	0
1:229499774:A:G	2	1	4	1	3	2.0	0.5	1.5
1:229547517:G:A	1	0	1	1	0	1	1	0
1:230762748:C:T	0	0	0	0	0	0	0	0
1:230767604:T:C	0	0	0	0	0	0	0	0
1:230787567:C:T	0	0	0	0	0	0	0	0
1:231021754:C:T	1	0	1	1	0	1	1	0
1:231021975:T:C	0	0	0	0	0	0	0	0
1:231162953:T:G	0	0	0	0	0	0	0	0
1:232415670:G:A	0	0	0	0	0	0	0	0
1:232445690:G:A	0	0	0	0	0	0	0	0
1:232462241:T:A	0	0	0	0	0	0	0	0
1:232955717:T:A	149	16	207	185	22	1	1	0
1:233090102:T:C	0	0	0	0	0	0	0	0
1:233289042:T:G	1	0	4	4	0	4	4	0
1:233649970:T:G	0	0	0	0	0	0	0	0
1:233650040:A:C	0	0	0	0	0	0	0	0
1:234433446:T:C	5	2	5	3	2	1	1	0
1:235219873:A:G	111	50	160	103	57	1	1	0
1:235257178:G:A	34	14	57	35	22	1.0	1.0	0.0
1:235489208:C:T	1	0	1	1	0	1	1	0
1:235552223:A:G	0	0	0	0	0	0	0	0
1:235738133:C:A	0	0	0	0	0	0	0	0
1:235747242:C:T	0	0	0	0	0	0	0	0
1:235777150:C:T	2	2	3	0	3	1.5	0.0	1.5
1:235781994:T:C	2	2	11	0	11	5.5	0.0	5.5
1:235809135:T:C	9	5	23	12	11	1	0	1
1:235809567:T:C	2	1	2	1	1	1.0	0.5	0.5
1:235977874:T:C	0	0	0	0	0	0	0	0
1:235981651:A:G	0	0	0	0	0	0	0	0
1:236110847:G:A	0	0	0	0	0	0	0	0
1:236111318:G:A	0	0	0	0	0	0	0	0
1:236394471:G:A	0	0	0	0	0	0	0	0
1:236482370:C:T	0	0	0	0	0	0	0	0
1:236555835:T:C	5	4	9	1	8	1	0	1
1:236820232:ATC:GTG	2	1	6	4	2	3.0	2.0	1.0
1:236820294:A:G	2	1	5	2	3	2.5	1.0	1.5
1:236891269:A:G	1	1	1	0	1	1	0	1
1:236895444:C:A	0	0	0	0	0	0	0	0
1:236895528:C:T	3	2	3	1	2	1	0	1
1:236981431:G:C	42	0	42	42	0	1.0	1.0	0.0
1:237454457:C:T	0	0	0	0	0	0	0	0
1:237678090:A:G	0	0	0	0	0	0	0	0
1:237926957:A:G	0	0	0	0	0	0	0	0
1:239973526:G:A	0	0	0	0	0	0	0	0
1:240329434:G:A	0	0	0	0	0	0	0	0
1:240998475:C:T	0	0	0	0	0	0	0	0
1:241744515:T:C	0	0	0	0	0	0	0	0
1:241766240:G:A	0	0	0	0	0	0	0	0
1:241878999:G:A	0	0	0	0	0	0	0	0
1:241993647:C:T	0	0	0	0	0	0	0	0
1:242524088:G:A	2	0	4	4	0	2.0	2.0	0.0
1:242975034:G:A	0	0	0	0	0	0	0	0
1:242975052:A:G	0	0	0	0	0	0	0	0
1:244864047:C:T	138	77	177	85	92	1.0	0.0	1.0
1:245155386:C:T	0	0	0	0	0	0	0	0
1:245685694:G:A	0	0	0	0	0	0	0	0
1:245685698:C:T	0	0	0	0	0	0	0	0
1:245698269:C:T	0	0	0	0	0	0	0	0
1:245858639:T:C	2	0	2	2	0	1.0	1.0	0.0
1:247183950:C:G	0	0	0	0	0	0	0	0
1:247424175:G:A	0	0	0	0	0	0	0	0
1:247451315:C:T	0	0	0	0	0	0	0	0
1:247589065:A:G	0	0	0	0	0	0	0	0
1:247605760:A:G	0	0	0	0	0	0	0	0
1:247605780:C:A	0	0	0	0	0	0	0	0
1:247606290:C:T	0	0	0	0	0	0	0	0
1:247606450:A:G	0	0	0	0	0	0	0	0
1:247672477:C:G	0	0	0	0	0	0	0	0
1:247672648:T:C	0	0	0	0	0	0	0	0
1:247712012:C:A	0	0	0	0	0	0	0	0
1:247712113:A:G	0	0	0	0	0	0	0	0
1:247712387:A:G	0	0	0	0	0	0	0	0
1:247758110:G:C	0	0	0	0	0	0	0	0
1:247876149:C:T	0	0	0	0	0	0	0	0
1:247876411:A:G	0	0	0	0	0	0	0	0
1:247896121:C:T	0	0	0	0	0	0	0	0
1:247921523:C:T	0	0	0	0	0	0	0	0
1:247949325:T:C	0	0	0	0	0	0	0	0
1:247949613:A:G	0	0	0	0	0	0	0	0
1:248084006:A:C	0	0	0	0	0	0	0	0
1:248180060:G:A	0	0	0	0	0	0	0	0
1:248203490:T:C	0	0	0	0	0	0	0	0
1:248239456:C:T	0	0	0	0	0	0	0	0
1:248273670:A:G	0	0	0	0	0	0	0	0
1:248294677:C:A	0	0	0	0	0	0	0	0
1:248294691:C:G	0	0	0	0	0	0	0	0
1:248323714:C:T	0	0	0	0	0	0	0	0
1:248324036:C:A	0	0	0	0	0	0	0	0
1:248324336:A:G	0	0	0	0	0	0	0	0
1:248324466:A:G	0	0	0	0	0	0	0	0
1:248349196:A:G	0	0	0	0	0	0	0	0
1:248361844:C:T	0	0	0	0	0	0	0	0
1:248362345:CACC:AACT	0	0	0	0	0	0	0	0
1:248362355:G:A	0	0	0	0	0	0	0	0
1:248362478:C:T	0	0	0	0	0	0	0	0
1:248388259:C:T	0	0	0	0	0	0	0	0
1:248388335:T:G	0	0	0	0	0	0	0	0
1:248442094:T:G	0	0	0	0	0	0	0	0
1:248574028:C:T	0	0	0	0	0	0	0	0
1:248638596:G:A	1	0	1	1	0	1	1	0
1:248650825:G:A	0	0	0	0	0	0	0	0
2:277314:G:A	58	26	69	39	30	1.0	1.0	0.0
2:675831:G:T	1	1	1	0	1	1	0	1
2:1083634:C:T	1	0	1	1	0	1	1	0
2:1173095:C:A	0	0	0	0	0	0	0	0
2:1267458:A:G	0	0	0	0	0	0	0	0
2:1456232:G:T	0	0	0	0	0	0	0	0
2:1477459:G:C	0	0	0	0	0	0	0	0
2:1494031:C:T	0	0	0	0	0	0	0	0
2:1496127:C:T	0	0	0	0	0	0	0	0
2:1496155:A:C	0	0	0	0	0	0	0	0
2:1516904:T:C	0	0	0	0	0	0	0	0
2:1540845:G:A	0	0	0	0	0	0	0	0
2:1542555:C:G	0	0	0	0	0	0	0	0
2:3208710:C:T	1	1	1	0	1	1	0	1
2:3479410:C:T	21	12	22	10	12	1	0	1
2:3500916:A:G	285	163	355	152	203	1	0	1
2:3605026:G:C	0	0	0	0	0	0	0	0
2:3617548:C:T	1	1	1	0	1	1	0	1
2:3617556:T:C	1	1	1	0	1	1	0	1
2:3626058:G:A	0	0	0	0	0	0	0	0
2:3671102:C:T	0	0	0	0	0	0	0	0
2:3681664:C:T	0	0	0	0	0	0	0	0
2:8038605:A:G	0	0	0	0	0	0	0	0
2:8038668:C:T	0	0	0	0	0	0	0	0
2:8603238:T:C	0	0	0	0	0	0	0	0
2:8736912:G:A	3	1	8	6	2	3	3	0
2:9910818:T:C	1	1	1	0	1	1	0	1
2:9919641:G:T	5	4	5	1	4	1	0	1
2:10048522:A:T	7	3	14	6	8	1	1	0
2:10122793:T:G	2	2	3	1	2	1.5	0.5	1.0
2:10423107:G:A	0	0	0	0	0	0	0	0
2:10423110:G:A	0	0	0	0	0	0	0	0
2:10768767:A:G	1	0	2	2	0	2	2	0
2:10790777:T:C	23	9	40	27	13	1	1	0
2:10793123:C:T	37	15	59	38	21	1	1	0
2:10912894:A:G	0	0	0	0	0	0	0	0
2:11211794:A:G	9	5	17	6	11	1	0	1
2:11308208:C:T	0	0	0	0	0	0	0	0
2:11308832:A:T	0	0	0	0	0	0	0	0
2:11598825:C:T	0	0	0	0	0	0	0	0
2:11634198:G:A	0	0	0	0	0	0	0	0
2:11771635:C:T	2	1	2	1	1	1.0	0.5	0.5
2:11784824:T:C	0	0	0	0	0	0	0	0
2:11792047:G:T	1	1	1	0	1	1	0	1
2:15393655:G:A	0	0	0	0	0	0	0	0
2:15402228:C:T	3	2	6	2	4	2	0	1
2:15461317:C:T	1	1	1	0	1	1	0	1
2:15467718:T:C	0	0	0	0	0	0	0	0
2:15474280:T:C	2	0	2	2	0	1.0	1.0	0.0
2:15475786:A:G	9	6	11	4	7	1	0	1
2:15534562:T:C	4	3	4	1	3	1.0	0.0	1.0
2:15595524:T:C	145	86	170	73	97	1	0	1
2:15607269:C:T	5	3	7	2	5	1	0	1
2:17385367:A:G	0	0	0	0	0	0	0	0
2:17515306:C:T	0	0	0	0	0	0	0	0
2:17517411:A:G	0	0	0	0	0	0	0	0
2:18583903:C:T	0	0	0	0	0	0	0	0
2:20606576:C:T	1	0	5	5	0	5	5	0
2:20638558:G:A	42	22	95	47	48	2.0	0.5	1.0
2:21009253:C:T	0	0	0	0	0	0	0	0
2:21009323:G:A	0	0	0	0	0	0	0	0
2:21028042:G:A	0	0	0	0	0	0	0	0
2:23703789:T:C	0	0	0	0	0	0	0	0
2:23872928:A:G	0	0	0	0	0	0	0	0
2:24033201:T:C	1	0	2	2	0	2	2	0
2:24119635:T:C	1	1	1	0	1	1	0	1
2:24119662:G:A	1	1	1	0	1	1	0	1
2:24161554:T:C	9	7	13	2	11	1	0	1
2:24167648:G:A	5	4	9	1	8	2	0	2
2:24203665:A:G	42	21	114	57	57	1.5	0.5	0.5
2:24334534:G:A	7	3	25	9	16	3	1	0
2:24334757:T:C	4	1	16	12	4	3.5	2.0	0.0
2:24971872:G:A	46	23	125	72	53	1.0	1.0	0.5
2:25249683:G:A	5	0	5	5	0	1	1	0
2:25432903:T:C	10	4	10	6	4	1.0	1.0	0.0
2:25810618:A:C	0	0	0	0	0	0	0	0
2:26269989:A:G	535	276	718	365	353	1	1	1
2:26367216:T:G	15	4	23	14	9	1	1	0
2:26424409:T:G	0	0	0	0	0	0	0	0
2:26453527:G:T	0	0	0	0	0	0	0	0
2:26477832:G:A	0	0	0	0	0	0	0	0
2:26577554:G:A	0	0	0	0	0	0	0	0
2:26581379:T:C	0	0	0	0	0	0	0	0
2:26946974:C:A	0	0	0	0	0	0	0	0
2:27037601:G:A	12	5	26	21	5	1.0	1.0	0.0
2:27067657:A:G	1	1	5	0	5	5	0	5
2:27092384:G:A	3	2	4	2	2	1	0	1
2:27100517:C:T	0	0	0	0	0	0	0	0
2:27201768:G:A	2	1	2	1	1	1.0	0.5	0.5
2:27238100:A:G	4	2	6	2	4	1.0	0.5	0.5
2:27328100:A:G	6	5	7	2	5	1.0	0.0	1.0
2:27335385:A:G	1	1	7	0	7	7	0	7
2:27366943:T:C	7	3	9	4	5	1	1	0
2:27367171:G:C	4	2	7	4	3	1.5	0.5	0.5
2:27369556:C:T	0	0	0	0	0	0	0	0
2:27440549:G:T	2	1	12	11	1	6.0	5.5	0.5
2:27444430:A:G	4	2	4	2	2	1.0	0.5	0.5
2:27453420:A:T	0	0	0	0	0	0	0	0
2:27506613:G:A	0	0	0	0	0	0	0	0
2:27566994:T:A	0	0	0	0	0	0	0	0
2:27578536:C:G	0	0	0	0	0	0	0	0
2:27578551:C:A	0	0	0	0	0	0	0	0
2:27579938:A:G	0	0	0	0	0	0	0	0
2:27581565:T:C	0	0	0	0	0	0	0	0
2:27615191:C:A	5	4	5	1	4	1	0	1
2:27664167:C:A	234	132	241	109	132	1.0	0.0	1.0
2:28411923:G:A	0	0	0	0	0	0	0	0
2:28566776:T:C	0	0	0	0	0	0	0	0
2:28598746:C:T	0	0	0	0	0	0	0	0
2:28632091:C:T	0	0	0	0	0	0	0	0
2:28778825:A:G	60	32	72	35	37	1.0	0.0	1.0
2:28869813:T:C	12	7	15	7	8	1.0	0.0	1.0
2:28869984:G:T	170	85	174	88	86	1.0	1.0	0.5
2:28906552:A:G	27	10	32	21	11	1	1	0
2:29003632:G:A	0	0	0	0	0	0	0	0
2:29017194:A:G	0	0	0	0	0	0	0	0
2:29064842:C:T	0	0	0	0	0	0	0	0
2:29071888:G:C	0	0	0	0	0	0	0	0
2:29072150:A:G	0	0	0	0	0	0	0	0
2:29072810:G:A	0	0	0	0	0	0	0	0
2:29074004:C:T	0	0	0	0	0	0	0	0
2:29193615:T:C	0	0	0	0	0	0	0	0
2:29221210:G:T	0	0	0	0	0	0	0	0
2:29222592:G:T	0	0	0	0	0	0	0	0
2:29226953:C:T	0	0	0	0	0	0	0	0
2:29232401:A:G	0	0	0	0	0	0	0	0
2:30158639:T:C	1016	558	1454	758	696	1.0	1.0	1.0
2:30753192:C:T	0	0	0	0	0	0	0	0
2:30758074:C:T	0	0	0	0	0	0	0	0
2:31199482:T:C	0	0	0	0	0	0	0	0
2:31339546:C:T	0	0	0	0	0	0	0	0
2:31348920:A:G	0	0	0	0	0	0	0	0
2:31377206:G:C	0	0	0	0	0	0	0	0
2:32250040:G:A	1	0	1	1	0	1	1	0
2:32251321:T:G	1	0	1	1	0	1	1	0
2:32414845:A:G	9	5	27	18	9	2	0	1
2:32488639:A:T	5	4	6	1	5	1	0	1
2:32597890:G:A	17	8	21	12	9	1	1	0
2:32640367:G:A	3	2	7	1	6	1	0	1
2:33134498:G:A	0	0	0	0	0	0	0	0
2:36477001:C:T	0	0	0	0	0	0	0	0
2:36554258:T:C	2	1	4	2	2	2.0	1.0	1.0
2:36555984:T:C	0	0	0	0	0	0	0	0
2:36556072:C:T	0	0	0	0	0	0	0	0
2:36583443:T:C	65	33	116	64	52	1	0	1
2:36590947:T:C	195	94	224	114	110	1	1	0
2:37003591:C:T	8	6	8	2	6	1.0	0.0	1.0
2:38070996:T:C	1	1	4	0	4	4	0	4
2:38285943:C:T	0	0	0	0	0	0	0	0
2:38309484:T:G	3	1	3	2	1	1	1	0
2:38481995:G:A	670	0	835	835	0	1.0	1.0	0.0
2:41157072:A:G	0	0	0	0	0	0	0	0
2:41819892:C:T	0	0	0	0	0	0	0	0
2:42169582:A:G	1330	771	2430	1258	1172	1.0	1.0	1.0
2:42333835:A:G	5	3	27	13	14	6	0	1
2:43398045:T:A	7	3	7	4	3	1	1	0
2:43566586:G:A	0	0	0	0	0	0	0	0
2:43570480:C:T	3	2	4	2	2	1	0	1
2:43574573:A:G	3	3	3	0	3	1	0	1
2:43577090:T:C	4	2	10	5	5	2.5	0.5	0.5
2:43681405:T:C	0	0	0	0	0	0	0	0
2:43681550:T:C	0	0	0	0	0	0	0	0
2:43700320:C:G	0	0	0	0	0	0	0	0
2:43839035:T:G	0	0	0	0	0	0	0	0
2:43844604:A:G	0	0	0	0	0	0	0	0
2:43877786:T:C	0	0	0	0	0	0	0	0
2:43896619:G:A	5	3	8	2	6	1	0	1
2:43896620:G:A	5	2	8	6	2	1	1	0
2:43974237:T:C	14	7	14	7	7	1.0	0.5	0.5
2:43982338:C:T	323	150	384	207	177	1	1	0
2:45413195:T:C	6	4	11	2	9	1.0	0.0	1.0
2:46818182:A:G	0	0	0	0	0	0	0	0
2:46905916:T:C	0	0	0	0	0	0	0	0
2:46907765:G:A	6	3	6	3	3	1.0	0.5	0.5
2:47373967:T:C	0	0	0	0	0	0	0	0
2:47512412:A:G	0	0	0	0	0	0	0	0
2:48581455:C:T	0	0	0	0	0	0	0	0
2:48582454:G:T	0	0	0	0	0	0	0	0
2:48646839:A:G	0	0	0	0	0	0	0	0
2:48721663:T:C	0	0	0	0	0	0	0	0
2:48721717:A:G	0	0	0	0	0	0	0	0
2:48776319:C:T	0	0	0	0	0	0	0	0
2:48962782:C:T	0	0	0	0	0	0	0	0
2:48963902:C:T	0	0	0	0	0	0	0	0
2:49154446:C:T	0	0	0	0	0	0	0	0
2:49973972:A:G	0	0	0	0	0	0	0	0
2:53888767:A:G	5	4	7	1	6	1	0	1
2:53892888:A:T	3	1	9	7	2	2	1	0
2:53893683:G:A	4	2	7	4	3	1.5	0.5	0.5
2:53899904:C:T	4	2	12	2	10	1.0	0.5	0.5
2:54334875:C:A	0	0	0	0	0	0	0	0
2:54529603:C:T	0	0	0	0	0	0	0	0
2:55222328:T:C	10	8	18	2	16	1.0	0.0	1.0
2:55233469:A:T	42	16	51	34	17	1.0	1.0	0.0
2:58461772:G:A	51	0	57	57	0	1	1	0
2:60460824:A:G	82	43	141	62	79	1.0	0.0	1.0
2:60711897:A:G	0	0	0	0	0	0	0	0
2:60734983:T:C	0	0	0	0	0	0	0	0
2:60735454:T:C	0	0	0	0	0	0	0	0
2:60735698:G:A	0	0	0	0	0	0	0	0
2:60948177:T:C	3	2	4	1	3	1	0	1
2:61157965:G:A	58	14	80	62	18	1.0	1.0	0.0
2:61157970:G:C	59	14	84	65	19	1	1	0
2:61162602:T:G	0	0	0	0	0	0	0	0
2:61188357:A:G	27	11	32	20	12	1	1	0
2:61223319:A:G	3	0	5	5	0	2	2	0
2:61417194:C:G	2	2	3	0	3	1.5	0.0	1.5
2:61420766:A:G	148	68	189	109	80	1.0	1.0	0.0
2:61589642:A:G	0	0	0	0	0	0	0	0
2:62506118:C:T	0	0	0	0	0	0	0	0
2:63588242:G:A	52	24	116	70	46	1.0	1.0	0.0
2:63622357:T:C	0	0	0	0	0	0	0	0
2:63684366:C:T	0	0	0	0	0	0	0	0
2:63842177:G:C	4	4	9	0	9	2.0	0.0	2.0
2:64347548:G:A	2	0	2	2	0	1.0	1.0	0.0
2:65018231:G:A	1	1	5	0	5	5	0	5
2:65069664:G:A	64	27	67	39	28	1.0	1.0	0.0
2:65071705:A:G	11	7	16	8	8	1	0	1
2:65071957:C:A	3	1	3	2	1	1	1	0
2:65072286:T:C	3	2	4	1	3	1	0	1
2:65205352:T:A	58	0	61	61	0	1.0	1.0	0.0
2:65205723:T:C	4	0	5	5	0	1.0	1.0	0.0
2:65205818:T:C	4	0	5	5	0	1.0	1.0	0.0
2:66568774:T:C	0	0	0	0	0	0	0	0
2:68125383:A:C	0	0	0	0	0	0	0	0
2:68157965:A:G	45	22	45	23	22	1	1	0
2:68161691:A:G	26	13	37	19	18	1.0	0.5	0.5
2:68188635:G:A	24	12	52	15	37	1.0	0.5	0.5
2:68284452:A:G	2	2	5	0	5	2.5	0.0	2.5
2:68319242:T:C	0	0	0	0	0	0	0	0
2:68319317:G:A	0	0	0	0	0	0	0	0
2:68365452:T:C	21	11	99	41	58	4	1	1
2:68380815:G:T	462	226	581	325	256	1.0	1.0	0.0
2:68395782:G:A	65	31	103	43	60	1	1	0
2:68526108:T:A	6	3	11	3	8	1.0	0.5	0.5
2:68529019:A:G	0	0	0	0	0	0	0	0
2:68538073:C:T	3	2	3	1	2	1	0	1
2:68655529:A:G	0	0	0	0	0	0	0	0
2:68775628:C:T	26	13	67	40	27	2.0	0.5	0.5
2:68813368:G:A	68	31	130	85	45	1.0	1.0	0.0
2:68822807:G:T	111	55	263	178	85	1	1	0
2:69102986:A:G	0	0	0	0	0	0	0	0
2:69431994:A:T	204	106	265	128	137	1.0	0.0	1.0
2:69465874:C:T	0	0	0	0	0	0	0	0
2:70297444:C:G	324	0	398	398	0	1.0	1.0	0.0
2:70831095:C:T	0	0	0	0	0	0	0	0
2:70831704:A:G	0	0	0	0	0	0	0	0
2:70933092:C:G	0	0	0	0	0	0	0	0
2:70935981:T:C	0	0	0	0	0	0	0	0
2:70943677:C:T	0	0	0	0	0	0	0	0
2:70960986:T:G	0	0	0	0	0	0	0	0
2:70963254:C:T	0	0	0	0	0	0	0	0
2:70984859:A:G	1	1	1	0	1	1	0	1
2:71070852:C:T	5	1	6	5	1	1	1	0
2:71124357:G:A	89	48	94	44	50	1	0	1
2:71133014:A:C	258	111	268	156	112	1.0	1.0	0.0
2:71133495:G:T	17	7	19	11	8	1	1	0
2:71202595:T:C	91	48	119	61	58	1	0	1
2:71406145:T:C	12	6	29	8	21	1.0	0.5	0.5
2:71406259:C:T	17	11	34	7	27	1	0	1
2:71551699:G:A	0	0	0	0	0	0	0	0
2:71553085:T:C	0	0	0	0	0	0	0	0
2:71564202:A:G	0	0	0	0	0	0	0	0
2:71570632:G:A	1	0	1	1	0	1	1	0
2:71611313:C:T	0	0	0	0	0	0	0	0
2:71611333:G:T	0	0	0	0	0	0	0	0
2:71679148:A:C	0	0	0	0	0	0	0	0
2:71984260:C:T	0	0	0	0	0	0	0	0
2:72731204:T:C	3	3	11	0	11	5	0	5
2:72998961:G:A	0	0	0	0	0	0	0	0
2:73089412:A:T	0	0	0	0	0	0	0	0
2:73112580:G:A	1	0	1	1	0	1	1	0
2:73234355:C:A	106	48	176	95	81	1.0	1.0	0.0
2:73251333:A:T	54	32	72	30	42	1.0	0.0	1.0
2:73291739:G:A	0	0	0	0	0	0	0	0
2:73448398:A:G	0	0	0	0	0	0	0	0
2:74101396:G:A	0	0	0	0	0	0	0	0
2:74516123:G:A	0	0	0	0	0	0	0	0
2:74886530:C:T	0	0	0	0	0	0	0	0
2:74886662:C:G	1	1	1	0	1	1	0	1
2:74887981:A:G	1	0	1	1	0	1	1	0
2:75198602:A:G	1	0	4	4	0	4	4	0
2:75493538:G:A	0	0	0	0	0	0	0	0
2:75651385:G:A	4	0	12	12	0	1.0	1.0	0.0
2:75687909:C:T	0	0	0	0	0	0	0	0
2:83219084:T:C	0	0	0	0	0	0	0	0
2:84291314:T:C	0	0	0	0	0	0	0	0
2:84694309:A:G	0	0	0	0	0	0	0	0
2:84718345:G:A	1	0	1	1	0	1	1	0
2:84870466:C:T	1	1	1	0	1	1	0	1
2:84916282:A:T	0	0	0	0	0	0	0	0
2:85262157:A:G	0	0	0	0	0	0	0	0
2:85262174:T:A	0	0	0	0	0	0	0	0
2:85368695:C:T	6	4	6	2	4	1.0	0.0	1.0
2:85371504:C:T	3	3	3	0	3	1	0	1
2:85394936:T:C	88	41	109	62	47	1.0	1.0	0.0
2:85398099:T:G	69	30	92	61	31	1	1	0
2:85401860:C:T	1652	1013	2828	1448	1380	1.0	1.0	1.0
2:85666618:G:A	0	0	0	0	0	0	0	0
2:85697606:C:T	5	2	5	3	2	1	1	0
2:85698406:A:G	0	0	0	0	0	0	0	0
2:85698633:C:G	3	2	7	3	4	1	1	1
2:85861188:T:C	98	53	111	45	66	1.0	0.0	1.0
2:86032320:C:T	3	2	7	2	5	2	0	1
2:86070057:G:A	1	0	3	3	0	3	3	0
2:86144760:T:C	20	10	25	11	14	1.0	0.5	0.5
2:86173701:G:A	55	27	63	32	31	1	1	0
2:86213595:T:C	1	1	1	0	1	1	0	1
2:86751970:G:A	4	1	4	3	1	1.0	1.0	0.0
2:87756945:T:C	3	3	3	0	3	1	0	1
2:88173272:G:A	43	43	51	0	51	1	0	1
2:88575373:C:A	4	2	8	2	6	1.0	0.5	0.5
2:88595605:T:C	3	2	4	1	3	1	0	1
2:88595833:T:C	0	0	0	0	0	0	0	0
2:88613755:G:C	3	1	3	2	1	1	1	0
2:88802798:G:T	0	0	0	0	0	0	0	0
2:90121808:C:T	0	0	0	0	0	0	0	0
2:90173209:A:G	0	0	0	0	0	0	0	0
2:91748437:G:A	0	0	0	0	0	0	0	0
2:91776096:G:A	0	0	0	0	0	0	0	0
2:91843334:A:T	0	0	0	0	0	0	0	0
2:94798832:T:C	0	0	0	0	0	0	0	0
2:94857002:C:G	0	0	0	0	0	0	0	0
2:94871756:C:T	0	0	0	0	0	0	0	0
2:94871877:A:G	0	0	0	0	0	0	0	0
2:94871899:G:A	0	0	0	0	0	0	0	0
2:94876688:C:G	0	0	0	0	0	0	0	0
2:94887038:C:T	0	0	0	0	0	0	0	0
2:95149561:C:T	2	0	2	2	0	1.0	1.0	0.0
2:95515044:G:T	0	0	0	0	0	0	0	0
2:95519966:C:T	1	1	3	0	3	3	0	3
2:95577368:C:G	0	0	0	0	0	0	0	0
2:95853744:C:T	6	4	23	4	19	3.0	0.0	2.0
2:96130118:T:C	0	0	0	0	0	0	0	0
2:96278815:G:A	33	9	41	29	12	1	1	0
2:96500467:A:G	0	0	0	0	0	0	0	0
2:96686103:A:G	0	0	0	0	0	0	0	0
2:96842170:T:G	0	0	0	0	0	0	0	0
2:96947879:T:C	0	0	0	0	0	0	0	0
2:96951403:T:C	0	0	0	0	0	0	0	0
2:97162102:G:A	2	0	3	3	0	1.5	1.5	0.0
2:97183482:T:C	5	3	7	2	5	1	0	1
2:97185332:A:G	6	4	9	3	6	1.0	0.0	1.0
2:97194750:T:C	14	2	18	16	2	1.0	1.0	0.0
2:97198596:CC:AT	14	11	30	4	26	1.0	0.0	1.0
2:97211703:T:C	14	11	28	5	23	2.0	0.0	1.5
2:97547721:C:G	14	7	21	9	12	1.0	0.5	0.5
2:97656827:C:T	15	10	18	5	13	1	0	1
2:97658064:G:C	25	12	39	17	22	1	1	0
2:97792461:C:G	13	5	20	15	5	1	1	0
2:98093221:T:C	0	0	0	0	0	0	0	0
2:98192969:T:C	0	0	0	0	0	0	0	0
2:99102320:T:C	2	1	3	1	2	1.5	0.5	1.0
2:99150610:G:A	1	1	4	0	4	4	0	4
2:99162522:T:C	5	2	5	3	2	1	1	0
2:99162668:T:C	1	0	1	1	0	1	1	0
2:99195645:T:C	18	8	38	19	19	1.0	1.0	0.0
2:99360350:G:A	397	204	541	276	265	1	1	1
2:99379341:T:C	13	6	14	7	7	1	1	0
2:99394347:A:G	9	4	12	8	4	1	1	0
2:99403033:A:G	22	10	25	13	12	1.0	1.0	0.0
2:100299853:A:G	0	0	0	0	0	0	0	0
2:100300647:C:T	0	0	0	0	0	0	0	0
2:100393620:G:C	0	0	0	0	0	0	0	0
2:100425660:T:G	0	0	0	0	0	0	0	0
2:100821099:G:A	0	0	0	0	0	0	0	0
2:100821139:C:G	0	0	0	0	0	0	0	0
2:101029682:G:A	3	3	3	0	3	1	0	1
2:101450621:T:C	0	0	0	0	0	0	0	0
2:101521722:C:T	0	0	0	0	0	0	0	0
2:102351615:T:C	0	0	0	0	0	0	0	0
2:102351751:CA:AG	0	0	0	0	0	0	0	0
2:102351825:T:C	0	0	0	0	0	0	0	0
2:102384942:C:T	1	1	2	0	2	2	0	2
2:102479072:T:C	0	0	0	0	0	0	0	0
2:105089049:C:T	14	7	19	7	12	1.0	0.5	0.5
2:105097239:A:G	13	4	14	10	4	1	1	0
2:105272892:G:A	2	1	2	1	1	1.0	0.5	0.5
2:106253635:G:A	1	0	1	1	0	1	1	0
2:106457013:T:A	0	0	0	0	0	0	0	0
2:106457045:C:T	0	0	0	0	0	0	0	0
2:106468283:A:G	0	0	0	0	0	0	0	0
2:106491055:C:T	0	0	0	0	0	0	0	0
2:106491111:G:C	0	0	0	0	0	0	0	0
2:106697639:A:G	0	0	0	0	0	0	0	0
2:106698041:T:C	0	0	0	0	0	0	0	0
2:106806732:G:A	0	0	0	0	0	0	0	0
2:106941256:G:A	0	0	0	0	0	0	0	0
2:107826993:G:C	0	0	0	0	0	0	0	0
2:107827035:G:A	0	0	0	0	0	0	0	0
2:107859502:A:G	0	0	0	0	0	0	0	0
2:108258742:G:A	0	0	0	0	0	0	0	0
2:108258788:T:C	0	0	0	0	0	0	0	0
2:108378352:C:G	0	0	0	0	0	0	0	0
2:108489925:A:G	10	8	11	3	8	1.0	0.0	1.0
2:108659722:C:T	572	1	731	730	1	1.0	1.0	0.0
2:108783811:C:T	20	11	20	9	11	1.0	0.0	1.0
2:108812690:T:A	3	2	9	5	4	3	0	1
2:109615620:G:A	0	0	0	0	0	0	0	0
2:110165126:C:T	4	0	9	9	0	2.0	2.0	0.0
2:110184919:G:A	0	0	0	0	0	0	0	0
2:110185117:T:C	0	0	0	0	0	0	0	0
2:110968234:A:G	0	0	0	0	0	0	0	0
2:111150114:T:C	0	0	0	0	0	0	0	0
2:111384593:G:C	0	0	0	0	0	0	0	0
2:111856852:G:A	2	0	5	5	0	2.5	2.5	0.0
2:111994351:G:A	0	0	0	0	0	0	0	0
2:111997251:G:T	0	0	0	0	0	0	0	0
2:111997424:A:G	0	0	0	0	0	0	0	0
2:112008396:A:G	0	0	0	0	0	0	0	0
2:112520372:T:C	2	1	7	1	6	3.5	0.5	3.0
2:112550939:T:A	5	4	10	3	7	1	0	1
2:112551896:C:T	2	1	7	3	4	3.5	1.5	2.0
2:112586470:T:C	1	0	1	1	0	1	1	0
2:112588935:A:C	109	58	122	59	63	1	0	1
2:112762552:G:A	0	0	0	0	0	0	0	0
2:112781669:C:T	0	0	0	0	0	0	0	0
2:113005998:A:G	0	0	0	0	0	0	0	0
2:113074368:T:C	0	0	0	0	0	0	0	0
2:113074735:T:C	0	0	0	0	0	0	0	0
2:113583086:G:A	0	0	0	0	0	0	0	0
2:113583100:C:A	0	0	0	0	0	0	0	0
2:113583129:A:G	0	0	0	0	0	0	0	0
2:113719183:A:C	3	2	6	4	2	1	0	1
2:115753241:G:C	0	0	0	0	0	0	0	0
2:117995521:C:T	0	0	0	0	0	0	0	0
2:118013990:C:A	52	31	56	22	34	1.0	0.0	1.0
2:119157673:T:C	0	0	0	0	0	0	0	0
2:119230989:G:A	0	0	0	0	0	0	0	0
2:119321202:T:C	68	37	106	42	64	1.0	0.0	1.0
2:119441564:A:G	0	0	0	0	0	0	0	0
2:119546244:A:T	0	0	0	0	0	0	0	0
2:127053466:G:A	0	0	0	0	0	0	0	0
2:127059125:G:A	54	31	71	34	37	1.0	0.0	1.0
2:127195478:A:C	0	0	0	0	0	0	0	0
2:127564195:G:A	0	0	0	0	0	0	0	0
2:127609517:G:A	0	0	0	0	0	0	0	0
2:127612321:A:G	0	0	0	0	0	0	0	0
2:127643033:C:T	0	0	0	0	0	0	0	0
2:127643516:A:G	0	0	0	0	0	0	0	0
2:127764809:T:C	3	2	3	1	2	1	0	1
2:127853074:T:C	118	69	146	60	86	1.0	0.0	1.0
2:128120440:G:A	0	0	0	0	0	0	0	0
2:128318387:T:C	1	1	1	0	1	1	0	1
2:129496404:T:G	0	0	0	0	0	0	0	0
2:129993568:C:A	0	0	0	0	0	0	0	0
2:129994033:G:A	0	0	0	0	0	0	0	0
2:130007392:T:A	0	0	0	0	0	0	0	0
2:130139645:T:C	0	0	0	0	0	0	0	0
2:130339674:G:A	3	1	3	2	1	1	1	0
2:130339680:G:C	2	0	2	2	0	1.0	1.0	0.0
2:130342923:G:A	41	17	44	25	19	1	1	0
2:130763090:T:C	0	0	0	0	0	0	0	0
2:130763372:C:G	0	0	0	0	0	0	0	0
2:130915377:A:G	0	0	0	0	0	0	0	0
2:130916129:G:A	0	0	0	0	0	0	0	0
2:130916712:A:G	0	0	0	0	0	0	0	0
2:131044472:C:T	0	0	0	0	0	0	0	0
2:131178891:C:T	0	0	0	0	0	0	0	0
2:131191596:G:A	0	0	0	0	0	0	0	0
2:131195756:C:T	0	0	0	0	0	0	0	0
2:131195830:T:C	0	0	0	0	0	0	0	0
2:131442699:C:T	0	0	0	0	0	0	0	0
2:131442995:C:T	0	0	0	0	0	0	0	0
2:131591936:G:T	0	0	0	0	0	0	0	0
2:131592075:T:G	0	0	0	0	0	0	0	0
2:131611581:G:C	0	0	0	0	0	0	0	0
2:131723413:C:T	0	0	0	0	0	0	0	0
2:131723953:CAAC:AAAT	0	0	0	0	0	0	0	0
2:132037865:T:A	0	0	0	0	0	0	0	0
2:132037910:T:C	0	0	0	0	0	0	0	0
2:132417191:C:T	0	0	0	0	0	0	0	0
2:132417426:A:G	0	0	0	0	0	0	0	0
2:132781993:G:A	0	0	0	0	0	0	0	0
2:132783032:G:T	0	0	0	0	0	0	0	0
2:132785012:C:G	0	0	0	0	0	0	0	0
2:132796715:A:G	0	0	0	0	0	0	0	0
2:134952752:A:G	1	0	1	1	0	1	1	0
2:134953946:C:T	5	0	8	8	0	1	1	0
2:134954087:G:A	6	1	6	5	1	1.0	1.0	0.0
2:134983306:A:G	0	0	0	0	0	0	0	0
2:134987822:G:A	0	0	0	0	0	0	0	0
2:134987975:C:T	0	0	0	0	0	0	0	0
2:135135802:A:G	11	7	15	5	10	1	0	1
2:135153852:T:C	23	15	59	12	47	2	0	1
2:136115979:A:T	76	41	87	36	51	1.0	0.0	1.0
2:136329754:A:G	0	0	0	0	0	0	0	0
2:137056907:C:G	0	0	0	0	0	0	0	0
2:137618402:A:T	0	0	0	0	0	0	0	0
2:138288282:A:G	0	0	0	0	0	0	0	0
2:140234768:C:A	0	0	0	0	0	0	0	0
2:140274519:C:T	0	0	0	0	0	0	0	0
2:140503099:A:G	0	0	0	0	0	0	0	0
2:140517007:T:C	0	0	0	0	0	0	0	0
2:140700416:T:A	0	0	0	0	0	0	0	0
2:140950299:G:T	0	0	0	0	0	0	0	0
2:140994023:G:A	0	0	0	0	0	0	0	0
2:142130807:G:C	0	0	0	0	0	0	0	0
2:142985113:T:C	18	7	30	23	7	1.0	1.0	0.0
2:144512808:G:A	5	3	8	5	3	1	0	1
2:145826744:G:A	0	0	0	0	0	0	0	0
2:147899548:G:A	0	0	0	0	0	0	0	0
2:147958859:T:C	78	28	92	59	33	1.0	1.0	0.0
2:151261757:GCAGA:ACAGG	33	14	47	24	23	1	1	0
2:151282902:G:A	238	163	321	110	211	1.0	0.0	1.0
2:151455056:G:A	3	2	3	1	2	1	0	1
2:151463604:G:A	9	3	17	6	11	1	1	0
2:151465581:A:T	11	5	11	6	5	1	1	0
2:151474904:C:G	7	4	8	3	5	1	0	1
2:151490465:T:C	2	1	2	1	1	1.0	0.5	0.5
2:151496329:C:G	0	0	0	0	0	0	0	0
2:151531039:T:C	2	0	5	5	0	2.5	2.5	0.0
2:151640012:A:G	0	0	0	0	0	0	0	0
2:151643935:C:G	0	0	0	0	0	0	0	0
2:151664582:C:T	0	0	0	0	0	0	0	0
2:151671058:C:T	0	0	0	0	0	0	0	0
2:151679984:T:A	0	0	0	0	0	0	0	0
2:151717467:A:G	2	1	2	1	1	1.0	0.5	0.5
2:152390555:G:A	0	0	0	0	0	0	0	0
2:152876957:A:G	0	0	0	0	0	0	0	0
2:157780398:G:A	2	1	4	3	1	2.0	1.5	0.5
2:158065569:C:G	0	0	0	0	0	0	0	0
2:158807087:T:C	0	0	0	0	0	0	0	0
2:158815740:G:A	0	0	0	0	0	0	0	0
2:159325863:T:C	5	4	5	1	4	1	0	1
2:159743206:C:G	30	18	36	16	20	1.0	0.0	1.0
2:159747941:C:T	11	4	11	7	4	1	1	0
2:160126549:G:C	0	0	0	0	0	0	0	0
2:160278489:G:C	1	0	1	1	0	1	1	0
2:160318182:C:T	48	28	57	26	31	1.0	0.0	1.0
2:161503472:T:C	0	0	0	0	0	0	0	0
2:161505388:A:G	0	0	0	0	0	0	0	0
2:162174974:G:T	0	0	0	0	0	0	0	0
2:164568327:A:G	0	0	0	0	0	0	0	0
2:164619743:A:T	0	0	0	0	0	0	0	0
2:164694894:G:A	44	23	58	23	35	1.0	0.0	1.0
2:165131262:T:G	1	0	1	1	0	1	1	0
2:165139597:T:A	0	0	0	0	0	0	0	0
2:165146969:G:A	0	0	0	0	0	0	0	0
2:165388720:T:A	0	0	0	0	0	0	0	0
2:166288485:T:C	0	0	0	0	0	0	0	0
2:166306533:T:C	0	0	0	0	0	0	0	0
2:166311583:C:T	0	0	0	0	0	0	0	0
2:166477575:G:T	0	0	0	0	0	0	0	0
2:167713948:T:C	0	0	0	0	0	0	0	0
2:167715583:G:T	0	0	0	0	0	0	0	0
2:167715588:A:G	0	0	0	0	0	0	0	0
2:168850918:C:T	0	0	0	0	0	0	0	0
2:168864867:G:A	0	0	0	0	0	0	0	0
2:168908036:C:G	0	0	0	0	0	0	0	0
2:168932506:T:C	0	0	0	0	0	0	0	0
2:168970367:C:T	0	0	0	0	0	0	0	0
2:168973818:A:G	0	0	0	0	0	0	0	0
2:169081698:G:A	0	0	0	0	0	0	0	0
2:169140541:G:A	0	0	0	0	0	0	0	0
2:169196995:C:T	0	0	0	0	0	0	0	0
2:169205568:G:C	0	0	0	0	0	0	0	0
2:169242963:T:C	0	0	0	0	0	0	0	0
2:169246826:T:C	0	0	0	0	0	0	0	0
2:169259078:T:C	0	0	0	0	0	0	0	0
2:169271049:G:A	0	0	0	0	0	0	0	0
2:169273018:G:A	0	0	0	0	0	0	0	0
2:169294161:G:A	0	0	0	0	0	0	0	0
2:169499434:A:T	0	0	0	0	0	0	0	0
2:169510589:G:A	0	0	0	0	0	0	0	0
2:169546520:T:C	3	2	3	1	2	1	0	1
2:169555183:T:C	2	1	10	1	9	5.0	0.5	4.5
2:169636593:T:A	65	23	69	46	23	1	1	0
2:169637353:A:G	72	38	78	38	40	1.0	0.5	1.0
2:169694329:A:G	0	0	0	0	0	0	0	0
2:170214402:T:C	4	0	6	6	0	1.0	1.0	0.0
2:170822115:T:C	0	0	0	0	0	0	0	0
2:170929729:C:T	23	11	24	12	12	1	1	0
2:171053803:C:T	11	4	12	8	4	1	1	0
2:172101522:T:C	0	0	0	0	0	0	0	0
2:172475080:G:A	1	0	1	1	0	1	1	0
2:172487375:C:T	0	0	0	0	0	0	0	0
2:172487429:A:T	0	0	0	0	0	0	0	0
2:172586346:T:C	7	1	16	15	1	1	1	0
2:173232378:A:G	0	0	0	0	0	0	0	0
2:173238432:T:C	0	0	0	0	0	0	0	0
2:173486230:C:T	0	0	0	0	0	0	0	0
2:174082032:T:C	21	12	34	17	17	1	0	1
2:174335141:G:T	0	0	0	0	0	0	0	0
2:174336175:G:C	0	0	0	0	0	0	0	0
2:174398335:G:A	3	2	3	1	2	1	0	1
2:174436269:G:A	1	1	1	0	1	1	0	1
2:176002239:C:T	9	5	9	4	5	1	0	1
2:176100176:G:A	0	0	0	0	0	0	0	0
2:176242545:T:C	0	0	0	0	0	0	0	0
2:176242628:A:G	0	0	0	0	0	0	0	0
2:177617090:G:T	0	0	0	0	0	0	0	0
2:177997946:C:T	0	0	0	0	0	0	0	0
2:177998357:G:A	0	0	0	0	0	0	0	0
2:177998533:G:A	0	0	0	0	0	0	0	0
2:178336321:G:T	0	0	0	0	0	0	0	0
2:178339070:G:A	0	0	0	0	0	0	0	0
2:178444438:G:A	50	0	109	109	0	1.0	1.0	0.0
2:178575302:G:A	1	1	1	0	1	1	0	1
2:178597767:A:G	2	2	2	0	2	1.0	0.0	1.0
2:178651744:C:T	8	5	25	3	22	1.0	0.0	1.0
2:178689578:C:T	7	3	7	4	3	1	1	0
2:178740998:T:C	0	0	0	0	0	0	0	0
2:178785681:G:A	1	0	2	2	0	2	2	0
2:178785974:C:T	2	2	2	0	2	1.0	0.0	1.0
2:179115203:T:C	0	0	0	0	0	0	0	0
2:179945453:C:T	18	8	18	10	8	1.0	1.0	0.0
2:179945537:A:T	19	9	23	11	12	1	1	0
2:179970702:T:C	11	7	19	12	7	1	0	1
2:181986155:A:G	0	0	0	0	0	0	0	0
2:182728970:C:T	7	3	11	6	5	1	1	0
2:182757820:T:G	14	10	20	5	15	1.0	0.0	1.0
2:182762777:A:G	21	10	22	12	10	1	1	0
2:183260845:A:G	0	0	0	0	0	0	0	0
2:185788819:G:A	0	0	0	0	0	0	0	0
2:185791930:C:T	0	0	0	0	0	0	0	0
2:185802633:A:C	0	0	0	0	0	0	0	0
2:185806252:T:C	0	0	0	0	0	0	0	0
2:185808170:A:G	0	0	0	0	0	0	0	0
2:186834024:G:A	0	0	0	0	0	0	0	0
2:187002015:G:A	0	0	0	0	0	0	0	0
2:188997371:G:A	0	0	0	0	0	0	0	0
2:188999354:G:A	0	0	0	0	0	0	0	0
2:188999856:T:C	0	0	0	0	0	0	0	0
2:189039360:A:G	0	0	0	0	0	0	0	0
2:189746462:G:T	5	2	7	3	4	1	1	0
2:190200027:C:T	0	0	0	0	0	0	0	0
2:190296896:T:C	267	155	378	161	217	1	0	1
2:190319749:A:G	47	26	56	27	29	1	0	1
2:190360255:G:T	110	43	236	145	91	1.0	1.0	0.0
2:190366732:G:A	38	11	57	44	13	1.0	1.0	0.0
2:190366777:G:A	17	5	23	16	7	1	1	0
2:190514542:G:A	3	3	5	0	5	1	0	1
2:193277046:G:A	0	0	0	0	0	0	0	0
2:195738049:G:A	1	0	5	5	0	5	5	0
2:195960514:C:A	0	0	0	0	0	0	0	0
2:197393071:T:C	80	28	91	60	31	1.0	1.0	0.0
2:197400802:A:G	52	28	58	27	31	1.0	0.0	1.0
2:197418581:T:C	97	48	114	57	57	1	1	0
2:197497294:T:C	391	194	424	219	205	1	1	0
2:197644227:G:A	0	0	0	0	0	0	0	0
2:199660353:A:G	0	0	0	0	0	0	0	0
2:200533001:G:A	15	13	15	2	13	1	0	1
2:200572611:T:C	0	0	0	0	0	0	0	0
2:201284866:G:C	29	16	45	15	30	1	0	1
2:201289477:C:T	0	0	0	0	0	0	0	0
2:201350769:C:G	0	0	0	0	0	0	0	0
2:201387816:G:A	2	0	2	2	0	1.0	1.0	0.0
2:201399433:C:T	2	1	2	1	1	1.0	0.5	0.5
2:201638957:G:A	2	1	2	1	1	1.0	0.5	0.5
2:202099657:G:A	0	0	0	0	0	0	0	0
2:202188224:G:A	0	0	0	0	0	0	0	0
2:202303450:C:T	144	85	189	78	111	1.0	0.0	1.0
2:202841710:C:T	2	1	12	7	5	6.0	3.5	2.5
2:202882799:A:G	0	0	0	0	0	0	0	0
2:203126066:T:G	0	0	0	0	0	0	0	0
2:204965268:C:T	0	0	0	0	0	0	0	0
2:205104496:G:A	0	0	0	0	0	0	0	0
2:205301856:G:A	0	0	0	0	0	0	0	0
2:205440432:C:T	0	0	0	0	0	0	0	0
2:205700776:C:T	0	0	0	0	0	0	0	0
2:205725962:T:C	0	0	0	0	0	0	0	0
2:205950105:C:T	0	0	0	0	0	0	0	0
2:206017806:G:C	16	3	30	23	7	1.0	1.0	0.0
2:206176329:T:C	0	0	0	0	0	0	0	0
2:206236293:G:T	0	0	0	0	0	0	0	0
2:206236369:A:T	0	0	0	0	0	0	0	0
2:206305007:G:A	21	0	67	67	0	3	3	0
2:206419564:C:T	0	0	0	0	0	0	0	0
2:206955552:G:A	0	0	0	0	0	0	0	0
2:206959660:T:G	0	0	0	0	0	0	0	0
2:206960932:A:T	0	0	0	0	0	0	0	0
2:207134076:C:T	0	0	0	0	0	0	0	0
2:207613331:A:G	33	16	35	17	18	1	1	0
2:207977240:A:G	1	0	2	2	0	2	2	0
2:208057510:G:T	4	0	4	4	0	1.0	1.0	0.0
2:208112411:A:G	0	0	0	0	0	0	0	0
2:208112437:C:T	0	0	0	0	0	0	0	0
2:208124313:A:G	0	0	0	0	0	0	0	0
2:208142835:T:G	0	0	0	0	0	0	0	0
2:208145834:A:G	0	0	0	0	0	0	0	0
2:209967474:C:T	0	0	0	0	0	0	0	0
2:210608433:C:A	0	0	0	0	0	0	0	0
2:210616533:C:G	0	0	0	0	0	0	0	0
2:211387139:T:C	0	0	0	0	0	0	0	0
2:213862497:A:C	0	0	0	0	0	0	0	0
2:213930019:A:C	0	0	0	0	0	0	0	0
2:214728798:T:C	5	5	5	0	5	1	0	1
2:214769331:C:T	0	0	0	0	0	0	0	0
2:214780740:C:G	0	0	0	0	0	0	0	0
2:214780821:C:G	3	3	3	0	3	1	0	1
2:214954039:G:A	0	0	0	0	0	0	0	0
2:214955289:G:A	0	0	0	0	0	0	0	0
2:214986579:A:G	0	0	0	0	0	0	0	0
2:214989432:C:T	0	0	0	0	0	0	0	0
2:215011647:T:C	0	0	0	0	0	0	0	0
2:215325297:C:G	109	53	124	70	54	1	1	0
2:215344808:C:T	25	16	36	9	27	1	0	1
2:215364969:A:G	0	0	0	0	0	0	0	0
2:215371989:T:C	0	0	0	0	0	0	0	0
2:215409733:G:A	0	0	0	0	0	0	0	0
2:216039296:A:T	3	1	3	2	1	1	1	0
2:216058956:C:T	7	2	16	8	8	1	1	0
2:216100221:C:T	0	0	0	0	0	0	0	0
2:216610812:A:G	0	0	0	0	0	0	0	0
2:216661798:C:T	0	0	0	0	0	0	0	0
2:216678910:G:A	0	0	0	0	0	0	0	0
2:217713096:C:G	0	0	0	0	0	0	0	0
2:217760572:T:C	0	0	0	0	0	0	0	0
2:217842134:T:C	0	0	0	0	0	0	0	0
2:217880962:G:A	0	0	0	0	0	0	0	0
2:218135587:C:T	0	0	0	0	0	0	0	0
2:218263773:C:G	0	0	0	0	0	0	0	0
2:218275565:G:C	7	1	7	6	1	1	1	0
2:218403058:C:T	158	74	516	305	211	3.0	1.0	0.0
2:218827078:G:A	0	0	0	0	0	0	0	0
2:218827973:G:C	0	0	0	0	0	0	0	0
2:218841971:C:T	0	0	0	0	0	0	0	0
2:218890289:T:A	2	0	2	2	0	1.0	1.0	0.0
2:218960489:G:A	0	0	0	0	0	0	0	0
2:219038536:T:G	0	0	0	0	0	0	0	0
2:219039001:C:T	0	0	0	0	0	0	0	0
2:219040525:T:C	0	0	0	0	0	0	0	0
2:219055315:A:G	0	0	0	0	0	0	0	0
2:219055843:C:T	0	0	0	0	0	0	0	0
2:219173034:A:G	30	18	47	24	23	1.0	0.0	1.0
2:219175608:A:G	503	286	653	281	372	1	0	1
2:219176369:G:A	15	12	35	8	27	2	0	2
2:219218557:C:T	13	9	43	22	21	4	0	1
2:219222719:T:C	8	4	18	6	12	1.0	0.5	0.5
2:219243578:T:C	0	0	0	0	0	0	0	0
2:219271629:G:A	0	0	0	0	0	0	0	0
2:219271649:T:C	0	0	0	0	0	0	0	0
2:219332599:C:T	0	0	0	0	0	0	0	0
2:219332666:C:A	0	0	0	0	0	0	0	0
2:219540004:G:A	2	0	2	2	0	1.0	1.0	0.0
2:219540508:G:A	1	1	1	0	1	1	0	1
2:219550924:T:C	0	0	0	0	0	0	0	0
2:222297170:A:G	0	0	0	0	0	0	0	0
2:222452493:G:A	0	0	0	0	0	0	0	0
2:222571888:C:T	3	1	3	2	1	1	1	0
2:222726702:G:C	3	3	3	0	3	1	0	1
2:223959900:A:G	47	21	65	37	28	1	1	0
2:224569728:A:G	6	3	12	6	6	2.0	0.5	0.5
2:224854976:G:A	29	15	66	30	36	1	0	1
2:226796327:T:C	0	0	0	0	0	0	0	0
2:227007466:G:A	10	4	34	14	20	1.0	1.0	0.0
2:227027903:C:T	5	4	13	1	12	1	0	1
2:227028004:C:T	5	4	9	2	7	2	0	1
2:227032170:C:T	1	0	1	1	0	1	1	0
2:227032260:C:T	2	0	2	2	0	1.0	1.0	0.0
2:227051116:G:A	5	3	6	3	3	1	0	1
2:227238007:G:C	293	168	855	409	446	2	0	1
2:227238036:C:A	164	67	540	298	242	3.0	1.0	0.0
2:227270915:C:T	5	1	19	18	1	1	1	0
2:227329764:AG:TT	6	5	6	1	5	1.0	0.0	1.0
2:227357009:A:G	27	13	27	14	13	1	1	0
2:227551996:A:G	8	2	26	20	6	3.0	2.5	0.0
2:227628495:G:A	0	0	0	0	0	0	0	0
2:227700940:G:A	0	0	0	0	0	0	0	0
2:227870120:T:A	0	0	0	0	0	0	0	0
2:227870240:G:A	0	0	0	0	0	0	0	0
2:227870314:GTACAC:CTACGT	0	0	0	0	0	0	0	0
2:227870424:T:C	0	0	0	0	0	0	0	0
2:227870467:G:A	0	0	0	0	0	0	0	0
2:227870470:T:C	0	0	0	0	0	0	0	0
2:228018254:T:C	0	0	0	0	0	0	0	0
2:228019005:T:C	0	0	0	0	0	0	0	0
2:228352775:C:T	1	0	1	1	0	1	1	0
2:230207994:C:T	408	214	652	328	324	1.0	1.0	1.0
2:230212397:G:A	269	133	356	187	169	1	1	0
2:230245867:C:T	220	91	685	463	222	2.0	1.0	0.0
2:230383546:C:T	45	24	59	27	32	1	0	1
2:230449378:G:A	3	2	4	1	3	1	0	1
2:230462576:A:G	13	8	36	8	28	2	0	1
2:230469048:A:G	184	81	296	171	125	1.0	1.0	0.0
2:230541355:G:A	18	9	27	16	11	1.0	0.5	0.5
2:230573787:C:T	2	1	3	1	2	1.5	0.5	1.0
2:230910129:G:A	1	1	1	0	1	1	0	1
2:230910582:T:G	0	0	0	0	0	0	0	0
2:230996356:T:C	0	0	0	0	0	0	0	0
2:231331852:C:T	1	1	5	0	5	5	0	5
2:231331885:G:A	1	1	5	0	5	5	0	5
2:231398416:G:A	1	1	1	0	1	1	0	1
2:231434101:C:T	3	0	3	3	0	1	1	0
2:232379271:A:T	0	0	0	0	0	0	0	0
2:232380431:T:C	0	0	0	0	0	0	0	0
2:232445587:T:C	0	0	0	0	0	0	0	0
2:232535364:A:G	0	0	0	0	0	0	0	0
2:232536197:T:C	0	0	0	0	0	0	0	0
2:232545584:C:T	0	0	0	0	0	0	0	0
2:232574076:G:A	0	0	0	0	0	0	0	0
2:232606133:G:A	1	0	6	6	0	6	6	0
2:232858472:G:A	1	1	1	0	1	1	0	1
2:232920305:G:A	0	0	0	0	0	0	0	0
2:233034416:C:A	0	0	0	0	0	0	0	0
2:233618472:A:G	0	0	0	0	0	0	0	0
2:233637215:C:T	0	0	0	0	0	0	0	0
2:233681970:C:A	0	0	0	0	0	0	0	0
2:233682559:T:C	0	0	0	0	0	0	0	0
2:233682693:G:A	0	0	0	0	0	0	0	0
2:233693023:T:G	0	0	0	0	0	0	0	0
2:233693319:A:G	0	0	0	0	0	0	0	0
2:233693545:A:G	0	0	0	0	0	0	0	0
2:233693556:A:C	0	0	0	0	0	0	0	0
2:233713783:T:C	0	0	0	0	0	0	0	0
2:233721797:A:G	0	0	0	0	0	0	0	0
2:233729157:T:C	0	0	0	0	0	0	0	0
2:233729207:G:A	0	0	0	0	0	0	0	0
2:233729266:T:C	0	0	0	0	0	0	0	0
2:233729603:A:G	0	0	0	0	0	0	0	0
2:233729934:A:G	0	0	0	0	0	0	0	0
2:233743662:G:T	0	0	0	0	0	0	0	0
2:233755003:C:G	0	0	0	0	0	0	0	0
2:233779390:C:A	0	0	0	0	0	0	0	0
2:233831490:G:A	0	0	0	0	0	0	0	0
2:233833162:C:T	0	0	0	0	0	0	0	0
2:233841896:G:C	0	0	0	0	0	0	0	0
2:233849854:G:A	0	0	0	0	0	0	0	0
2:233852579:C:T	0	0	0	0	0	0	0	0
2:233866700:G:A	2	1	3	2	1	1.5	1.0	0.5
2:235041543:T:C	0	0	0	0	0	0	0	0
2:235041640:A:C	0	0	0	0	0	0	0	0
2:237334649:G:A	0	0	0	0	0	0	0	0
2:237336138:T:C	0	0	0	0	0	0	0	0
2:237336280:C:T	0	0	0	0	0	0	0	0
2:237340465:T:C	0	0	0	0	0	0	0	0
2:237340987:C:T	0	0	0	0	0	0	0	0
2:237341074:G:A	0	0	0	0	0	0	0	0
2:237350171:C:G	0	0	0	0	0	0	0	0
2:237374962:G:A	0	0	0	0	0	0	0	0
2:237510968:A:G	0	0	0	0	0	0	0	0
2:237525606:C:T	0	0	0	0	0	0	0	0
2:237534583:A:G	0	0	0	0	0	0	0	0
2:237540364:T:C	0	0	0	0	0	0	0	0
2:237540380:T:C	0	0	0	0	0	0	0	0
2:237540464:A:G	0	0	0	0	0	0	0	0
2:237553681:A:G	0	0	0	0	0	0	0	0
2:237574521:T:C	0	0	0	0	0	0	0	0
2:237575086:A:G	0	0	0	0	0	0	0	0
2:237576608:G:A	0	0	0	0	0	0	0	0
2:237586038:G:A	0	0	0	0	0	0	0	0
2:237760140:A:G	70	36	97	41	56	1.0	0.0	1.0
2:237760159:A:G	67	32	98	42	56	1	1	0
2:237763782:G:C	73	33	76	42	34	1	1	0
2:237764060:C:G	32	16	67	36	31	1.0	1.0	0.5
2:238102078:T:C	0	0	0	0	0	0	0	0
2:238107898:C:G	5	0	10	10	0	1	1	0
2:238130271:T:C	0	0	0	0	0	0	0	0
2:238130416:A:G	0	0	0	0	0	0	0	0
2:238131200:A:G	0	0	0	0	0	0	0	0
2:238164405:C:T	0	0	0	0	0	0	0	0
2:238167171:C:T	0	0	0	0	0	0	0	0
2:238167294:A:G	0	0	0	0	0	0	0	0
2:240014693:A:G	3	1	7	6	1	1	1	0
2:240022311:T:C	615	342	864	409	455	1	1	1
2:240029895:A:G	0	0	0	0	0	0	0	0
2:240126908:A:C	0	0	0	0	0	0	0	0
2:240134033:C:T	0	0	0	0	0	0	0	0
2:240520080:G:A	0	0	0	0	0	0	0	0
2:240524178:T:C	4	2	5	2	3	1.0	0.5	0.5
2:240576677:G:C	33	13	38	24	14	1	1	0
2:240592062:A:G	5	1	7	5	2	1	1	0
2:240598004:G:A	5	3	5	2	3	1	0	1
2:240630432:C:T	0	0	0	0	0	0	0	0
2:240630675:C:T	0	0	0	0	0	0	0	0
2:240630710:C:T	0	0	0	0	0	0	0	0
2:240630832:A:C	0	0	0	0	0	0	0	0
2:240682585:C:A	0	0	0	0	0	0	0	0
2:240682592:C:G	0	0	0	0	0	0	0	0
2:240687796:G:A	0	0	0	0	0	0	0	0
2:240691996:T:G	0	0	0	0	0	0	0	0
2:240933180:A:G	0	0	0	0	0	0	0	0
2:240959407:A:G	0	0	0	0	0	0	0	0
2:241064070:C:T	0	0	0	0	0	0	0	0
2:241065450:A:G	0	0	0	0	0	0	0	0
2:241071915:C:A	0	0	0	0	0	0	0	0
2:241089326:A:G	109	58	160	80	80	1	0	1
2:241094355:T:A	73	45	86	32	54	1	0	1
2:241190109:G:A	0	0	0	0	0	0	0	0
2:241202304:C:T	0	0	0	0	0	0	0	0
2:241465606:C:T	0	0	0	0	0	0	0	0
2:241637607:C:T	0	0	0	0	0	0	0	0
2:241671358:T:A	18	8	22	13	9	1.0	1.0	0.0
2:241673674:A:G	4	1	4	3	1	1.0	1.0	0.0
2:241673718:T:G	4	1	4	3	1	1.0	1.0	0.0
2:241724947:G:A	0	0	0	0	0	0	0	0
2:241816853:C:T	0	0	0	0	0	0	0	0
2:241816877:C:T	0	0	0	0	0	0	0	0
2:241851121:A:G	1	1	1	0	1	1	0	1
3:75665186:T:G	0	0	0	0	0	0	0	0
3:75737070:G:A	1	0	1	1	0	1	1	0
3:75737586:A:T	2	0	2	2	0	1.0	1.0	0.0
3:75737597:C:T	3	0	3	3	0	1	1	0
3:75737682:G:A	3	0	3	3	0	1	1	0
3:117026878:G:A	9	0	9	9	0	1	1	0
3:119147529:C:T	0	0	0	0	0	0	0	0
3:119409551:G:A	1	1	2	0	2	2	0	2
3:119503609:G:C	24	15	31	13	18	1.0	0.0	1.0
3:119544833:C:T	0	0	0	0	0	0	0	0
3:119620109:A:G	0	0	0	0	0	0	0	0
3:119620163:G:A	0	0	0	0	0	0	0	0
3:119660339:C:T	0	0	0	0	0	0	0	0
3:119703116:C:T	0	0	0	0	0	0	0	0
3:119807502:G:A	0	0	0	0	0	0	0	0
3:119807525:G:A	0	0	0	0	0	0	0	0
3:121489329:T:C	0	0	0	0	0	0	0	0
3:121544797:C:A	1	1	1	0	1	1	0	1
3:122284922:A:G	0	0	0	0	0	0	0	0
3:122961294:A:G	0	0	0	0	0	0	0	0
3:124482852:C:T	0	0	0	0	0	0	0	0
3:124796607:C:T	0	0	0	0	0	0	0	0
3:125014805:T:G	0	0	0	0	0	0	0	0
3:125027338:C:A	0	0	0	0	0	0	0	0
3:125029382:G:A	0	0	0	0	0	0	0	0
3:125916698:G:A	12	9	22	3	19	1.0	0.0	1.0
3:125920850:C:T	9	7	42	15	27	4	0	2
3:125925004:G:A	7	7	21	0	21	2	0	2
3:125925017:G:A	6	6	20	0	20	3.0	0.0	3.0
3:125928643:A:T	1	1	10	0	10	10	0	10
3:125929366:C:T	0	0	0	0	0	0	0	0
3:125929440:A:G	0	0	0	0	0	0	0	0
3:125929500:G:A	0	0	0	0	0	0	0	0
3:125930560:C:A	1	1	1	0	1	1	0	1
3:126107216:T:C	0	0	0	0	0	0	0	0
3:126135566:T:C	0	0	0	0	0	0	0	0
3:126137852:C:A	0	0	0	0	0	0	0	0
3:126500784:G:A	0	0	0	0	0	0	0	0
3:126550075:G:A	0	0	0	0	0	0	0	0
3:126733094:G:T	73	21	140	97	43	1	1	0
3:127004706:C:T	0	0	0	0	0	0	0	0
3:128153663:C:T	552	380	606	201	405	1.0	0.0	1.0
3:128153759:A:G	615	441	1553	497	1056	2	0	1
3:128264652:T:C	5	2	5	3	2	1	1	0
3:128462694:C:T	0	0	0	0	0	0	0	0
3:128462934:A:G	0	0	0	0	0	0	0	0
3:128573370:A:G	0	0	0	0	0	0	0	0
3:129433301:T:C	4	1	10	9	1	1.0	1.0	0.0
3:129433861:T:C	55	41	69	17	52	1	0	1
3:129572908:T:C	0	0	0	0	0	0	0	0
3:129584229:G:A	0	0	0	0	0	0	0	0
3:130091285:G:A	0	0	0	0	0	0	0	0
3:130091315:C:T	0	0	0	0	0	0	0	0
3:130104107:A:G	6	1	19	17	2	2.0	2.0	0.0
3:130581806:T:C	0	0	0	0	0	0	0	0
3:130827853:A:G	6	0	6	6	0	1.0	1.0	0.0
3:131133341:T:C	0	0	0	0	0	0	0	0
3:131228591:A:T	2	0	2	2	0	1.0	1.0	0.0
3:131549980:T:C	0	0	0	0	0	0	0	0
3:132176448:G:A	0	0	0	0	0	0	0	0
3:132243984:G:A	0	0	0	0	0	0	0	0
3:133380401:G:A	0	0	0	0	0	0	0	0
3:133448519:G:A	0	0	0	0	0	0	0	0
3:133637946:G:A	5	3	5	2	3	1	0	1
3:133649518:T:G	4	2	4	2	2	1.0	0.5	0.5
3:133756878:C:T	0	0	0	0	0	0	0	0
3:134222476:C:T	17	15	26	2	24	1	0	1
3:134559428:C:T	2	0	8	8	0	4.0	4.0	0.0
3:136326371:G:A	0	0	0	0	0	0	0	0
3:136369196:G:A	5	3	13	2	11	1	0	1
3:138067600:T:C	0	0	0	0	0	0	0	0
3:138081814:A:G	0	0	0	0	0	0	0	0
3:138102526:G:A	0	0	0	0	0	0	0	0
3:138314339:C:T	0	0	0	0	0	0	0	0
3:139358293:T:C	0	0	0	0	0	0	0	0
3:139494058:G:A	4	2	8	5	3	1.5	0.5	0.5
3:139494790:T:C	0	0	0	0	0	0	0	0
3:139494913:G:A	1	1	1	0	1	1	0	1
3:140688105:G:A	0	0	0	0	0	0	0	0
3:140688418:C:A	0	0	0	0	0	0	0	0
3:141443286:C:G	7	2	13	10	3	1	1	0
3:141443343:T:G	12	3	22	18	4	1.0	1.0	0.0
3:141607760:T:C	17	6	23	13	10	1	1	0
3:141778664:G:C	0	0	0	0	0	0	0	0
3:143177433:T:C	1	0	1	1	0	1	1	0
3:143177444:C:A	1	1	1	0	1	1	0	1
3:148742201:A:C	0	0	0	0	0	0	0	0
3:148986000:T:G	0	0	0	0	0	0	0	0
3:148986831:T:C	0	0	0	0	0	0	0	0
3:148996317:A:G	456	282	552	239	313	1.0	0.0	1.0
3:149040077:C:T	9	6	15	7	8	1	0	1
3:149041538:T:C	8	1	15	12	3	1.0	1.0	0.0
3:149155200:G:A	26	25	43	3	40	1.0	0.0	1.0
3:149162256:G:A	21	19	46	6	40	1	0	1
3:149176330:C:G	0	0	0	0	0	0	0	0
3:149186647:T:G	0	0	0	0	0	0	0	0
3:149576060:G:A	0	0	0	0	0	0	0	0
3:149741626:C:T	13	3	26	19	7	1	1	0
3:149761469:A:G	0	0	0	0	0	0	0	0
3:149982732:T:C	1	0	1	1	0	1	1	0
3:150411207:T:G	21	13	26	10	16	1	0	1
3:150611276:C:G	2	1	3	2	1	1.5	1.0	0.5
3:150611698:C:T	3	1	12	9	3	3	2	0
3:150945547:T:C	0	0	0	0	0	0	0	0
3:151338828:G:A	0	0	0	0	0	0	0	0
3:151394780:G:A	0	0	0	0	0	0	0	0
3:151436878:T:C	0	0	0	0	0	0	0	0
3:151745633:G:T	0	0	0	0	0	0	0	0
3:155523951:A:G	0	0	0	0	0	0	0	0
3:157363535:A:G	0	0	0	0	0	0	0	0
3:158276049:G:T	0	0	0	0	0	0	0	0
3:158276148:G:A	0	0	0	0	0	0	0	0
3:158691473:C:T	12	3	12	9	3	1.0	1.0	0.0
3:158819654:A:G	11	5	16	7	9	1	1	0
3:165055269:G:A	0	0	0	0	0	0	0	0
3:165065377:T:C	0	0	0	0	0	0	0	0
3:166691655:G:A	0	0	0	0	0	0	0	0
3:167248648:C:T	0	0	0	0	0	0	0	0
3:167317026:T:C	0	0	0	0	0	0	0	0
3:167333938:A:G	0	0	0	0	0	0	0	0
3:167449398:T:A	0	0	0	0	0	0	0	0
3:169774313:C:T	180	60	240	167	73	1.0	1.0	0.0
3:169903125:A:G	0	0	0	0	0	0	0	0
3:171108131:G:A	0	0	0	0	0	0	0	0
3:171677678:A:G	0	0	0	0	0	0	0	0
3:172425977:G:T	0	0	0	0	0	0	0	0
3:172426928:A:G	0	0	0	0	0	0	0	0
3:172648042:T:G	13	7	13	6	7	1	0	1
3:172913671:A:G	0	0	0	0	0	0	0	0
3:172913722:G:A	0	0	0	0	0	0	0	0
3:173049032:G:A	0	0	0	0	0	0	0	0
3:174377688:T:C	0	0	0	0	0	0	0	0
3:175096948:G:A	0	0	0	0	0	0	0	0
3:175755259:T:C	0	0	0	0	0	0	0	0
3:179258989:C:T	0	0	0	0	0	0	0	0
3:179259033:G:A	0	0	0	0	0	0	0	0
3:179260754:G:A	6	2	10	4	6	1.0	1.0	0.0
3:179419485:A:G	90	25	128	93	35	1.0	1.0	0.0
3:179465250:C:T	0	0	0	0	0	0	0	0
3:179707074:A:G	2	1	2	1	1	1.0	0.5	0.5
3:180323572:A:C	0	0	0	0	0	0	0	0
3:180659741:G:C	0	0	0	0	0	0	0	0
3:182611278:T:C	0	0	0	0	0	0	0	0
3:182914004:C:A	1	0	1	1	0	1	1	0
3:183017394:C:A	2	1	10	7	3	5.0	3.5	1.5
3:183037421:T:G	15	8	27	10	17	1	0	1
3:183072461:G:A	33	17	37	19	18	1	0	1
3:183154174:C:T	0	0	0	0	0	0	0	0
3:183309754:T:G	0	0	0	0	0	0	0	0
3:183651103:C:T	24	13	27	14	13	1.0	0.5	1.0
3:183715195:C:T	127	84	214	68	146	1	0	1
3:183817306:C:T	4	1	8	7	1	1.5	1.5	0.0
3:183978614:A:G	4	1	11	10	1	1.5	1.5	0.0
3:184035989:G:A	0	0	0	0	0	0	0	0
3:184038176:C:T	0	0	0	0	0	0	0	0
3:184083921:C:T	0	0	0	0	0	0	0	0
3:184258453:A:G	2	0	2	2	0	1.0	1.0	0.0
3:184354671:G:A	0	0	0	0	0	0	0	0
3:184372478:C:T	0	0	0	0	0	0	0	0
3:184426797:A:G	0	0	0	0	0	0	0	0
3:184426858:G:A	0	0	0	0	0	0	0	0
3:184855767:C:T	2	1	2	1	1	1.0	0.5	0.5
3:184982638:C:T	7	4	7	3	4	1	0	1
3:185417660:G:A	11	0	11	11	0	1	1	0
3:185428914:C:T	0	0	0	0	0	0	0	0
3:185511676:T:C	0	0	0	0	0	0	0	0
3:187234247:AGA:GAG	0	0	0	0	0	0	0	0
3:187234799:C:T	0	0	0	0	0	0	0	0
3:187235249:G:A	0	0	0	0	0	0	0	0
3:187236020:C:T	0	0	0	0	0	0	0	0
3:187669043:T:C	0	0	0	0	0	0	0	0
3:187702430:C:T	0	0	0	0	0	0	0	0
3:187728423:C:T	5	4	13	2	11	2	0	2
3:187729913:C:A	2	1	5	4	1	2.5	2.0	0.5
3:189315503:C:G	0	0	0	0	0	0	0	0
3:191375291:A:G	4	2	4	2	2	1.0	0.5	0.5
3:191461404:A:G	0	0	0	0	0	0	0	0
3:193314137:C:T	0	0	0	0	0	0	0	0
3:193491389:T:C	0	0	0	0	0	0	0	0
3:193492979:A:G	0	0	0	0	0	0	0	0
3:194341836:C:T	0	0	0	0	0	0	0	0
3:194360187:G:A	0	0	0	0	0	0	0	0
3:194360254:C:T	0	0	0	0	0	0	0	0
3:194360663:G:A	0	0	0	0	0	0	0	0
3:195122056:C:G	0	0	0	0	0	0	0	0
3:195762196:C:G	0	0	0	0	0	0	0	0
3:195965476:G:A	28	7	71	50	21	2.0	2.0	0.0
3:195965548:C:G	1	0	2	2	0	2	2	0
3:195984118:GTATA:ATATG	65	9	122	104	18	1	1	0
3:195997066:A:G	0	0	0	0	0	0	0	0
3:196214345:C:G	0	0	0	0	0	0	0	0
3:196228891:G:A	0	0	0	0	0	0	0	0
3:196554337:T:C	1	1	1	0	1	1	0	1
3:196733809:C:T	3	2	5	3	2	1	0	1
3:196807835:T:C	51	14	91	64	27	1	1	0
3:198080324:G:A	0	0	0	0	0	0	0	0
4:212656:C:T	0	0	0	0	0	0	0	0
4:337869:T:C	38	15	48	31	17	1.0	1.0	0.0
4:337877:G:C	45	19	61	37	24	1	1	0
4:383099:C:A	10	6	37	15	22	3.5	0.0	1.0
4:425776:C:T	0	0	0	0	0	0	0	0
4:426899:C:T	5	2	12	9	3	2	2	0
4:427832:A:G	2	1	4	2	2	2.0	1.0	1.0
4:866404:A:G	12	5	13	7	6	1.0	1.0	0.0
4:868552:C:A	7	2	7	5	2	1	1	0
4:888837:T:G	0	0	0	0	0	0	0	0
4:888855:G:A	4	3	4	1	3	1.0	0.0	1.0
4:952438:T:C	27	16	37	16	21	1	0	1
4:967585:G:A	3	2	3	1	2	1	0	1
4:967609:C:T	3	2	3	1	2	1	0	1
4:1025103:G:T	0	0	0	0	0	0	0	0
4:1093550:C:T	0	0	0	0	0	0	0	0
4:1096837:G:A	1	1	1	0	1	1	0	1
4:1171976:C:T	2	1	9	3	6	4.5	1.5	3.0
4:1225388:G:A	32	12	33	20	13	1.0	1.0	0.0
4:1251091:A:G	1	1	1	0	1	1	0	1
4:1298003:A:G	1	1	2	0	2	2	0	2
4:1376097:G:A	2	2	2	0	2	1.0	0.0	1.0
4:1394625:T:C	3	0	6	6	0	1	1	0
4:1394641:G:A	3	0	6	6	0	1	1	0
4:1395217:T:C	2	0	2	2	0	1.0	1.0	0.0
4:1395313:A:G	2	1	2	1	1	1.0	0.5	0.5
4:1395373:A:G	2	1	2	1	1	1.0	0.5	0.5
4:1644290:C:G	0	0	0	0	0	0	0	0
4:1727933:C:T	53	34	54	20	34	1	0	1
4:1728261:G:A	14	9	32	9	23	1.0	0.0	1.0
4:1728488:C:G	9	4	9	5	4	1	1	0
4:1731251:G:A	11	6	11	5	6	1	0	1
4:1739936:G:A	2	0	2	2	0	1.0	1.0	0.0
4:2174006:A:G	0	0	0	0	0	0	0	0
4:2174727:G:A	0	0	0	0	0	0	0	0
4:2179353:T:C	0	0	0	0	0	0	0	0
4:2193219:C:T	0	0	0	0	0	0	0	0
4:2193226:G:A	0	0	0	0	0	0	0	0
4:2274108:G:A	0	0	0	0	0	0	0	0
4:2341454:C:T	0	0	0	0	0	0	0	0
4:2458819:G:A	0	0	0	0	0	0	0	0
4:2490464:T:C	378	187	445	228	217	1.0	1.0	0.0
4:2700388:A:G	23	14	23	9	14	1	0	1
4:2824673:T:C	15	8	15	7	8	1	0	1
4:2941634:T:C	9	4	11	5	6	1	1	0
4:2950077:A:G	12	8	17	8	9	1.0	0.0	1.0
4:2965260:C:T	0	0	0	0	0	0	0	0
4:2965483:C:T	0	0	0	0	0	0	0	0
4:3004316:C:T	0	0	0	0	0	0	0	0
4:3146926:T:G	5	2	6	3	3	1	1	0
4:3255866:C:T	0	0	0	0	0	0	0	0
4:3261411:G:A	0	0	0	0	0	0	0	0
4:3493099:A:C	3	1	3	2	1	1	1	0
4:3493120:G:A	2	1	2	1	1	1.0	0.5	0.5
4:3493171:C:T	1	1	1	0	1	1	0	1
4:3525059:C:T	3	0	5	5	0	1	1	0
4:3947910:G:A	0	0	0	0	0	0	0	0
4:4145681:T:G	0	0	0	0	0	0	0	0
4:4157115:A:G	0	0	0	0	0	0	0	0
4:4157158:G:A	0	0	0	0	0	0	0	0
4:4174358:A:C	0	0	0	0	0	0	0	0
4:4198033:G:A	0	0	0	0	0	0	0	0
4:4226555:G:T	0	0	0	0	0	0	0	0
4:4302795:A:C	3	2	5	2	3	2	0	1
4:4863149:C:T	0	0	0	0	0	0	0	0
4:5568494:G:A	0	0	0	0	0	0	0	0
4:5689175:T:C	0	0	0	0	0	0	0	0
4:5719322:A:G	0	0	0	0	0	0	0	0
4:5748177:T:C	0	0	0	0	0	0	0	0
4:5748234:G:C	0	0	0	0	0	0	0	0
4:5752817:T:C	0	0	0	0	0	0	0	0
4:5783715:G:A	0	0	0	0	0	0	0	0
4:5793685:C:T	0	0	0	0	0	0	0	0
4:5828569:C:T	0	0	0	0	0	0	0	0
4:5836786:C:G	0	0	0	0	0	0	0	0
4:5839623:A:G	0	0	0	0	0	0	0	0
4:5965074:T:C	0	0	0	0	0	0	0	0
4:5988612:G:A	0	0	0	0	0	0	0	0
4:5988872:T:C	0	0	0	0	0	0	0	0
4:5989064:A:G	0	0	0	0	0	0	0	0
4:5989657:T:C	0	0	0	0	0	0	0	0
4:6291969:C:G	0	0	0	0	0	0	0	0
4:6300792:G:A	0	0	0	0	0	0	0	0
4:6301295:C:T	3	3	3	0	3	1	0	1
4:6593220:A:C	1	1	1	0	1	1	0	1
4:6594633:G:A	5	3	6	2	4	1	0	1
4:6598285:A:G	3	2	3	1	2	1	0	1
4:6605137:A:G	1	1	1	0	1	1	0	1
4:6954332:T:C	0	0	0	0	0	0	0	0
4:7715285:G:A	0	0	0	0	0	0	0	0
4:7781436:G:A	0	0	0	0	0	0	0	0
4:7800500:G:C	0	0	0	0	0	0	0	0
4:7855503:C:T	0	0	0	0	0	0	0	0
4:8008144:T:C	0	0	0	0	0	0	0	0
4:8228343:T:C	3	3	3	0	3	1	0	1
4:8228507:T:C	3	1	3	2	1	1	1	0
4:8228508:T:C	3	2	3	1	2	1	0	1
4:8232654:T:C	1	1	1	0	1	1	0	1
4:8356634:G:A	0	0	0	0	0	0	0	0
4:8366970:C:T	6	3	8	3	5	1.0	0.5	0.5
4:8452912:A:G	20	11	70	32	38	3.0	0.0	1.0
4:8963798:A:C	0	0	0	0	0	0	0	0
4:8963846:A:G	0	0	0	0	0	0	0	0
4:9064322:T:C	0	0	0	0	0	0	0	0
4:9384129:G:T	0	0	0	0	0	0	0	0
4:9384190:A:G	0	0	0	0	0	0	0	0
4:9783007:C:T	0	0	0	0	0	0	0	0
4:9908299:G:A	0	0	0	0	0	0	0	0
4:9920506:C:T	0	0	0	0	0	0	0	0
4:10021357:C:T	0	0	0	0	0	0	0	0
4:10025918:C:T	0	0	0	0	0	0	0	0
4:10093047:G:A	0	0	0	0	0	0	0	0
4:10443583:T:C	0	0	0	0	0	0	0	0
4:10445282:A:G	0	0	0	0	0	0	0	0
4:10445544:C:G	2	0	6	6	0	3.0	3.0	0.0
4:11372010:G:A	15	15	15	0	15	1	0	1
4:13544168:G:T	0	0	0	0	0	0	0	0
4:13603303:A:G	4	3	4	1	3	1.0	0.0	1.0
4:15002875:C:T	5	2	17	9	8	4	1	0
4:15567395:G:A	0	0	0	0	0	0	0	0
4:15688305:G:A	0	0	0	0	0	0	0	0
4:17501759:C:T	26	16	29	10	19	1.0	0.0	1.0
4:17526840:G:A	0	0	0	0	0	0	0	0
4:17526947:G:C	0	0	0	0	0	0	0	0
4:17639257:C:G	1	0	2	2	0	2	2	0
4:17842406:G:A	1	1	1	0	1	1	0	1
4:22818881:A:T	0	0	0	0	0	0	0	0
4:23813084:G:A	0	0	0	0	0	0	0	0
4:23813899:C:T	0	0	0	0	0	0	0	0
4:23814039:C:T	0	0	0	0	0	0	0	0
4:24799693:G:A	0	0	0	0	0	0	0	0
4:24799732:C:T	0	0	0	0	0	0	0	0
4:25252373:C:T	12	7	20	11	9	1.0	0.0	1.0
4:25417661:T:C	9	6	9	3	6	1	0	1
4:25759071:A:G	12	4	16	12	4	1.0	1.0	0.0
4:26272652:T:A	0	0	0	0	0	0	0	0
4:26415514:T:C	121	62	149	81	68	1	0	1
4:26717947:T:C	1	1	3	0	3	3	0	3
4:30724074:G:A	0	0	0	0	0	0	0	0
4:30724365:G:A	0	0	0	0	0	0	0	0
4:36068183:G:A	2	2	2	0	2	1.0	0.0	1.0
4:36229221:G:A	8	4	8	4	4	1.0	0.5	0.5
4:36339131:G:A	0	0	0	0	0	0	0	0
4:37443693:C:A	0	0	0	0	0	0	0	0
4:37444263:T:C	0	0	0	0	0	0	0	0
4:37960565:G:C	1	1	1	0	1	1	0	1
4:38773268:T:C	31	13	31	18	13	1	1	0
4:38797027:C:A	6	3	6	3	3	1.0	0.5	0.5
4:38797314:C:T	6	3	7	3	4	1.0	0.5	0.5
4:38828729:A:G	4	2	4	2	2	1.0	0.5	0.5
4:38998685:A:G	43	17	52	29	23	1	1	0
4:39062745:A:G	7	6	7	1	6	1	0	1
4:39448609:C:A	0	0	0	0	0	0	0	0
4:39458870:C:G	5	3	5	2	3	1	0	1
4:39481228:A:G	0	0	0	0	0	0	0	0
4:40021250:C:T	0	0	0	0	0	0	0	0
4:40438198:T:C	3	1	6	3	3	2	1	0
4:41013924:T:G	0	0	0	0	0	0	0	0
4:41671587:T:C	0	0	0	0	0	0	0	0
4:41747651:C:T	0	0	0	0	0	0	0	0
4:41935379:G:A	99	54	102	48	54	1	0	1
4:41982101:C:T	0	0	0	0	0	0	0	0
4:42020447:C:A	9	4	15	11	4	1	1	0
4:42029992:T:C	0	0	0	0	0	0	0	0
4:42030007:A:G	0	0	0	0	0	0	0	0
4:42472210:A:G	0	0	0	0	0	0	0	0
4:44703108:T:C	8	2	15	11	4	1.0	1.0	0.0
4:46084043:T:C	0	0	0	0	0	0	0	0
4:47032609:C:G	0	0	0	0	0	0	0	0
4:47406692:A:G	0	0	0	0	0	0	0	0
4:47512668:C:T	29	10	31	21	10	1	1	0
4:47558146:C:A	2	2	2	0	2	1.0	0.0	1.0
4:47591266:G:C	2	2	2	0	2	1.0	0.0	1.0
4:47680157:A:G	0	0	0	0	0	0	0	0
4:47837912:C:T	0	0	0	0	0	0	0	0
4:47885519:T:C	2	1	3	1	2	1.5	0.5	1.0
4:47885974:G:A	1	0	1	1	0	1	1	0
4:47971093:G:A	0	0	0	0	0	0	0	0
4:48067679:G:C	2	0	2	2	0	1.0	1.0	0.0
4:48113247:C:T	1	1	1	0	1	1	0	1
4:48580892:G:A	7	2	15	10	5	2	1	0
4:48986433:C:A	0	0	0	0	0	0	0	0
4:49016897:T:C	0	0	0	0	0	0	0	0
4:51886646:A:T	2	2	2	0	2	1.0	0.0	1.0
4:52744105:C:T	0	0	0	0	0	0	0	0
4:52745501:T:C	0	0	0	0	0	0	0	0
4:53145359:A:G	2	0	2	2	0	1.0	1.0	0.0
4:54087157:A:C	0	0	0	0	0	0	0	0
4:54100500:C:T	0	0	0	0	0	0	0	0
4:54100752:T:C	0	0	0	0	0	0	0	0
4:54285873:C:T	0	0	0	0	0	0	0	0
4:55443825:A:G	1	1	2	0	2	2	0	2
4:55453183:C:G	4	3	4	1	3	1.0	0.0	1.0
4:55890365:T:C	12	7	25	7	18	1.0	0.0	1.0
4:56310666:T:C	0	0	0	0	0	0	0	0
4:56315829:C:T	0	0	0	0	0	0	0	0
4:56316481:G:A	0	0	0	0	0	0	0	0
4:56316592:C:T	0	0	0	0	0	0	0	0
4:56349637:G:A	1	1	1	0	1	1	0	1
4:56382550:G:C	20	7	22	13	9	1.0	1.0	0.0
4:56384119:T:C	41	13	45	32	13	1	1	0
4:56404031:T:C	0	0	0	0	0	0	0	0
4:56490422:A:G	46	27	90	29	61	1.0	0.0	1.0
4:56530884:A:C	0	0	0	0	0	0	0	0
4:56530916:T:C	0	0	0	0	0	0	0	0
4:56650730:G:A	0	0	0	0	0	0	0	0
4:56930934:G:T	15	9	23	14	9	1	0	1
4:56931142:A:C	4	3	5	1	4	1.0	0.0	1.0
4:57020984:C:T	11	9	11	2	9	1	0	1
4:57023511:C:T	19	12	31	7	24	1	0	1
4:62816988:A:T	0	0	0	0	0	0	0	0
4:67508879:C:T	9	5	10	4	6	1	0	1
4:67510990:T:C	0	0	0	0	0	0	0	0
4:67514352:C:T	9	1	9	8	1	1	1	0
4:67514497:G:A	12	5	18	10	8	1.0	1.0	0.0
4:67514548:C:T	21	9	32	17	15	1	1	0
4:67518290:C:T	16	7	30	18	12	1.0	1.0	0.0
4:67581322:C:T	61	27	89	52	37	1	1	0
4:67631879:C:A	4	3	7	3	4	1.5	0.0	1.0
4:67668674:C:T	3	2	3	1	2	1	0	1
4:67701307:T:G	0	0	0	0	0	0	0	0
4:67720549:G:C	52	17	64	46	18	1.0	1.0	0.0
4:67914681:A:G	0	0	0	0	0	0	0	0
4:68337362:T:C	13	8	18	5	13	1	0	1
4:68818113:C:T	0	0	0	0	0	0	0	0
4:69389542:C:T	0	0	0	0	0	0	0	0
4:69525711:G:A	0	0	0	0	0	0	0	0
4:69594610:C:T	0	0	0	0	0	0	0	0
4:70249336:T:A	0	0	0	0	0	0	0	0
4:70366984:C:T	0	0	0	0	0	0	0	0
4:70390050:A:G	0	0	0	0	0	0	0	0
4:70480984:C:G	0	0	0	0	0	0	0	0
4:70531272:C:T	0	0	0	0	0	0	0	0
4:70603268:A:G	0	0	0	0	0	0	0	0
4:70634360:A:G	0	0	0	0	0	0	0	0
4:71560146:C:T	0	0	0	0	0	0	0	0
4:71752606:G:T	0	0	0	0	0	0	0	0
4:71752617:A:C	0	0	0	0	0	0	0	0
4:71784057:G:A	0	0	0	0	0	0	0	0
4:72548569:C:T	0	0	0	0	0	0	0	0
4:72807879:T:A	0	0	0	0	0	0	0	0
4:73064835:G:A	0	0	0	0	0	0	0	0
4:73091019:G:A	9	3	11	8	3	1	1	0
4:73419522:C:T	0	0	0	0	0	0	0	0
4:73576650:A:G	1	1	1	0	1	1	0	1
4:74157992:C:T	1	1	3	0	3	3	0	3
4:74449007:A:C	1	1	5	0	5	5	0	5
4:74750631:A:T	0	0	0	0	0	0	0	0
4:75012761:C:T	0	0	0	0	0	0	0	0
4:75012969:G:A	0	0	0	0	0	0	0	0
4:75013026:A:G	0	0	0	0	0	0	0	0
4:75046202:C:T	0	0	0	0	0	0	0	0
4:75564372:G:A	0	0	0	0	0	0	0	0
4:76741156:C:T	0	0	0	0	0	0	0	0
4:76754352:C:T	0	0	0	0	0	0	0	0
4:78057987:C:T	0	0	0	0	0	0	0	0
4:78068562:T:C	0	0	0	0	0	0	0	0
4:78181284:T:C	0	0	0	0	0	0	0	0
4:78318909:A:G	0	0	0	0	0	0	0	0
4:78363540:C:T	0	0	0	0	0	0	0	0
4:78379839:G:A	0	0	0	0	0	0	0	0
4:78464565:G:A	0	0	0	0	0	0	0	0
4:78522696:G:A	0	0	0	0	0	0	0	0
4:78534560:C:G	0	0	0	0	0	0	0	0
4:78534579:C:T	0	0	0	0	0	0	0	0
4:80202224:C:T	5	2	5	3	2	1	1	0
4:81171716:A:G	0	0	0	0	0	0	0	0
4:82275299:G:C	0	0	0	0	0	0	0	0
4:82276398:C:T	0	0	0	0	0	0	0	0
4:82660911:G:T	0	0	0	0	0	0	0	0
4:82660930:G:A	0	0	0	0	0	0	0	0
4:82661058:C:G	0	0	0	0	0	0	0	0
4:83267697:G:A	5	0	5	5	0	1	1	0
4:83269878:A:G	3	2	3	1	2	1	0	1
4:84244126:G:C	0	0	0	0	0	0	0	0
4:84244867:C:T	0	0	0	0	0	0	0	0
4:84841232:T:C	0	0	0	0	0	0	0	0
4:85923682:A:G	78	38	104	56	48	1.0	1.0	0.0
4:86762878:A:G	0	0	0	0	0	0	0	0
4:86785353:T:G	0	0	0	0	0	0	0	0
4:87207953:C:T	0	0	0	0	0	0	0	0
4:87613083:A:G	0	0	0	0	0	0	0	0
4:87614633:C:T	0	0	0	0	0	0	0	0
4:87615210:G:A	0	0	0	0	0	0	0	0
4:87615368:T:C	0	0	0	0	0	0	0	0
4:87615398:T:C	0	0	0	0	0	0	0	0
4:87615540:A:G	0	0	0	0	0	0	0	0
4:87615666:A:G	0	0	0	0	0	0	0	0
4:87615731:T:C	0	0	0	0	0	0	0	0
4:87615734:C:T	0	0	0	0	0	0	0	0
4:87615747:AAC:GAT	0	0	0	0	0	0	0	0
4:87615911:A:C	0	0	0	0	0	0	0	0
4:87616205:T:C	0	0	0	0	0	0	0	0
4:87616232:T:C	0	0	0	0	0	0	0	0
4:87616253:T:C	0	0	0	0	0	0	0	0
4:87616268:C:T	0	0	0	0	0	0	0	0
4:87661983:A:T	0	0	0	0	0	0	0	0
4:88697686:T:C	17	17	20	0	20	1	0	1
4:88749004:C:T	0	0	0	0	0	0	0	0
4:89822180:C:T	0	0	0	0	0	0	0	0
4:91319651:C:T	0	0	0	0	0	0	0	0
4:91325193:G:A	0	0	0	0	0	0	0	0
4:93395612:T:G	0	0	0	0	0	0	0	0
4:93422891:G:A	0	0	0	0	0	0	0	0
4:94208087:T:C	8	4	26	13	13	3.0	0.5	1.0
4:94248531:G:T	0	0	0	0	0	0	0	0
4:94249688:G:A	1	1	2	0	2	2	0	2
4:94264904:A:G	2	2	9	0	9	4.5	0.0	4.5
4:94276369:C:T	3	2	3	1	2	1	0	1
4:94290459:T:C	6	4	6	2	4	1.0	0.0	1.0
4:94582751:T:C	0	0	0	0	0	0	0	0
4:94585691:G:A	3	2	12	2	10	4	0	4
4:95245119:C:T	0	0	0	0	0	0	0	0
4:97972325:C:T	2	2	3	0	3	1.5	0.0	1.5
4:98025732:C:A	3	0	3	3	0	1	1	0
4:98026175:G:A	0	0	0	0	0	0	0	0
4:98105986:T:C	0	0	0	0	0	0	0	0
4:99005814:T:C	2	2	8	0	8	4.0	0.0	4.0
4:99023081:C:T	0	0	0	0	0	0	0	0
4:99031559:A:G	1	0	1	1	0	1	1	0
4:99126661:G:A	0	0	0	0	0	0	0	0
4:99127263:T:C	2	2	8	0	8	4.0	0.0	4.0
4:99131582:C:A	0	0	0	0	0	0	0	0
4:99143175:A:T	0	0	0	0	0	0	0	0
4:99344976:T:C	0	0	0	0	0	0	0	0
4:99522643:G:A	0	0	0	0	0	0	0	0
4:99564098:G:A	0	0	0	0	0	0	0	0
4:99583507:T:C	0	0	0	0	0	0	0	0
4:99589702:T:C	0	0	0	0	0	0	0	0
4:99594865:C:G	0	0	0	0	0	0	0	0
4:99649524:T:A	0	0	0	0	0	0	0	0
4:99651658:C:G	0	0	0	0	0	0	0	0
4:99653038:A:G	0	0	0	0	0	0	0	0
4:99654554:C:T	0	0	0	0	0	0	0	0
4:102030176:G:A	471	259	587	274	313	1	1	1
4:102267879:G:A	0	0	0	0	0	0	0	0
4:102632215:C:T	7	3	11	5	6	1	1	0
4:102753951:G:C	201	26	247	211	36	1	1	0
4:105275794:A:G	3	1	3	2	1	1	1	0
4:105589313:A:G	0	0	0	0	0	0	0	0
4:107654833:G:A	18	11	21	9	12	1.0	0.0	1.0
4:107720144:T:C	139	79	172	71	101	1	0	1
4:107989895:T:C	16	8	16	8	8	1.0	0.5	0.5
4:108004838:A:G	0	0	0	0	0	0	0	0
4:108009883:T:C	262	107	316	193	123	1.0	1.0	0.0
4:108023576:G:A	0	0	0	0	0	0	0	0
4:108023665:C:T	0	0	0	0	0	0	0	0
4:108789485:C:T	0	0	0	0	0	0	0	0
4:109682628:T:C	49	23	72	27	45	1	1	0
4:109836068:G:A	1	0	1	1	0	1	1	0
4:109836131:G:A	1	0	1	1	0	1	1	0
4:109844216:A:G	0	0	0	0	0	0	0	0
4:109851911:G:A	0	0	0	0	0	0	0	0
4:109870205:G:A	0	0	0	0	0	0	0	0
4:109870257:C:T	0	0	0	0	0	0	0	0
4:109870387:C:T	1	0	1	1	0	1	1	0
4:109879216:G:A	0	0	0	0	0	0	0	0
4:110400140:G:T	0	0	0	0	0	0	0	0
4:112171384:T:C	0	0	0	0	0	0	0	0
4:112358812:C:G	0	0	0	0	0	0	0	0
4:112423769:C:T	0	0	0	0	0	0	0	0
4:112423806:T:C	0	0	0	0	0	0	0	0
4:112423991:A:G	1	1	3	0	3	3	0	3
4:112431241:G:A	1	1	2	0	2	2	0	2
4:112431472:A:G	1	1	1	0	1	1	0	1
4:112431743:G:A	2	0	2	2	0	1.0	1.0	0.0
4:112431896:C:T	0	0	0	0	0	0	0	0
4:112432129:T:C	2	1	4	1	3	2.0	0.5	1.5
4:112438547:A:G	0	0	0	0	0	0	0	0
4:112788137:G:A	0	0	0	0	0	0	0	0
4:112788190:C:T	1	0	1	1	0	1	1	0
4:112788614:G:A	79	0	84	84	0	1	1	0
4:112827282:A:G	0	0	0	0	0	0	0	0
4:113282848:A:G	0	0	0	0	0	0	0	0
4:113336045:C:T	0	0	0	0	0	0	0	0
4:113354087:C:T	0	0	0	0	0	0	0	0
4:113355724:TTCAA:CTCAG	0	0	0	0	0	0	0	0
4:113358534:G:A	0	0	0	0	0	0	0	0
4:113373152:T:C	0	0	0	0	0	0	0	0
4:116598970:C:G	0	0	0	0	0	0	0	0
4:117574983:A:T	1	0	1	1	0	1	1	0
4:117575363:A:G	1	0	1	1	0	1	1	0
4:117575615:T:A	1	0	1	1	0	1	1	0
4:117576088:G:A	0	0	0	0	0	0	0	0
4:118053991:C:T	0	0	0	0	0	0	0	0
4:118194091:T:C	0	0	0	0	0	0	0	0
4:118240640:G:A	0	0	0	0	0	0	0	0
4:118298754:C:A	0	0	0	0	0	0	0	0
4:118316193:T:C	0	0	0	0	0	0	0	0
4:118460267:T:C	0	0	0	0	0	0	0	0
4:118493276:A:T	0	0	0	0	0	0	0	0
4:118506932:T:A	0	0	0	0	0	0	0	0
4:118631281:A:C	0	0	0	0	0	0	0	0
4:118636170:C:T	0	0	0	0	0	0	0	0
4:118636178:T:A	0	0	0	0	0	0	0	0
4:119023456:G:T	1	1	1	0	1	1	0	1
4:119030492:A:G	1	0	1	1	0	1	1	0
4:119164293:A:G	0	0	0	0	0	0	0	0
4:119212394:T:G	1	1	5	0	5	5	0	5
4:119260569:A:G	0	0	0	0	0	0	0	0
4:119320694:A:G	0	0	0	0	0	0	0	0
4:119406043:CGCT:TGCC	3	2	8	1	7	1	0	1
4:119409500:T:G	0	0	0	0	0	0	0	0
4:119607172:G:A	0	0	0	0	0	0	0	0
4:120816612:G:A	0	0	0	0	0	0	0	0
4:121036404:G:A	0	0	0	0	0	0	0	0
4:121036579:T:C	0	0	0	0	0	0	0	0
4:121037536:T:C	0	0	0	0	0	0	0	0
4:121045652:C:T	0	0	0	0	0	0	0	0
4:121329359:A:G	0	0	0	0	0	0	0	0
4:121329499:G:A	0	0	0	0	0	0	0	0
4:121340441:A:T	0	0	0	0	0	0	0	0
4:121761852:G:A	0	0	0	0	0	0	0	0
4:121902897:C:T	0	0	0	0	0	0	0	0
4:122077926:G:A	0	0	0	0	0	0	0	0
4:122224596:T:A	2	1	2	1	1	1.0	0.5	0.5
4:122271228:T:C	4	3	4	1	3	1.0	0.0	1.0
4:122307977:C:T	1	0	3	3	0	3	3	0
4:122893153:C:T	0	0	0	0	0	0	0	0
4:122934398:G:T	2	1	4	3	1	2.0	1.5	0.5
4:124463168:C:T	0	0	0	0	0	0	0	0
4:125317769:A:T	0	0	0	0	0	0	0	0
4:125318831:C:T	0	0	0	0	0	0	0	0
4:125319355:T:C	0	0	0	0	0	0	0	0
4:125320716:C:T	0	0	0	0	0	0	0	0
4:125481735:G:A	0	0	0	0	0	0	0	0
4:125490439:G:A	0	0	0	0	0	0	0	0
4:125491420:A:G	0	0	0	0	0	0	0	0
4:127643845:A:G	0	0	0	0	0	0	0	0
4:127663425:G:A	0	0	0	0	0	0	0	0
4:127820555:T:C	0	0	0	0	0	0	0	0
4:128946125:T:A	11	6	17	10	7	1	0	1
4:129138886:A:C	0	0	0	0	0	0	0	0
4:135046791:A:T	0	0	0	0	0	0	0	0
4:137528529:A:G	0	0	0	0	0	0	0	0
4:137532375:T:C	0	0	0	0	0	0	0	0
4:138183260:T:C	0	0	0	0	0	0	0	0
4:138219340:G:C	0	0	0	0	0	0	0	0
4:139889483:C:T	0	0	0	0	0	0	0	0
4:139889546:C:T	0	0	0	0	0	0	0	0
4:139889981:T:C	0	0	0	0	0	0	0	0
4:140461967:A:T	0	0	0	0	0	0	0	0
4:140676972:C:T	32	20	48	15	33	1.0	0.0	1.0
4:142145901:G:A	0	0	0	0	0	0	0	0
4:142347549:A:G	0	0	0	0	0	0	0	0
4:142402941:G:A	0	0	0	0	0	0	0	0
4:143214565:G:A	2	1	2	1	1	1.0	0.5	0.5
4:143395886:C:T	0	0	0	0	0	0	0	0
4:143554996:A:G	3	2	3	1	2	1	0	1
4:143911670:T:G	6	6	12	0	12	1.5	0.0	1.5
4:144119631:T:C	0	0	0	0	0	0	0	0
4:145376176:G:A	0	0	0	0	0	0	0	0
4:145625549:A:G	0	0	0	0	0	0	0	0
4:145651075:G:A	0	0	0	0	0	0	0	0
4:150798111:A:G	8	4	16	12	4	1.0	0.5	0.5
4:151027422:G:A	1	1	7	0	7	7	0	7
4:151656245:C:T	0	0	0	0	0	0	0	0
4:153632821:G:A	24	12	41	21	20	1.0	0.5	0.5
4:153658608:C:T	10	1	10	9	1	1.0	1.0	0.0
4:153658641:G:A	9	0	9	9	0	1	1	0
4:153658723:A:G	0	0	0	0	0	0	0	0
4:154298209:A:G	0	0	0	0	0	0	0	0
4:154298230:G:C	0	0	0	0	0	0	0	0
4:154298388:C:A	0	0	0	0	0	0	0	0
4:154298397:T:G	0	0	0	0	0	0	0	0
4:154320583:C:T	0	0	0	0	0	0	0	0
4:154322421:C:T	0	0	0	0	0	0	0	0
4:154323310:C:T	0	0	0	0	0	0	0	0
4:154323323:G:T	0	0	0	0	0	0	0	0
4:154391259:G:A	0	0	0	0	0	0	0	0
4:154489757:A:G	0	0	0	0	0	0	0	0
4:154539961:T:C	13	6	19	7	12	1	1	0
4:154565229:C:T	0	0	0	0	0	0	0	0
4:154567669:C:T	0	0	0	0	0	0	0	0
4:154569680:C:T	0	0	0	0	0	0	0	0
4:154570607:G:A	0	0	0	0	0	0	0	0
4:154609725:C:T	0	0	0	0	0	0	0	0
4:155353225:T:C	13	5	16	10	6	1	1	0
4:155368748:C:T	4	3	4	1	3	1.0	0.0	1.0
4:157084724:G:A	0	0	0	0	0	0	0	0
4:158868858:G:A	0	0	0	0	0	0	0	0
4:158960327:T:C	0	0	0	0	0	0	0	0
4:161386160:C:A	0	0	0	0	0	0	0	0
4:163514113:A:C	111	63	134	56	78	1	0	1
4:163519429:T:C	34	16	61	28	33	1.0	1.0	0.0
4:163545672:C:T	94	53	214	100	114	1.0	0.0	1.0
4:165277994:C:T	0	0	0	0	0	0	0	0
4:165278098:A:T	0	0	0	0	0	0	0	0
4:165278238:C:T	0	0	0	0	0	0	0	0
4:165278611:A:C	0	0	0	0	0	0	0	0
4:165310716:A:G	3	3	4	0	4	1	0	1
4:165404277:A:G	0	0	0	0	0	0	0	0
4:165404605:G:A	0	0	0	0	0	0	0	0
4:165404679:A:G	0	0	0	0	0	0	0	0
4:165404716:A:G	0	0	0	0	0	0	0	0
4:165405444:C:T	0	0	0	0	0	0	0	0
4:165405756:G:A	0	0	0	0	0	0	0	0
4:165405780:A:C	0	0	0	0	0	0	0	0
4:165549636:A:T	0	0	0	0	0	0	0	0
4:168441406:C:G	5	1	5	4	1	1	1	0
4:168709053:T:G	0	0	0	0	0	0	0	0
4:169561732:A:G	3	1	4	2	2	1	1	0
4:169833261:G:A	0	0	0	0	0	0	0	0
4:172311654:G:A	0	0	0	0	0	0	0	0
4:174304301:G:A	2	1	3	2	1	1.5	1.0	0.5
4:174316257:T:C	1	0	1	1	0	1	1	0
4:174522005:C:T	0	0	0	0	0	0	0	0
4:174522110:G:T	0	0	0	0	0	0	0	0
4:177341529:T:C	0	0	0	0	0	0	0	0
4:181522885:A:G	0	0	0	0	0	0	0	0
4:181522978:A:G	0	0	0	0	0	0	0	0
4:182628678:T:G	0	0	0	0	0	0	0	0
4:183446458:A:G	4	3	5	2	3	1.0	0.0	1.0
4:183679418:C:A	8	6	8	2	6	1.0	0.0	1.0
4:183693721:C:T	1	1	1	0	1	1	0	1
4:184010665:G:A	0	0	0	0	0	0	0	0
4:184299209:G:A	0	0	0	0	0	0	0	0
4:184299402:G:A	1	0	1	1	0	1	1	0
4:184734038:G:C	1	0	1	1	0	1	1	0
4:184813900:G:A	1	0	8	8	0	8	8	0
4:185019798:C:G	0	0	0	0	0	0	0	0
4:185175891:C:T	15	8	22	13	9	1	0	1
4:185190485:T:C	11	6	11	5	6	1	0	1
4:185190957:G:A	210	85	220	129	91	1.0	1.0	0.0
4:185458581:T:C	0	0	0	0	0	0	0	0
4:185506581:G:A	0	0	0	0	0	0	0	0
4:186076613:C:A	0	0	0	0	0	0	0	0
4:186082920:C:T	0	0	0	0	0	0	0	0
4:186083063:C:T	0	0	0	0	0	0	0	0
4:186191887:C:G	149	111	154	38	116	1	0	1
4:186197508:G:T	0	0	0	0	0	0	0	0
4:186199057:C:A	3	1	11	9	2	2	1	0
4:186201165:T:G	3	2	3	1	2	1	0	1
4:186236880:G:A	0	0	0	0	0	0	0	0
4:186533797:T:C	0	0	0	0	0	0	0	0
4:186603371:C:T	0	0	0	0	0	0	0	0
4:186609868:A:G	0	0	0	0	0	0	0	0
4:186613221:A:G	0	0	0	0	0	0	0	0
4:186621601:T:C	0	0	0	0	0	0	0	0
4:186708343:G:A	0	0	0	0	0	0	0	0
4:186708384:C:T	0	0	0	0	0	0	0	0
4:186708616:A:C	0	0	0	0	0	0	0	0
4:186709436:G:A	0	0	0	0	0	0	0	0
4:188091526:G:A	0	0	0	0	0	0	0	0
4:188101170:C:T	0	0	0	0	0	0	0	0
4:188139882:C:T	0	0	0	0	0	0	0	0
4:188349921:C:T	0	0	0	0	0	0	0	0
4:188389153:C:G	0	0	0	0	0	0	0	0
4:188738623:G:A	1	1	1	0	1	1	0	1
4:189984870:G:A	0	0	0	0	0	0	0	0
5:173991:G:A	0	0	0	0	0	0	0	0
5:181545:T:G	0	0	0	0	0	0	0	0
5:181615:C:G	0	0	0	0	0	0	0	0
5:181647:A:G	0	0	0	0	0	0	0	0
5:230996:T:C	37	20	43	21	22	1	0	1
5:311363:T:C	73	42	90	43	47	1	0	1
5:421288:G:A	0	0	0	0	0	0	0	0
5:421311:A:C	0	0	0	0	0	0	0	0
5:432790:C:A	0	0	0	0	0	0	0	0
5:434607:G:C	0	0	0	0	0	0	0	0
5:474989:A:G	1	0	1	1	0	1	1	0
5:476238:C:T	0	0	0	0	0	0	0	0
5:665165:T:C	0	0	0	0	0	0	0	0
5:677947:A:G	1	0	2	2	0	2	2	0
5:1063883:G:A	0	0	0	0	0	0	0	0
5:1076130:G:A	0	0	0	0	0	0	0	0
5:1216785:G:A	0	0	0	0	0	0	0	0
5:1225498:G:A	0	0	0	0	0	0	0	0
5:1225511:T:A	0	0	0	0	0	0	0	0
5:1225561:C:T	0	0	0	0	0	0	0	0
5:1466804:G:A	7	6	7	1	6	1	0	1
5:1494794:C:T	31	28	88	8	80	1	0	1
5:1880777:C:T	0	0	0	0	0	0	0	0
5:2755371:C:T	0	0	0	0	0	0	0	0
5:2787468:C:A	0	0	0	0	0	0	0	0
5:2787672:T:G	0	0	0	0	0	0	0	0
5:2787746:C:T	0	0	0	0	0	0	0	0
5:2787879:A:G	0	0	0	0	0	0	0	0
5:2788095:G:A	0	0	0	0	0	0	0	0
5:2788116:A:G	0	0	0	0	0	0	0	0
5:2788487:T:C	0	0	0	0	0	0	0	0
5:5146264:T:C	0	0	0	0	0	0	0	0
5:5146282:A:G	0	0	0	0	0	0	0	0
5:5200168:C:T	0	0	0	0	0	0	0	0
5:5447494:A:G	4	2	23	10	13	5.0	2.0	0.5
5:5462035:G:A	1	0	1	1	0	1	1	0
5:5462494:A:G	1	1	1	0	1	1	0	1
5:5462507:G:A	1	1	1	0	1	1	0	1
5:5489270:G:A	3	2	3	1	2	1	0	1
5:6749643:C:T	3	0	3	3	0	1	1	0
5:7520768:G:T	0	0	0	0	0	0	0	0
5:7743674:C:T	0	0	0	0	0	0	0	0
5:7870860:A:G	33	20	37	14	23	1	0	1
5:7878311:T:A	2	2	3	0	3	1.5	0.0	1.5
5:7889103:G:A	2	2	3	0	3	1.5	0.0	1.5
5:7889191:C:T	1	1	1	0	1	1	0	1
5:7891393:C:G	6	3	14	4	10	1.5	0.5	0.5
5:9154547:G:C	0	0	0	0	0	0	0	0
5:9265490:C:T	0	0	0	0	0	0	0	0
5:9629417:G:A	0	0	0	0	0	0	0	0
5:10250318:G:A	17	7	18	11	7	1	1	0
5:10250331:T:C	33	19	37	16	21	1	0	1
5:10254705:A:G	700	363	996	511	485	1.0	1.0	1.0
5:10256049:T:C	70	40	83	39	44	1.0	0.0	1.0
5:10260953:C:T	0	0	0	0	0	0	0	0
5:10282284:A:G	0	0	0	0	0	0	0	0
5:10505473:A:G	0	0	0	0	0	0	0	0
5:10624754:T:G	0	0	0	0	0	0	0	0
5:10664520:A:G	0	0	0	0	0	0	0	0
5:10664887:C:G	0	0	0	0	0	0	0	0
5:10664892:C:T	0	0	0	0	0	0	0	0
5:13701416:T:C	0	0	0	0	0	0	0	0
5:13701427:T:C	0	0	0	0	0	0	0	0
5:13718913:T:G	0	0	0	0	0	0	0	0
5:13718980:G:A	0	0	0	0	0	0	0	0
5:13737335:G:A	0	0	0	0	0	0	0	0
5:13810332:G:A	0	0	0	0	0	0	0	0
5:13811666:T:C	0	0	0	0	0	0	0	0
5:13829690:G:A	0	0	0	0	0	0	0	0
5:13844936:G:A	0	0	0	0	0	0	0	0
5:13864619:C:A	0	0	0	0	0	0	0	0
5:13865871:T:C	0	0	0	0	0	0	0	0
5:13931231:C:T	1	1	7	0	7	7	0	7
5:14741812:A:C	0	0	0	0	0	0	0	0
5:16478091:G:A	0	0	0	0	0	0	0	0
5:16902403:A:T	0	0	0	0	0	0	0	0
5:16902592:T:A	1	0	1	1	0	1	1	0
5:17353928:AAGCT:GAGCC	0	0	0	0	0	0	0	0
5:22580467:G:A	0	0	0	0	0	0	0	0
5:25909655:C:T	2	0	2	2	0	1.0	1.0	0.0
5:25910457:A:G	0	0	0	0	0	0	0	0
5:25910510:C:G	0	0	0	0	0	0	0	0
5:25911027:C:A	2	0	3	3	0	1.5	1.5	0.0
5:25911179:T:C	1	1	1	0	1	1	0	1
5:26988221:G:A	0	0	0	0	0	0	0	0
5:28926929:A:G	0	0	0	0	0	0	0	0
5:28927056:A:G	0	0	0	0	0	0	0	0
5:28927088:C:T	0	0	0	0	0	0	0	0
5:28927102:G:A	0	0	0	0	0	0	0	0
5:28927222:C:T	0	0	0	0	0	0	0	0
5:28927283:G:A	0	0	0	0	0	0	0	0
5:29848702:T:C	0	0	0	0	0	0	0	0
5:29848783:G:A	0	0	0	0	0	0	0	0
5:30365610:C:T	0	0	0	0	0	0	0	0
5:31552788:T:A	2	0	2	2	0	1.0	1.0	0.0
5:31822761:T:C	0	0	0	0	0	0	0	0
5:31822925:T:C	0	0	0	0	0	0	0	0
5:31822970:C:T	0	0	0	0	0	0	0	0
5:31908699:G:A	0	0	0	0	0	0	0	0
5:32400161:A:G	17	11	36	15	21	1	0	1
5:32522797:GATAC:TATAT	0	0	0	0	0	0	0	0
5:32523173:A:G	0	0	0	0	0	0	0	0
5:32523642:T:C	0	0	0	0	0	0	0	0
5:32786283:A:G	0	0	0	0	0	0	0	0
5:33448686:C:A	58	28	69	39	30	1.0	1.0	0.0
5:33461250:G:A	5	2	5	3	2	1	1	0
5:33963765:C:T	0	0	0	0	0	0	0	0
5:34840736:A:G	0	0	0	0	0	0	0	0
5:34998673:C:A	0	0	0	0	0	0	0	0
5:35065548:C:T	0	0	0	0	0	0	0	0
5:35643532:A:G	0	0	0	0	0	0	0	0
5:35654609:C:T	0	0	0	0	0	0	0	0
5:35702204:A:G	0	0	0	0	0	0	0	0
5:35860966:T:C	2	1	2	1	1	1.0	0.5	0.5
5:35871088:G:A	0	0	0	0	0	0	0	0
5:35871171:C:T	0	0	0	0	0	0	0	0
5:35910427:C:T	0	0	0	0	0	0	0	0
5:35962882:A:G	0	0	0	0	0	0	0	0
5:36686302:G:A	0	0	0	0	0	0	0	0
5:37168870:G:A	2	1	2	1	1	1.0	0.5	0.5
5:37211965:A:C	0	0	0	0	0	0	0	0
5:38485963:C:T	0	0	0	0	0	0	0	0
5:38919056:G:A	0	0	0	0	0	0	0	0
5:38924423:T:C	0	0	0	0	0	0	0	0
5:38955694:G:A	8	3	21	13	8	2.0	1.0	0.0
5:39719344:A:G	0	0	0	0	0	0	0	0
5:39719451:T:C	0	0	0	0	0	0	0	0
5:39719808:G:A	0	0	0	0	0	0	0	0
5:40681152:C:T	2	1	2	1	1	1.0	0.5	0.5
5:40964783:A:T	0	0	0	0	0	0	0	0
5:40998094:T:C	0	0	0	0	0	0	0	0
5:41000241:G:A	0	0	0	0	0	0	0	0
5:41049287:T:C	0	0	0	0	0	0	0	0
5:41049295:C:T	0	0	0	0	0	0	0	0
5:41054832:A:G	0	0	0	0	0	0	0	0
5:41061614:A:G	0	0	0	0	0	0	0	0
5:41862717:G:A	123	63	147	75	72	1	0	1
5:42646346:T:A	0	0	0	0	0	0	0	0
5:42699942:A:G	0	0	0	0	0	0	0	0
5:42801166:C:T	1	1	1	0	1	1	0	1
5:43039691:T:C	128	108	138	21	117	1.0	0.0	1.0
5:43175001:C:T	11	7	11	4	7	1	0	1
5:43232440:C:G	0	0	0	0	0	0	0	0
5:43297042:A:G	83	43	412	165	247	4	0	1
5:43495497:C:T	5	0	10	10	0	2	2	0
5:43495582:C:T	1	1	1	0	1	1	0	1
5:43588186:C:T	1	1	11	0	11	11	0	11
5:43609241:C:T	109	55	222	101	121	1	0	1
5:44809060:G:C	137	66	147	77	70	1	1	0
5:50633317:G:A	0	0	0	0	0	0	0	0
5:50633516:A:G	0	0	0	0	0	0	0	0
5:50757181:G:A	0	0	0	0	0	0	0	0
5:50761895:G:A	11	7	19	5	14	1	0	1
5:53051539:C:T	0	0	0	0	0	0	0	0
5:53055583:G:A	0	0	0	0	0	0	0	0
5:53083447:C:T	0	0	0	0	0	0	0	0
5:53646367:A:G	347	177	400	210	190	1	1	1
5:53683267:G:A	10	5	10	5	5	1.0	0.5	0.5
5:53859633:G:T	0	0	0	0	0	0	0	0
5:53859858:C:T	0	0	0	0	0	0	0	0
5:54310465:T:C	20	10	28	17	11	1.0	0.5	0.5
5:54456071:G:A	0	0	0	0	0	0	0	0
5:54456158:T:C	0	0	0	0	0	0	0	0
5:54519665:A:C	1	1	2	0	2	2	0	2
5:54956517:T:C	0	0	0	0	0	0	0	0
5:55114271:G:A	0	0	0	0	0	0	0	0
5:55124971:A:C	0	0	0	0	0	0	0	0
5:55137565:G:A	0	0	0	0	0	0	0	0
5:55220693:G:A	0	0	0	0	0	0	0	0
5:55910616:G:A	0	0	0	0	0	0	0	0
5:56872885:C:T	16	9	20	10	10	1.0	0.0	1.0
5:56881616:G:A	15	9	26	13	13	1	0	1
5:56882284:A:G	34	22	46	20	26	1.0	0.0	1.0
5:56911296:T:A	46	24	57	28	29	1.0	0.0	1.0
5:57482276:A:G	0	0	0	0	0	0	0	0
5:58455616:A:G	0	0	0	0	0	0	0	0
5:58457289:C:T	0	0	0	0	0	0	0	0
5:58457322:A:G	0	0	0	0	0	0	0	0
5:60744640:G:A	0	0	0	0	0	0	0	0
5:60893199:G:C	0	0	0	0	0	0	0	0
5:60945315:G:A	189	78	283	158	125	1	1	0
5:61687014:G:A	0	0	0	0	0	0	0	0
5:61703941:C:T	0	0	0	0	0	0	0	0
5:63301972:T:C	0	0	0	0	0	0	0	0
5:64971768:T:C	39	22	54	26	28	1	0	1
5:64977191:G:A	33	11	42	29	13	1	1	0
5:65586109:A:G	23	14	25	9	16	1	0	1
5:66572090:C:T	0	0	0	0	0	0	0	0
5:69217772:G:T	13	2	15	13	2	1	1	0
5:69235426:C:T	139	74	319	183	136	1	0	1
5:69400113:T:G	6	5	6	1	5	1.0	0.0	1.0
5:69419483:C:T	2	2	2	0	2	1.0	0.0	1.0
5:71455991:T:G	265	137	288	146	142	1	1	1
5:71502714:A:G	12	8	32	23	9	1.0	0.0	1.0
5:71504711:G:A	18	4	29	20	9	1.0	1.0	0.0
5:71510630:G:A	22	12	23	11	12	1.0	0.0	1.0
5:71510822:T:A	18	3	23	20	3	1.0	1.0	0.0
5:71510884:C:G	16	4	17	13	4	1.0	1.0	0.0
5:71511131:G:A	14	6	17	9	8	1.0	1.0	0.0
5:71513342:A:G	15	5	20	14	6	1	1	0
5:71544406:C:T	6	4	15	3	12	1.5	0.0	1.0
5:71553194:G:T	2	2	6	0	6	3.0	0.0	3.0
5:72460275:G:A	0	0	0	0	0	0	0	0
5:72725693:T:A	0	0	0	0	0	0	0	0
5:72725707:C:A	0	0	0	0	0	0	0	0
5:72888271:C:T	6	2	8	4	4	1.0	1.0	0.0
5:73052445:A:G	1	0	1	1	0	1	1	0
5:74634926:C:T	0	0	0	0	0	0	0	0
5:74931678:C:T	0	0	0	0	0	0	0	0
5:75104499:C:T	0	0	0	0	0	0	0	0
5:76298918:G:A	0	0	0	0	0	0	0	0
5:76376975:G:C	0	0	0	0	0	0	0	0
5:76627460:C:T	3	1	3	2	1	1	1	0
5:76637140:G:C	6	4	8	2	6	1.0	0.0	1.0
5:76652825:A:G	7	3	8	4	4	1	1	0
5:76819138:C:T	0	0	0	0	0	0	0	0
5:77063199:C:A	23	10	37	20	17	1	1	0
5:77291169:G:A	0	0	0	0	0	0	0	0
5:77413162:A:G	0	0	0	0	0	0	0	0
5:77426618:G:A	0	0	0	0	0	0	0	0
5:77492159:C:T	31	17	120	67	53	3	0	1
5:77776297:G:C	36	18	47	24	23	1.0	0.5	0.5
5:77784944:A:G	0	0	0	0	0	0	0	0
5:77784965:G:A	4	2	4	2	2	1.0	0.5	0.5
5:77785416:T:G	0	0	0	0	0	0	0	0
5:77785843:C:T	0	0	0	0	0	0	0	0
5:79791060:G:A	0	0	0	0	0	0	0	0
5:80065442:G:C	0	0	0	0	0	0	0	0
5:80289053:A:G	0	0	0	0	0	0	0	0
5:80300123:G:A	0	0	0	0	0	0	0	0
5:80300202:T:C	0	0	0	0	0	0	0	0
5:80300356:T:C	0	0	0	0	0	0	0	0
5:80300390:C:T	0	0	0	0	0	0	0	0
5:80300455:C:T	0	0	0	0	0	0	0	0
5:80320264:G:C	0	0	0	0	0	0	0	0
5:80331843:A:T	0	0	0	0	0	0	0	0
5:80359152:A:C	0	0	0	0	0	0	0	0
5:80359648:A:G	0	0	0	0	0	0	0	0
5:82253397:C:T	1	1	1	0	1	1	0	1
5:82253421:C:A	1	1	1	0	1	1	0	1
5:82276365:G:C	8	4	8	4	4	1.0	0.5	0.5
5:82278363:C:T	11	3	11	8	3	1	1	0
5:83490375:T:C	1	1	1	0	1	1	0	1
5:83493828:A:G	1	0	1	1	0	1	1	0
5:83537326:G:A	0	0	0	0	0	0	0	0
5:83537550:A:G	2	0	2	2	0	1.0	1.0	0.0
5:83537572:A:G	1	0	1	1	0	1	1	0
5:83538811:T:C	0	0	0	0	0	0	0	0
5:83539726:A:G	0	0	0	0	0	0	0	0
5:83539905:T:A	0	0	0	0	0	0	0	0
5:83644454:C:G	0	0	0	0	0	0	0	0
5:86287833:C:T	0	0	0	0	0	0	0	0
5:87399457:A:G	15	4	28	18	10	1	1	0
5:88202210:G:A	1	0	1	1	0	1	1	0
5:88203032:G:A	3	2	5	1	4	1	0	1
5:90525167:T:C	89	48	115	52	63	1	0	1
5:90529393:G:A	215	107	1415	700	715	6	1	0
5:90683772:G:A	0	0	0	0	0	0	0	0
5:90683881:C:T	0	0	0	0	0	0	0	0
5:90690065:A:G	0	0	0	0	0	0	0	0
5:90692687:A:G	0	0	0	0	0	0	0	0
5:90694507:A:G	0	0	0	0	0	0	0	0
5:90745693:A:G	0	0	0	0	0	0	0	0
5:90756555:C:T	0	0	0	0	0	0	0	0
5:93268242:A:G	0	0	0	0	0	0	0	0
5:93268329:G:A	0	0	0	0	0	0	0	0
5:94386345:G:T	1	1	2	0	2	2	0	2
5:94942425:T:C	0	0	0	0	0	0	0	0
5:95424098:G:A	1	1	1	0	1	1	0	1
5:95490951:C:A	13	3	14	11	3	1	1	0
5:95525414:G:C	4	2	8	2	6	2.0	0.5	1.5
5:95654174:A:C	3	1	3	2	1	1	1	0
5:95708534:C:T	0	0	0	0	0	0	0	0
5:95708565:C:T	0	0	0	0	0	0	0	0
5:95708692:T:C	0	0	0	0	0	0	0	0
5:95816609:A:G	335	172	428	216	212	1	1	1
5:95858867:T:C	0	0	0	0	0	0	0	0
5:95900755:C:T	2	2	3	0	3	1.5	0.0	1.5
5:96393194:C:G	0	0	0	0	0	0	0	0
5:96740783:G:A	36	1	65	64	1	1.0	1.0	0.0
5:96743698:C:T	0	0	0	0	0	0	0	0
5:96750630:G:C	43	25	70	35	35	1	0	1
5:96783148:G:C	28	12	45	29	16	1.0	1.0	0.0
5:96783162:C:T	26	10	48	30	18	1.0	1.0	0.0
5:96785820:C:T	10	2	11	9	2	1.0	1.0	0.0
5:96786506:C:T	10	2	14	12	2	1.0	1.0	0.0
5:96788627:T:C	9	5	19	10	9	1	0	1
5:96790605:A:G	4	3	7	1	6	1.0	0.0	1.0
5:96793832:T:C	5	1	6	5	1	1	1	0
5:96892368:C:T	15	3	20	17	3	1	1	0
5:96895296:G:T	12	1	13	12	1	1.0	1.0	0.0
5:96896438:T:A	13	1	17	16	1	1	1	0
5:96900192:A:G	0	0	0	0	0	0	0	0
5:96901622:G:A	16	3	24	19	5	1.0	1.0	0.0
5:96909639:C:T	39	13	71	44	27	1	1	0
5:96909735:C:T	30	8	35	27	8	1.0	1.0	0.0
5:96913411:C:T	28	4	37	25	12	1.0	1.0	0.0
5:96936100:C:T	29	14	37	16	21	1	1	0
5:96979616:C:G	5	1	8	7	1	1	1	0
5:97449502:G:A	0	0	0	0	0	0	0	0
5:98833559:G:C	0	0	0	0	0	0	0	0
5:99522765:C:G	0	0	0	0	0	0	0	0
5:99524256:A:G	0	0	0	0	0	0	0	0
5:100067871:C:T	0	0	0	0	0	0	0	0
5:100380129:T:A	0	0	0	0	0	0	0	0
5:103201597:C:T	13	7	13	6	7	1	0	1
5:107725561:T:C	0	0	0	0	0	0	0	0
5:107726653:T:C	0	0	0	0	0	0	0	0
5:109588573:G:A	0	0	0	0	0	0	0	0
5:109774836:T:A	6	3	12	3	9	1.0	0.5	0.5
5:109845981:A:T	11	4	23	18	5	1	1	0
5:109884728:G:A	0	0	0	0	0	0	0	0
5:111103810:A:G	9	5	14	9	5	1	1	1
5:112145903:A:T	2	0	10	10	0	5.0	5.0	0.0
5:112161610:T:G	2	2	7	0	7	3.5	0.0	3.5
5:112184043:T:C	5	4	10	1	9	1	0	1
5:112194587:A:G	5	1	16	15	1	1	1	0
5:112209973:C:G	10	3	15	12	3	1.0	1.0	0.0
5:112419765:C:A	77	59	285	78	207	2	0	1
5:113049105:G:A	0	0	0	0	0	0	0	0
5:113532996:C:A	8	3	13	10	3	1.0	1.0	0.0
5:113553677:G:A	2	0	6	6	0	3.0	3.0	0.0
5:113564005:A:G	3	2	5	3	2	1	0	1
5:113581581:T:G	2	1	2	1	1	1.0	0.5	0.5
5:113584411:C:G	5	3	7	3	4	1	0	1
5:115390764:T:C	0	0	0	0	0	0	0	0
5:115524464:G:A	0	0	0	0	0	0	0	0
5:115913381:C:T	99	2	138	136	2	1	1	0
5:116052233:T:C	42	42	42	0	42	1.0	0.0	1.0
5:116058929:G:A	0	0	0	0	0	0	0	0
5:116092637:G:T	183	90	208	111	97	1	1	0
5:116134076:C:T	63	36	67	27	40	1	0	1
5:116447323:C:T	1	0	8	8	0	8	8	0
5:116716307:T:C	0	0	0	0	0	0	0	0
5:116716490:G:A	0	0	0	0	0	0	0	0
5:116716625:A:T	0	0	0	0	0	0	0	0
5:117778980:A:G	0	0	0	0	0	0	0	0
5:119178181:G:A	13	2	21	17	4	1	1	0
5:119355303:A:G	9	1	19	18	1	1	1	0
5:119452501:C:G	7	5	13	4	9	1	0	1
5:119475838:G:A	103	49	120	63	57	1	1	0
5:119526018:A:G	22	12	22	10	12	1.0	0.0	1.0
5:119652611:C:T	0	0	0	0	0	0	0	0
5:121671480:G:C	0	0	0	0	0	0	0	0
5:122152811:C:G	0	0	0	0	0	0	0	0
5:122450972:G:C	0	0	0	0	0	0	0	0
5:124648222:G:T	10	1	30	29	1	1.0	1.0	0.0
5:126466335:G:A	0	0	0	0	0	0	0	0
5:126544897:T:C	0	0	0	0	0	0	0	0
5:127170960:G:A	0	0	0	0	0	0	0	0
5:127179848:A:G	0	0	0	0	0	0	0	0
5:128109681:C:T	0	0	0	0	0	0	0	0
5:128110131:T:C	0	0	0	0	0	0	0	0
5:128278780:A:G	0	0	0	0	0	0	0	0
5:128330606:C:T	0	0	0	0	0	0	0	0
5:129027137:A:G	0	0	0	0	0	0	0	0
5:129106951:T:C	4	1	4	3	1	1.0	1.0	0.0
5:130185433:A:G	0	0	0	0	0	0	0	0
5:130990246:T:C	57	0	58	58	0	1	1	0
5:131430969:T:C	10	5	36	12	24	3.0	0.5	0.5
5:131472505:T:C	3	1	4	3	1	1	1	0
5:131672501:T:C	4	2	10	3	7	2.5	0.5	1.5
5:131976634:G:T	0	0	0	0	0	0	0	0
5:132060785:C:T	0	0	0	0	0	0	0	0
5:132218587:C:A	1	1	1	0	1	1	0	1
5:132271607:C:T	0	0	0	0	0	0	0	0
5:132271709:T:C	0	0	0	0	0	0	0	0
5:132327369:T:C	0	0	0	0	0	0	0	0
5:132334853:C:G	0	0	0	0	0	0	0	0
5:132340627:C:T	0	0	0	0	0	0	0	0
5:132370257:T:C	2	0	2	2	0	1.0	1.0	0.0
5:132385482:A:G	0	0	0	0	0	0	0	0
5:132758502:A:G	0	0	0	0	0	0	0	0
5:134411663:C:G	462	228	868	473	395	1.0	1.0	0.0
5:135007971:C:T	0	0	0	0	0	0	0	0
5:135008109:A:G	1	1	1	0	1	1	0	1
5:135237758:G:A	0	0	0	0	0	0	0	0
5:135446760:T:A	0	0	0	0	0	0	0	0
5:135446820:T:C	0	0	0	0	0	0	0	0
5:135842453:A:G	0	0	0	0	0	0	0	0
5:135940625:C:T	0	0	0	0	0	0	0	0
5:135941125:G:A	0	0	0	0	0	0	0	0
5:135941158:T:C	0	0	0	0	0	0	0	0
5:135951257:A:G	0	0	0	0	0	0	0	0
5:136047300:G:C	8	3	10	7	3	1.0	1.0	0.0
5:136047351:G:A	7	3	11	7	4	1	1	0
5:137908828:G:A	0	0	0	0	0	0	0	0
5:138090758:G:A	0	0	0	0	0	0	0	0
5:138150951:A:T	0	0	0	0	0	0	0	0
5:138185967:A:G	1	1	1	0	1	1	0	1
5:138192259:C:T	2	0	3	3	0	1.5	1.5	0.0
5:138329634:G:A	0	0	0	0	0	0	0	0
5:138372745:C:T	24	13	27	11	16	1.0	0.0	1.0
5:138419006:T:C	11	4	14	8	6	1	1	0
5:138556481:G:A	43	17	54	35	19	1	1	0
5:138566650:T:C	18	9	27	17	10	1.0	0.5	0.5
5:140360869:C:T	0	0	0	0	0	0	0	0
5:140558652:C:T	2	2	2	0	2	1.0	0.0	1.0
5:140560717:G:A	3	2	13	2	11	2	0	2
5:140647631:T:C	136	75	143	64	79	1.0	0.0	1.0
5:140668959:C:T	4	2	5	2	3	1.0	0.5	0.5
5:140672686:A:G	0	0	0	0	0	0	0	0
5:140787878:C:T	0	0	0	0	0	0	0	0
5:140788485:A:G	0	0	0	0	0	0	0	0
5:140788566:G:T	0	0	0	0	0	0	0	0
5:140795037:G:A	0	0	0	0	0	0	0	0
5:140795280:G:C	0	0	0	0	0	0	0	0
5:140802149:A:G	0	0	0	0	0	0	0	0
5:140802307:T:C	0	0	0	0	0	0	0	0
5:140802516:G:T	0	0	0	0	0	0	0	0
5:140803473:G:A	0	0	0	0	0	0	0	0
5:140807352:G:T	0	0	0	0	0	0	0	0
5:140807737:C:T	0	0	0	0	0	0	0	0
5:140808798:T:G	0	0	0	0	0	0	0	0
5:140808816:A:G	0	0	0	0	0	0	0	0
5:140808990:G:C	0	0	0	0	0	0	0	0
5:140821835:T:C	0	0	0	0	0	0	0	0
5:140823847:C:T	0	0	0	0	0	0	0	0
5:140829882:T:G	0	0	0	0	0	0	0	0
5:140841554:G:A	0	0	0	0	0	0	0	0
5:140842572:A:C	0	0	0	0	0	0	0	0
5:140843056:A:G	0	0	0	0	0	0	0	0
5:140848579:C:A	0	0	0	0	0	0	0	0
5:140849783:G:C	0	0	0	0	0	0	0	0
5:140849941:T:G	0	0	0	0	0	0	0	0
5:140850785:AA:CC	0	0	0	0	0	0	0	0
5:141136460:C:T	0	0	0	0	0	0	0	0
5:141180333:C:T	0	0	0	0	0	0	0	0
5:141210271:C:T	0	0	0	0	0	0	0	0
5:141224760:A:T	0	0	0	0	0	0	0	0
5:141332286:G:A	0	0	0	0	0	0	0	0
5:141332643:G:T	0	0	0	0	0	0	0	0
5:141332732:A:T	0	0	0	0	0	0	0	0
5:141344493:A:C	0	0	0	0	0	0	0	0
5:141346261:C:T	0	0	0	0	0	0	0	0
5:141346456:A:T	0	0	0	0	0	0	0	0
5:141351455:A:G	0	0	0	0	0	0	0	0
5:141351841:A:G	0	0	0	0	0	0	0	0
5:141355648:G:A	0	0	0	0	0	0	0	0
5:141356907:T:G	0	0	0	0	0	0	0	0
5:141362171:G:C	0	0	0	0	0	0	0	0
5:141362194:A:G	0	0	0	0	0	0	0	0
5:141364828:T:C	0	0	0	0	0	0	0	0
5:141366152:C:T	0	0	0	0	0	0	0	0
5:141371561:C:G	0	0	0	0	0	0	0	0
5:141372129:C:A	0	0	0	0	0	0	0	0
5:141375820:C:T	0	0	0	0	0	0	0	0
5:141383462:A:G	0	0	0	0	0	0	0	0
5:141405253:C:T	0	0	0	0	0	0	0	0
5:141408283:C:G	0	0	0	0	0	0	0	0
5:141410366:G:A	0	0	0	0	0	0	0	0
5:141413440:A:G	2	0	3	3	0	1.5	1.5	0.0
5:141418063:G:T	0	0	0	0	0	0	0	0
5:141422889:G:A	0	0	0	0	0	0	0	0
5:141423156:C:T	0	0	0	0	0	0	0	0
5:141427454:T:C	0	0	0	0	0	0	0	0
5:141478231:T:C	0	0	0	0	0	0	0	0
5:141489436:T:C	0	0	0	0	0	0	0	0
5:141634927:T:C	513	300	696	309	387	1	0	1
5:141646720:C:T	13	5	21	12	9	1	1	0
5:141656770:A:G	0	0	0	0	0	0	0	0
5:141928268:T:C	28	14	31	15	16	1.0	0.5	0.5
5:141929700:C:T	7	3	7	4	3	1	1	0
5:141945684:T:C	1	0	14	14	0	14	14	0
5:141955676:A:G	0	0	0	0	0	0	0	0
5:141955719:G:A	0	0	0	0	0	0	0	0
5:141956699:G:T	0	0	0	0	0	0	0	0
5:141957561:C:T	0	0	0	0	0	0	0	0
5:141957660:A:G	0	0	0	0	0	0	0	0
5:145228777:A:T	0	0	0	0	0	0	0	0
5:145228831:A:T	0	0	0	0	0	0	0	0
5:145229507:A:G	0	0	0	0	0	0	0	0
5:145229800:C:T	0	0	0	0	0	0	0	0
5:145866522:T:G	0	0	0	0	0	0	0	0
5:145997573:T:C	0	0	0	0	0	0	0	0
5:145997860:T:C	0	0	0	0	0	0	0	0
5:145997916:C:T	0	0	0	0	0	0	0	0
5:146013801:C:T	0	0	0	0	0	0	0	0
5:146062570:G:A	0	0	0	0	0	0	0	0
5:146062640:G:C	0	0	0	0	0	0	0	0
5:146104281:A:T	0	0	0	0	0	0	0	0
5:146120433:C:T	21	15	23	6	17	1	0	1
5:146128777:A:G	15	8	19	9	10	1	0	1
5:146129073:TA:CC	9	3	10	7	3	1	1	0
5:146140258:G:A	14	7	18	10	8	1.0	0.5	0.5
5:146143542:G:A	6	2	8	5	3	1.0	1.0	0.0
5:146160433:T:G	11	4	11	7	4	1	1	0
5:146164409:G:A	16	5	21	15	6	1.0	1.0	0.0
5:146510606:C:T	16	6	16	10	6	1.0	1.0	0.0
5:147922802:C:A	0	0	0	0	0	0	0	0
5:147922824:G:T	0	0	0	0	0	0	0	0
5:148118456:G:A	0	0	0	0	0	0	0	0
5:148120053:C:T	0	0	0	0	0	0	0	0
5:148120107:C:T	0	0	0	0	0	0	0	0
5:148125553:G:A	0	0	0	0	0	0	0	0
5:148127030:A:G	0	0	0	0	0	0	0	0
5:148131303:T:C	0	0	0	0	0	0	0	0
5:148137035:T:C	0	0	0	0	0	0	0	0
5:148213934:C:A	0	0	0	0	0	0	0	0
5:148314263:G:A	0	0	0	0	0	0	0	0
5:148323853:C:T	5	0	6	6	0	1	1	0
5:148425557:T:C	5	3	5	2	3	1	0	1
5:148662667:G:T	0	0	0	0	0	0	0	0
5:148826877:G:A	130	67	141	72	69	1.0	1.0	1.0
5:148827083:G:A	14	6	19	8	11	1.0	1.0	0.0
5:148827884:G:C	6	3	11	3	8	1.5	0.5	1.0
5:149003782:C:G	0	0	0	0	0	0	0	0
5:149006962:T:G	0	0	0	0	0	0	0	0
5:149028329:GC:AA	0	0	0	0	0	0	0	0
5:149199073:T:C	0	0	0	0	0	0	0	0
5:149200462:G:A	0	0	0	0	0	0	0	0
5:149368339:G:C	2	2	2	0	2	1.0	0.0	1.0
5:149896561:T:C	0	0	0	0	0	0	0	0
5:150120109:T:C	0	0	0	0	0	0	0	0
5:150392717:C:G	14	5	29	16	13	1.5	1.0	0.0
5:150396669:C:T	19	6	46	27	19	1	1	0
5:150527971:T:G	0	0	0	0	0	0	0	0
5:151138797:AG:GA	2	0	2	2	0	1.0	1.0	0.0
5:151185447:C:T	24	10	27	14	13	1.0	1.0	0.0
5:151267327:T:C	49	26	58	28	30	1	0	1
5:151316886:C:T	0	0	0	0	0	0	0	0
5:151316937:G:A	0	0	0	0	0	0	0	0
5:151316979:C:T	0	0	0	0	0	0	0	0
5:151325197:A:G	0	0	0	0	0	0	0	0
5:151344245:G:A	0	0	0	0	0	0	0	0
5:151507321:G:A	0	0	0	0	0	0	0	0
5:151521550:A:G	0	0	0	0	0	0	0	0
5:151521739:G:A	0	0	0	0	0	0	0	0
5:151545583:A:G	0	0	0	0	0	0	0	0
5:151567567:G:A	0	0	0	0	0	0	0	0
5:153650400:T:C	0	0	0	0	0	0	0	0
5:154033830:C:T	15	6	20	10	10	1	1	0
5:154049899:T:C	4	3	5	1	4	1.0	0.0	1.0
5:154053173:T:C	1	1	1	0	1	1	0	1
5:154053410:C:T	0	0	0	0	0	0	0	0
5:154337673:G:A	1	1	9	0	9	9	0	9
5:154493732:A:G	0	0	0	0	0	0	0	0
5:154917977:T:C	6	2	6	4	2	1.0	1.0	0.0
5:154966765:G:A	43	27	49	18	31	1	0	1
5:157240270:G:A	0	0	0	0	0	0	0	0
5:159917454:G:A	0	0	0	0	0	0	0	0
5:159950553:G:A	0	0	0	0	0	0	0	0
5:159951152:G:T	0	0	0	0	0	0	0	0
5:160349630:C:T	0	0	0	0	0	0	0	0
5:160670489:A:G	0	0	0	0	0	0	0	0
5:160670625:G:A	0	0	0	0	0	0	0	0
5:168423743:A:G	0	0	0	0	0	0	0	0
5:168464825:T:C	0	0	0	0	0	0	0	0
5:168486505:G:A	11	8	14	4	10	1	0	1
5:168506055:A:G	9	4	19	13	6	1	1	0
5:168516822:G:A	3	2	3	1	2	1	0	1
5:168753076:C:T	0	0	0	0	0	0	0	0
5:168785946:A:G	0	0	0	0	0	0	0	0
5:169594606:C:T	0	0	0	0	0	0	0	0
5:169601477:T:C	4	1	4	3	1	1.0	1.0	0.0
5:169604146:T:C	4	2	4	2	2	1.0	0.5	0.5
5:170008709:A:C	15	6	16	10	6	1	1	0
5:170141195:T:C	0	0	0	0	0	0	0	0
5:170141636:G:A	0	0	0	0	0	0	0	0
5:170258159:C:T	3	1	3	2	1	1	1	0
5:170812108:C:A	0	0	0	0	0	0	0	0
5:171392883:G:A	1	0	1	1	0	1	1	0
5:172053051:G:A	0	0	0	0	0	0	0	0
5:172054602:A:G	28	17	31	11	20	1.0	0.0	1.0
5:172106778:T:C	53	21	123	85	38	2	1	0
5:172200697:G:A	3	0	3	3	0	1	1	0
5:172975908:G:A	2	0	2	2	0	1.0	1.0	0.0
5:172976020:T:C	0	0	0	0	0	0	0	0
5:173226233:A:G	0	0	0	0	0	0	0	0
5:173235021:T:C	0	0	0	0	0	0	0	0
5:174562032:C:T	0	0	0	0	0	0	0	0
5:176308440:A:G	0	0	0	0	0	0	0	0
5:176584888:G:A	0	0	0	0	0	0	0	0
5:176590454:C:T	0	0	0	0	0	0	0	0
5:176626644:C:G	0	0	0	0	0	0	0	0
5:176654906:C:T	3	1	3	2	1	1	1	0
5:176887205:T:C	0	0	0	0	0	0	0	0
5:177091783:C:T	0	0	0	0	0	0	0	0
5:177306115:A:G	47	30	62	26	36	1	0	1
5:177310719:A:G	2	2	11	0	11	5.5	0.0	5.5
5:177388123:T:C	0	0	0	0	0	0	0	0
5:177409531:A:G	0	0	0	0	0	0	0	0
5:177440942:A:G	29	12	34	20	14	1	1	0
5:177458498:T:C	3	0	3	3	0	1	1	0
5:177467755:C:T	1	0	1	1	0	1	1	0
5:177489515:C:T	7	7	8	0	8	1	0	1
5:177489554:C:T	7	1	7	6	1	1	1	0
5:177513383:G:A	6	3	7	4	3	1.0	0.5	0.5
5:177608963:T:C	4	1	7	6	1	1.0	1.0	0.0
5:177631695:G:A	15	8	30	13	17	1	0	1
5:177995907:A:G	0	0	0	0	0	0	0	0
5:178055693:T:C	486	15	562	547	15	1.0	1.0	0.0
5:178166028:C:T	1	0	1	1	0	1	1	0
5:178166045:G:A	1	0	1	1	0	1	1	0
5:178186295:C:T	0	0	0	0	0	0	0	0
5:178187000:T:C	0	0	0	0	0	0	0	0
5:178187089:GCTCC:CCTCG	0	0	0	0	0	0	0	0
5:178187136:C:T	0	0	0	0	0	0	0	0
5:178867058:T:C	11	2	26	20	6	1	1	0
5:178965504:T:G	0	0	0	0	0	0	0	0
5:178986946:T:C	0	0	0	0	0	0	0	0
5:178988936:A:G	0	0	0	0	0	0	0	0
5:178989062:G:A	0	0	0	0	0	0	0	0
5:178989287:G:A	0	0	0	0	0	0	0	0
5:179028126:C:T	6	3	7	3	4	1.0	0.5	0.5
5:179082701:TT:GA	3	1	3	2	1	1	1	0
5:179207546:G:A	0	0	0	0	0	0	0	0
5:179609432:G:A	30	8	59	51	8	1.0	1.0	0.0
5:179617892:G:A	86	45	123	62	61	1.0	0.0	1.0
5:179623187:A:C	17	7	89	60	29	4	1	0
5:179642550:G:A	0	0	0	0	0	0	0	0
5:180102124:G:A	0	0	0	0	0	0	0	0
5:180302519:A:G	0	0	0	0	0	0	0	0
5:180352607:G:C	0	0	0	0	0	0	0	0
5:180612606:C:T	0	0	0	0	0	0	0	0
5:180630293:T:C	0	0	0	0	0	0	0	0
5:180791668:A:G	9	2	9	7	2	1	1	0
5:180911368:A:G	0	0	0	0	0	0	0	0
5:180947534:G:A	0	0	0	0	0	0	0	0
5:180949972:CAT:GAG	0	0	0	0	0	0	0	0
5:180950331:T:C	0	0	0	0	0	0	0	0
5:180950470:G:A	0	0	0	0	0	0	0	0
5:180982462:C:G	0	0	0	0	0	0	0	0
5:180982595:A:G	0	0	0	0	0	0	0	0
5:181005416:C:T	0	0	0	0	0	0	0	0
5:181045498:C:T	0	0	0	0	0	0	0	0
5:181045513:A:G	0	0	0	0	0	0	0	0
5:181059247:G:T	0	0	0	0	0	0	0	0
5:181283362:C:T	0	0	0	0	0	0	0	0
6:350829:G:A	86	42	94	49	45	1.0	1.0	0.0
6:656343:T:C	0	0	0	0	0	0	0	0
6:2959279:C:T	209	120	249	120	129	1	0	1
6:3015631:C:T	2	1	3	2	1	1.5	1.0	0.5
6:3978471:C:T	0	0	0	0	0	0	0	0
6:4079641:T:C	0	0	0	0	0	0	0	0
6:4115524:C:T	0	0	0	0	0	0	0	0
6:4122015:C:A	3	0	11	11	0	4	4	0
6:4133621:C:T	199	95	228	125	103	1	1	0
6:4715782:A:G	0	0	0	0	0	0	0	0
6:4715803:T:C	0	0	0	0	0	0	0	0
6:4734801:T:C	0	0	0	0	0	0	0	0
6:4734837:C:G	0	0	0	0	0	0	0	0
6:5086324:C:A	1	0	6	6	0	6	6	0
6:5431107:A:G	5	0	15	15	0	2	2	0
6:5817628:A:G	0	0	0	0	0	0	0	0
6:7211585:G:A	5	4	6	1	5	1	0	1
6:7393219:C:T	50	26	74	40	34	1.0	0.5	1.0
6:7405275:G:A	6	2	7	5	2	1.0	1.0	0.0
6:7506389:G:A	0	0	0	0	0	0	0	0
6:7516898:A:T	0	0	0	0	0	0	0	0
6:7517276:T:C	0	0	0	0	0	0	0	0
6:7542041:T:C	1	0	4	4	0	4	4	0
6:7986614:G:A	0	0	0	0	0	0	0	0
6:7987650:G:C	0	0	0	0	0	0	0	0
6:7987956:T:C	0	0	0	0	0	0	0	0
6:10118983:C:T	0	0	0	0	0	0	0	0
6:10574898:T:C	0	0	0	0	0	0	0	0
6:10634480:A:G	0	0	0	0	0	0	0	0
6:10796298:G:A	1	1	1	0	1	1	0	1
6:10963782:G:A	0	0	0	0	0	0	0	0
6:11005453:G:A	0	0	0	0	0	0	0	0
6:12120212:A:G	8	2	16	14	2	1.0	1.0	0.0
6:12120355:C:T	7	1	15	12	3	2	1	0
6:12121941:A:G	3	1	3	2	1	1	1	0
6:12123016:A:G	3	1	4	3	1	1	1	0
6:12124622:G:A	2	1	2	1	1	1.0	0.5	0.5
6:12125539:A:G	6	1	7	6	1	1.0	1.0	0.0
6:13288346:G:A	9	5	12	5	7	1	0	1
6:13288416:A:G	9	4	11	5	6	1	1	0
6:13295283:A:C	2	2	4	0	4	2.0	0.0	2.0
6:13295304:C:T	2	2	3	0	3	1.5	0.0	1.5
6:13360856:A:G	1	1	1	0	1	1	0	1
6:15523817:C:G	3	1	3	2	1	1	1	0
6:15524249:G:A	1	1	1	0	1	1	0	1
6:15662887:T:C	267	122	326	173	153	1	1	0
6:16290530:T:A	0	0	0	0	0	0	0	0
6:16327384:A:G	1	1	1	0	1	1	0	1
6:17602595:G:T	2	0	2	2	0	1.0	1.0	0.0
6:17602608:C:T	2	0	2	2	0	1.0	1.0	0.0
6:17602632:C:T	2	0	2	2	0	1.0	1.0	0.0
6:17602664:A:G	3	0	3	3	0	1	1	0
6:17602679:G:A	3	0	3	3	0	1	1	0
6:17665248:G:C	5	3	10	7	3	1	0	1
6:17675015:T:C	4	2	4	2	2	1.0	0.5	0.5
6:17764299:C:T	0	0	0	0	0	0	0	0
6:17764524:T:C	0	0	0	0	0	0	0	0
6:18138983:G:A	0	0	0	0	0	0	0	0
6:18161332:G:A	77	41	119	50	69	1	0	1
6:18237430:C:T	98	45	126	66	60	1.0	1.0	0.0
6:18364502:G:C	0	0	0	0	0	0	0	0
6:19613478:C:T	0	0	0	0	0	0	0	0
6:22569960:T:C	0	0	0	0	0	0	0	0
6:24002235:A:G	0	0	0	0	0	0	0	0
6:24290975:T:C	0	0	0	0	0	0	0	0
6:24403227:C:T	200	98	259	144	115	1.0	1.0	0.0
6:24410790:A:G	1	1	2	0	2	2	0	2
6:24418558:T:C	5	4	12	3	9	2	0	2
6:24437230:T:C	0	0	0	0	0	0	0	0
6:24462792:G:C	0	0	0	0	0	0	0	0
6:24489424:C:T	3	2	3	1	2	1	0	1
6:24489513:A:C	0	0	0	0	0	0	0	0
6:24503362:C:T	4	1	5	3	2	1.0	1.0	0.0
6:24806366:C:T	67	33	79	42	37	1	1	0
6:24818557:A:G	57	26	153	75	78	2	1	0
6:24976946:A:C	4	0	4	4	0	1.0	1.0	0.0
6:25113703:G:A	3	1	10	8	2	2	2	0
6:25115068:G:T	7	2	22	19	3	1	1	0
6:25435530:A:G	8	5	11	6	5	1.0	0.0	1.0
6:25727037:C:T	0	0	0	0	0	0	0	0
6:25727106:C:T	0	0	0	0	0	0	0	0
6:25850617:C:T	0	0	0	0	0	0	0	0
6:25862238:C:T	0	0	0	0	0	0	0	0
6:25966840:C:T	28	15	64	40	24	1.0	0.0	1.0
6:26033278:G:A	9	8	9	1	8	1	0	1
6:26044141:A:G	5	1	21	20	1	5	5	0
6:26045701:T:C	4	4	4	0	4	1.0	0.0	1.0
6:26056321:A:G	931	515	1583	838	745	1	1	1
6:26090951:C:G	11	10	11	1	10	1	0	1
6:26091108:T:C	1	0	1	1	0	1	1	0
6:26107562:G:T	0	0	0	0	0	0	0	0
6:26108054:C:G	0	0	0	0	0	0	0	0
6:26183813:A:G	0	0	0	0	0	0	0	0
6:26198994:G:A	27	19	123	37	86	4	0	3
6:26199594:A:G	12	9	12	3	9	1.0	0.0	1.0
6:26199852:C:T	16	5	16	11	5	1.0	1.0	0.0
6:26199855:A:G	14	9	14	5	9	1.0	0.0	1.0
6:26202377:G:A	1	1	2	0	2	2	0	2
6:26216428:T:C	14	9	15	6	9	1.0	0.0	1.0
6:26234655:A:G	364	278	513	134	379	1.0	0.0	1.0
6:26234724:A:G	592	446	872	252	620	1.0	0.0	1.0
6:26285275:C:T	50	17	53	35	18	1.0	1.0	0.0
6:26285332:A:G	57	27	62	33	29	1	1	0
6:26370377:T:C	30	7	43	36	7	1.0	1.0	0.0
6:26370429:AAC:GAT	26	5	35	30	5	1.0	1.0	0.0
6:26370479:T:C	22	2	28	26	2	1.0	1.0	0.0
6:26372893:G:A	3	0	6	6	0	1	1	0
6:26372922:C:T	24	3	38	26	12	1.0	1.0	0.0
6:26373279:G:A	24	4	37	28	9	1.0	1.0	0.0
6:26374321:T:C	26	26	88	0	88	2.0	0.0	2.0
6:26374750:T:C	0	0	0	0	0	0	0	0
6:26375875:A:G	36	3	45	42	3	1.0	1.0	0.0
6:26376800:G:A	14	4	16	12	4	1.0	1.0	0.0
6:26377157:C:G	13	2	16	14	2	1	1	0
6:26392287:G:C	9	4	9	5	4	1	1	0
6:26392793:G:A	9	7	20	4	16	1	0	1
6:26463432:G:A	5	4	7	1	6	1	0	1
6:26468098:G:A	14	7	14	7	7	1.0	0.5	0.5
6:26468317:G:C	9	4	9	5	4	1	1	0
6:26468432:G:A	6	3	6	3	3	1.0	0.5	0.5
6:26597105:A:G	408	200	490	254	236	1.0	1.0	0.0
6:27310241:C:A	0	0	0	0	0	0	0	0
6:27359221:C:T	1	0	1	1	0	1	1	0
6:27407832:A:C	0	0	0	0	0	0	0	0
6:27457406:C:A	5	3	5	2	3	1	0	1
6:27523520:G:A	0	0	0	0	0	0	0	0
6:27737281:G:T	0	0	0	0	0	0	0	0
6:27807896:A:G	0	0	0	0	0	0	0	0
6:27871968:T:C	1	1	1	0	1	1	0	1
6:27911422:C:A	0	0	0	0	0	0	0	0
6:27912204:A:G	0	0	0	0	0	0	0	0
6:28091242:G:A	19	12	71	23	48	4	0	2
6:28091439:G:C	18	9	51	31	20	2.0	0.5	0.5
6:28136856:G:T	0	0	0	0	0	0	0	0
6:28153120:G:A	4	2	6	3	3	1.5	0.5	0.5
6:28272137:G:A	36	10	49	38	11	1.0	1.0	0.0
6:28301047:A:G	0	0	0	0	0	0	0	0
6:28301886:A:G	0	0	0	0	0	0	0	0
6:28326773:T:C	2	1	2	1	1	1.0	0.5	0.5
6:28329536:T:A	2	2	2	0	2	1.0	0.0	1.0
6:28363350:AA:GC	6	3	11	6	5	1.0	0.5	0.5
6:28391393:A:G	0	0	0	0	0	0	0	0
6:28447190:G:T	0	0	0	0	0	0	0	0
6:28574743:C:T	0	0	0	0	0	0	0	0
6:28575487:C:T	0	0	0	0	0	0	0	0
6:28969405:C:T	0	0	0	0	0	0	0	0
6:29173855:T:C	0	0	0	0	0	0	0	0
6:29174072:T:C	0	0	0	0	0	0	0	0
6:29174277:C:G	0	0	0	0	0	0	0	0
6:29174287:A:G	0	0	0	0	0	0	0	0
6:29181784:G:A	0	0	0	0	0	0	0	0
6:29181828:G:T	0	0	0	0	0	0	0	0
6:29181855:T:G	0	0	0	0	0	0	0	0
6:29181868:C:T	0	0	0	0	0	0	0	0
6:29262800:C:A	0	0	0	0	0	0	0	0
6:29262906:T:C	0	0	0	0	0	0	0	0
6:29374998:G:A	0	0	0	0	0	0	0	0
6:29375048:G:A	0	0	0	0	0	0	0	0
6:29556175:A:G	0	0	0	0	0	0	0	0
6:29556180:A:G	0	0	0	0	0	0	0	0
6:29588032:C:T	0	0	0	0	0	0	0	0
6:29659445:C:A	0	0	0	0	0	0	0	0
6:29726192:C:T	39	19	42	23	19	1	1	0
6:29726793:A:G	41	15	74	44	30	1	1	0
6:29726903:AA:CT	105	41	351	202	149	3	1	0
6:29888526:C:T	15	6	21	13	8	1	1	0
6:29926449:G:T	14	14	46	0	46	3.0	0.0	3.0
6:29926719:C:G	60	39	152	42	110	2.0	0.0	1.0
6:29926823:G:T	80	26	317	208	109	3.5	2.0	0.0
6:29927255:G:C	2	0	3	3	0	1.5	1.5	0.0
6:29927322:C:A	3	0	5	5	0	1	1	0
6:29928224:C:A	0	0	0	0	0	0	0	0
6:29928307:A:G	6	0	6	6	0	1.0	1.0	0.0
6:29928491:T:C	1	1	1	0	1	1	0	1
6:29928498:G:A	0	0	0	0	0	0	0	0
6:29943542:G:T	1515	3	3500	3497	3	2	2	0
6:29972329:G:A	0	0	0	0	0	0	0	0
6:29972425:G:A	0	0	0	0	0	0	0	0
6:29975228:G:C	0	0	0	0	0	0	0	0
6:29975258:GGAAG:AGAAT	0	0	0	0	0	0	0	0
6:30064745:A:C	5	4	8	1	7	1	0	1
6:30070870:T:C	1	1	3	0	3	3	0	3
6:30108087:A:G	0	0	0	0	0	0	0	0
6:30108126:C:T	0	0	0	0	0	0	0	0
6:30108978:G:A	0	0	0	0	0	0	0	0
6:30110498:C:T	0	0	0	0	0	0	0	0
6:30110553:C:T	0	0	0	0	0	0	0	0
6:30112497:G:A	0	0	0	0	0	0	0	0
6:30112719:G:A	0	0	0	0	0	0	0	0
6:30147068:T:C	0	0	0	0	0	0	0	0
6:30147178:C:T	0	0	0	0	0	0	0	0
6:30147765:G:A	0	0	0	0	0	0	0	0
6:30153683:C:T	0	0	0	0	0	0	0	0
6:30171922:G:A	0	0	0	0	0	0	0	0
6:30198489:C:T	7	5	11	6	5	1	0	1
6:30259648:C:G	42	23	62	26	36	1.0	0.0	1.0
6:30469199:T:G	2	0	2	2	0	1.0	1.0	0.0
6:30486012:A:C	51	0	56	56	0	1	1	0
6:30553360:G:A	9	6	25	16	9	1	0	1
6:30562468:T:C	2	2	3	0	3	1.5	0.0	1.5
6:30643573:C:A	1	0	2	2	0	2	2	0
6:30685004:C:T	17	8	22	11	11	1	1	0
6:30730764:A:G	19	17	25	2	23	1	0	1
6:30741580:G:A	29	20	31	9	22	1	0	1
6:30814225:C:T	0	0	0	0	0	0	0	0
6:30814328:T:C	0	0	0	0	0	0	0	0
6:30814428:G:C	0	0	0	0	0	0	0	0
6:30814458:G:A	0	0	0	0	0	0	0	0
6:30814526:C:T	0	0	0	0	0	0	0	0
6:30814584:G:A	0	0	0	0	0	0	0	0
6:30814630:A:G	1	1	1	0	1	1	0	1
6:30889295:G:C	0	0	0	0	0	0	0	0
6:30891080:C:T	1	0	1	1	0	1	1	0
6:30897427:A:C	0	0	0	0	0	0	0	0
6:30897499:C:T	0	0	0	0	0	0	0	0
6:30909983:A:C	25	15	48	31	17	1	0	1
6:30920384:T:C	3	3	3	0	3	1	0	1
6:30921612:T:C	2	1	2	1	1	1.0	0.5	0.5
6:30926164:G:A	5	1	7	6	1	1	1	0
6:30931747:T:C	0	0	0	0	0	0	0	0
6:30931794:C:T	0	0	0	0	0	0	0	0
6:30951614:G:A	0	0	0	0	0	0	0	0
6:30952347:G:A	0	0	0	0	0	0	0	0
6:31025600:T:A	0	0	0	0	0	0	0	0
6:31025756:A:G	0	0	0	0	0	0	0	0
6:31025790:G:T	0	0	0	0	0	0	0	0
6:31112112:C:G	0	0	0	0	0	0	0	0
6:31112239:C:G	0	0	0	0	0	0	0	0
6:31116036:T:C	0	0	0	0	0	0	0	0
6:31116271:A:G	0	0	0	0	0	0	0	0
6:31117187:T:C	0	0	0	0	0	0	0	0
6:31117492:A:G	0	0	0	0	0	0	0	0
6:31117579:C:T	0	0	0	0	0	0	0	0
6:31120368:T:A	0	0	0	0	0	0	0	0
6:31138400:T:C	7	6	9	2	7	1	0	1
6:31138491:A:G	2	1	3	2	1	1.5	1.0	0.5
6:31143403:T:C	3	3	4	0	4	1	0	1
6:31145253:A:G	5	2	12	10	2	1	1	0
6:31145275:G:A	6	3	13	10	3	1.0	0.5	0.5
6:31148433:G:A	1	1	2	0	2	2	0	2
6:31148469:G:A	1	1	1	0	1	1	0	1
6:31150788:C:G	4	3	4	1	3	1.0	0.0	1.0
6:31154705:G:A	28	12	28	16	12	1.0	1.0	0.0
6:31157072:C:T	12	9	12	3	9	1.0	0.0	1.0
6:31157381:C:T	0	0	0	0	0	0	0	0
6:31161865:A:C	6	4	6	2	4	1.0	0.0	1.0
6:31162725:T:C	4	1	5	3	2	1.0	1.0	0.0
6:31165732:G:A	0	0	0	0	0	0	0	0
6:31170330:G:A	0	0	0	0	0	0	0	0
6:31197789:T:C	118	55	145	77	68	1.0	1.0	0.0
6:31269076:GT:AC	823	478	1136	542	594	1	1	1
6:31275763:G:A	0	0	0	0	0	0	0	0
6:31276069:G:T	0	0	0	0	0	0	0	0
6:31276082:C:T	0	0	0	0	0	0	0	0
6:31276107:G:A	0	0	0	0	0	0	0	0
6:31280392:C:T	160	0	179	179	0	1.0	1.0	0.0
6:31280657:A:G	93	93	97	0	97	1	0	1
6:31280901:T:C	0	0	0	0	0	0	0	0
6:31281355:A:T	0	0	0	0	0	0	0	0
6:31281419:A:C	0	0	0	0	0	0	0	0
6:31281440:G:A	88	0	136	136	0	1.0	1.0	0.0
6:31410581:T:G	24	13	31	14	17	1.0	0.0	1.0
6:31410610:T:C	36	22	49	19	30	1.0	0.0	1.0
6:31410648:A:G	56	32	69	28	41	1.0	0.0	1.0
6:31411200:G:A	7	4	7	3	4	1	0	1
6:31412154:G:A	4	1	5	3	2	1.0	1.0	0.0
6:31415105:C:A	6	5	6	1	5	1.0	0.0	1.0
6:31415134:A:G	5	4	5	1	4	1	0	1
6:31505769:A:G	207	114	255	114	141	1	0	1
6:31505784:A:G	198	106	249	117	132	1.0	0.0	1.0
6:31506180:C:G	48	24	55	31	24	1.0	0.5	0.5
6:31506223:G:A	22	8	27	19	8	1.0	1.0	0.0
6:31519543:A:G	0	0	0	0	0	0	0	0
6:31520177:G:C	0	0	0	0	0	0	0	0
6:31529148:G:A	0	0	0	0	0	0	0	0
6:31538847:T:C	438	287	977	384	593	2.0	0.0	1.0
6:31538871:G:T	0	0	0	0	0	0	0	0
6:31541655:G:A	23	11	28	16	12	1	1	0
6:31542328:A:G	2	1	7	4	3	3.5	2.0	1.5
6:31546087:A:T	1	1	1	0	1	1	0	1
6:31573007:C:A	178	78	262	158	104	1.0	1.0	0.0
6:31587353:A:G	3	2	3	1	2	1	0	1
6:31630712:A:G	14	8	35	14	21	2.0	0.0	1.0
6:31635993:A:G	44	20	53	31	22	1.0	1.0	0.0
6:31636814:C:T	38	19	46	24	22	1.0	1.0	0.5
6:31641495:T:C	5	2	9	4	5	2	1	0
6:31659672:C:G	10	9	17	2	15	1.0	0.0	1.0
6:31664357:C:A	94	31	98	67	31	1.0	1.0	0.0
6:31707988:G:A	0	0	0	0	0	0	0	0
6:31719231:G:A	0	0	0	0	0	0	0	0
6:31781043:G:A	11	5	17	10	7	1	1	0
6:31901161:C:T	4	2	4	2	2	1.0	0.5	0.5
6:31969018:G:C	20	8	21	13	8	1.0	1.0	0.0
6:32061638:T:C	0	0	0	0	0	0	0	0
6:32064966:G:A	0	0	0	0	0	0	0	0
6:32067917:C:T	0	0	0	0	0	0	0	0
6:32096949:T:C	0	0	0	0	0	0	0	0
6:32154695:C:A	22	14	53	18	35	2.0	0.0	1.0
6:32179919:G:A	431	210	535	282	253	1	1	0
6:32180254:A:G	45	17	48	31	17	1	1	0
6:32186508:A:G	5	5	5	0	5	1	0	1
6:32220520:G:C	0	0	0	0	0	0	0	0
6:32220826:C:T	0	0	0	0	0	0	0	0
6:32220863:TCT:CCC	0	0	0	0	0	0	0	0
6:32221255:T:C	0	0	0	0	0	0	0	0
6:32255855:G:A	20	8	38	28	10	1.0	1.0	0.0
6:32288641:T:C	0	0	0	0	0	0	0	0
6:32293475:T:G	2	0	3	3	0	1.5	1.5	0.0
6:32293730:T:C	6	3	23	11	12	3.0	0.5	0.5
6:32293994:A:G	3	3	4	0	4	1	0	1
6:32325375:A:G	0	0	0	0	0	0	0	0
6:32325478:G:C	0	0	0	0	0	0	0	0
6:32325657:A:C	1	0	5	5	0	5	5	0
6:32325793:G:A	1	0	3	3	0	3	3	0
6:32325801:C:G	1	0	3	3	0	3	3	0
6:32325821:A:T	1	0	2	2	0	2	2	0
6:32325894:G:A	0	0	0	0	0	0	0	0
6:32326164:G:C	2	2	2	0	2	1.0	0.0	1.0
6:32330595:A:G	1	1	3	0	3	3	0	3
6:32332045:G:A	1	0	1	1	0	1	1	0
6:32335915:T:A	1	0	3	3	0	3	3	0
6:32394044:C:T	0	0	0	0	0	0	0	0
6:32396178:T:C	0	0	0	0	0	0	0	0
6:32403058:T:C	0	0	0	0	0	0	0	0
6:32439932:C:A	1908	1233	3580	1800	1780	1.0	1.0	1.0
6:32443258:A:C	2152	1421	4638	2384	2254	2.0	1.0	1.0
6:32459971:C:T	0	0	0	0	0	0	0	0
6:32460012:T:C	0	0	0	0	0	0	0	0
6:32473499:C:T	2	0	2	2	0	1.0	1.0	0.0
6:32662112:G:A	471	230	622	324	298	1	1	0
6:32662114:C:T	463	264	612	298	314	1	0	1
6:32664910:A:G	2137	2130	5233	66	5167	2	0	2
6:32664917:C:G	2254	2246	5857	70	5787	2.0	0.0	2.0
6:32664947:C:T	2777	2540	11981	3222	8759	3	1	2
6:32664967:C:T	2895	2626	16305	6817	9488	4	2	2
6:32665004:AG:TA	2939	2631	18128	9021	9107	5	2	2
6:32665043:C:G	2925	2516	18027	10070	7957	5	2	2
6:32756481:C:T	0	0	0	0	0	0	0	0
6:32757285:T:A	0	0	0	0	0	0	0	0
6:32761865:G:C	0	0	0	0	0	0	0	0
6:32763481:G:A	0	0	0	0	0	0	0	0
6:32813777:G:A	151	64	332	189	143	1	1	0
6:32814372:G:A	136	69	387	203	184	2.0	1.0	1.0
6:32832447:C:A	43	19	116	70	46	2	1	0
6:32842666:G:A	17	7	46	26	20	1	1	0
6:32849181:G:A	4	2	9	6	3	1.5	0.5	0.5
6:32857313:G:A	3048	2556	12841	6150	6691	3.0	2.0	2.0
6:32974525:G:A	33	21	56	14	42	1	0	1
6:32976317:G:C	77	43	129	67	62	1	0	1
6:32980649:C:T	125	63	172	98	74	1	1	1
6:33007237:T:C	1	0	1	1	0	1	1	0
6:33007480:C:T	127	53	145	83	62	1	1	0
6:33068728:G:C	681	387	962	496	466	1	1	1
6:33069076:A:C	650	313	870	498	372	1.0	1.0	0.0
6:33069174:A:G	821	428	1139	611	528	1	1	1
6:33069182:G:A	868	450	1200	651	549	1.0	1.0	1.0
6:33069194:C:T	907	458	1254	684	570	1	1	1
6:33069222:T:C	1229	632	1839	999	840	1	1	1
6:33069642:G:A	2620	1750	6967	4050	2917	2.0	1.0	1.0
6:33069647:T:C	2739	1967	7898	4376	3522	2	1	1
6:33069745:T:C	3247	3112	34969	19537	15432	9	5	4
6:33069780:CTTG:TTTA	3257	3179	44788	25223	19565	11	6	5
6:33073449:C:T	187	66	529	363	166	2	1	0
6:33080571:G:A	0	0	0	0	0	0	0	0
6:33080577:A:T	0	0	0	0	0	0	0	0
6:33080762:T:A	3250	3176	41472	18130	23342	10.0	4.0	5.0
6:33080884:ATG:GTA	2974	2558	13412	6031	7381	3.0	1.0	2.0
6:33084991:T:C	1683	1063	3635	1956	1679	1	1	1
6:33085026:G:A	1245	730	2538	1450	1088	1	1	1
6:33085173:T:C	720	394	969	480	489	1.0	1.0	1.0
6:33085181:C:T	705	391	946	457	489	1	1	1
6:33085800:G:A	693	442	1051	388	663	1	0	1
6:33103823:C:A	0	0	0	0	0	0	0	0
6:33103977:C:A	0	0	0	0	0	0	0	0
6:33127870:G:C	3	0	4	4	0	1	1	0
6:33127907:A:G	8	6	13	7	6	1.0	0.0	1.0
6:33127960:G:A	7	0	18	18	0	1	1	0
6:33127971:C:G	7	0	20	20	0	1	1	0
6:33128024:C:T	3	0	15	15	0	2	2	0
6:33170900:G:A	0	0	0	0	0	0	0	0
6:33267978:G:A	3	2	3	1	2	1	0	1
6:33286888:A:G	16	9	20	8	12	1.0	0.0	1.0
6:33305078:G:C	61	30	70	34	36	1	1	0
6:33315989:T:C	4	3	4	1	3	1.0	0.0	1.0
6:33339017:T:G	0	0	0	0	0	0	0	0
6:33365669:C:T	0	0	0	0	0	0	0	0
6:33365787:G:A	0	0	0	0	0	0	0	0
6:33366139:G:T	18	0	25	25	0	1.0	1.0	0.0
6:33403927:G:A	0	0	0	0	0	0	0	0
6:33440765:G:A	0	0	0	0	0	0	0	0
6:33440903:G:A	1	0	1	1	0	1	1	0
6:33670403:C:T	5	2	12	5	7	1	1	0
6:33675781:G:A	1	1	4	0	4	4	0	4
6:33691695:C:G	14	7	21	10	11	1.0	0.5	0.5
6:33723019:CA:TG	0	0	0	0	0	0	0	0
6:33735453:G:A	0	0	0	0	0	0	0	0
6:34040229:A:G	0	0	0	0	0	0	0	0
6:34102045:G:A	0	0	0	0	0	0	0	0
6:34102135:G:T	0	0	0	0	0	0	0	0
6:34247444:G:A	6	2	10	8	2	1.0	1.0	0.0
6:35140043:T:A	0	0	0	0	0	0	0	0
6:35286197:C:T	56	20	63	38	25	1.0	1.0	0.0
6:35286430:G:A	0	0	0	0	0	0	0	0
6:35292726:C:T	8	4	8	4	4	1.0	0.5	0.5
6:35292753:C:T	6	3	6	3	3	1.0	0.5	0.5
6:35319978:G:A	32	19	38	16	22	1.0	0.0	1.0
6:35320919:C:T	33	17	34	16	18	1	0	1
6:35424010:C:T	13	8	22	11	11	1	0	1
6:35462909:G:A	3	2	3	1	2	1	0	1
6:35484569:C:T	0	0	0	0	0	0	0	0
6:35509248:C:G	0	0	0	0	0	0	0	0
6:35577165:G:A	2	2	2	0	2	1.0	0.0	1.0
6:35738076:G:A	0	0	0	0	0	0	0	0
6:35738115:T:C	0	0	0	0	0	0	0	0
6:35835415:C:A	2	1	2	1	1	1.0	0.5	0.5
6:36319535:G:C	0	0	0	0	0	0	0	0
6:36673977:A:C	5	3	5	2	3	1	0	1
6:36677919:A:G	1	0	2	2	0	2	2	0
6:36856623:C:T	91	40	104	55	49	1	1	0
6:36954908:A:C	0	0	0	0	0	0	0	0
6:36963386:A:G	8	3	18	7	11	1.5	1.0	0.0
6:37020588:C:T	14	9	15	5	10	1.0	0.0	1.0
6:37021615:G:C	2	1	3	2	1	1.5	1.0	0.5
6:37381290:G:A	7	4	17	11	6	1	0	1
6:37474541:A:G	6	2	13	7	6	1.5	1.0	0.0
6:37481092:C:G	5	4	5	1	4	1	0	1
6:38783112:A:G	0	0	0	0	0	0	0	0
6:38805517:G:A	0	0	0	0	0	0	0	0
6:38832388:G:A	0	0	0	0	0	0	0	0
6:38857553:C:T	2	2	2	0	2	1.0	0.0	1.0
6:38873325:G:A	0	0	0	0	0	0	0	0
6:38875650:C:T	0	0	0	0	0	0	0	0
6:38883893:C:T	0	0	0	0	0	0	0	0
6:38990077:A:G	0	0	0	0	0	0	0	0
6:39048860:C:T	0	0	0	0	0	0	0	0
6:39066296:G:A	0	0	0	0	0	0	0	0
6:39072878:A:C	0	0	0	0	0	0	0	0
6:39073726:A:C	0	0	0	0	0	0	0	0
6:39080715:A:C	0	0	0	0	0	0	0	0
6:39315307:G:A	0	0	0	0	0	0	0	0
6:39316274:G:T	0	0	0	0	0	0	0	0
6:39357302:A:G	0	0	0	0	0	0	0	0
6:39904464:C:G	0	0	0	0	0	0	0	0
6:39905906:G:A	0	0	0	0	0	0	0	0
6:39913358:A:T	0	0	0	0	0	0	0	0
6:39927671:T:C	0	0	0	0	0	0	0	0
6:39958435:C:T	10	10	10	0	10	1.0	0.0	1.0
6:39958503:C:T	62	0	65	65	0	1.0	1.0	0.0
6:40392726:A:G	0	0	0	0	0	0	0	0
6:41030402:G:A	1	1	2	0	2	2	0	2
6:41061603:T:C	2	1	2	1	1	1.0	0.5	0.5
6:41070039:C:T	1	0	3	3	0	3	3	0
6:41071106:C:T	10	3	10	7	3	1.0	1.0	0.0
6:41565841:C:A	8	2	10	8	2	1.0	1.0	0.0
6:41578069:C:T	0	0	0	0	0	0	0	0
6:41653533:G:A	0	0	0	0	0	0	0	0
6:42106021:G:A	0	0	0	0	0	0	0	0
6:42194650:A:G	0	0	0	0	0	0	0	0
6:42217826:A:C	37	17	44	25	19	1	1	0
6:42256808:A:T	1	1	1	0	1	1	0	1
6:42264737:G:A	0	0	0	0	0	0	0	0
6:42564364:C:T	166	88	183	84	99	1.0	0.0	1.0
6:42605775:T:C	8	3	8	5	3	1.0	1.0	0.0
6:42617284:G:A	2	1	4	1	3	2.0	0.5	1.5
6:42659692:CCCCG:TCCCA	26	13	45	19	26	1.0	0.5	0.5
6:42698282:G:A	0	0	0	0	0	0	0	0
6:42698323:T:C	0	0	0	0	0	0	0	0
6:42698407:C:T	0	0	0	0	0	0	0	0
6:42698426:G:C	0	0	0	0	0	0	0	0
6:42884619:C:T	414	231	478	216	262	1.0	0.0	1.0
6:42923284:G:A	7	2	9	6	3	1	1	0
6:42925383:G:A	0	0	0	0	0	0	0	0
6:42938646:G:T	88	46	124	72	52	1.0	0.0	1.0
6:42956455:C:T	492	0	551	551	0	1.0	1.0	0.0
6:42956509:G:A	551	0	630	630	0	1	1	0
6:42956546:C:T	657	1	763	762	1	1	1	0
6:42956686:G:T	50	0	51	51	0	1.0	1.0	0.0
6:43142013:G:A	0	0	0	0	0	0	0	0
6:43503743:C:G	0	0	0	0	0	0	0	0
6:43513383:C:T	8	2	8	6	2	1.0	1.0	0.0
6:43521098:C:T	1	0	1	1	0	1	1	0
6:43521156:G:T	3	1	3	2	1	1	1	0
6:43533926:C:T	2	1	8	3	5	4.0	1.5	2.5
6:43620254:G:A	3	3	9	0	9	3	0	3
6:43621460:A:G	3	1	3	2	1	1	1	0
6:43670899:G:A	0	0	0	0	0	0	0	0
6:43672362:A:G	0	0	0	0	0	0	0	0
6:43672431:G:A	0	0	0	0	0	0	0	0
6:44001077:A:G	0	0	0	0	0	0	0	0
6:44180084:A:G	1	0	1	1	0	1	1	0
6:44183753:G:A	0	0	0	0	0	0	0	0
6:44255273:G:T	5	3	5	2	3	1	0	1
6:44282428:A:G	0	0	0	0	0	0	0	0
6:44286028:A:G	0	0	0	0	0	0	0	0
6:44287722:G:A	0	0	0	0	0	0	0	0
6:44301456:C:T	4	2	12	2	10	1.5	0.5	1.0
6:44343117:G:A	0	0	0	0	0	0	0	0
6:44352811:T:A	0	0	0	0	0	0	0	0
6:44403977:C:T	21	7	29	20	9	1	1	0
6:44445726:T:A	14	11	17	3	14	1.0	0.0	1.0
6:46079903:T:C	0	0	0	0	0	0	0	0
6:46167546:A:G	0	0	0	0	0	0	0	0
6:46642168:C:T	0	0	0	0	0	0	0	0
6:46655961:T:C	0	0	0	0	0	0	0	0
6:46689320:A:G	0	0	0	0	0	0	0	0
6:46705206:A:G	0	0	0	0	0	0	0	0
6:46825438:G:A	0	0	0	0	0	0	0	0
6:46833334:G:T	0	0	0	0	0	0	0	0
6:46833355:A:G	0	0	0	0	0	0	0	0
6:46834633:G:A	0	0	0	0	0	0	0	0
6:46858978:T:A	0	0	0	0	0	0	0	0
6:46859107:T:C	0	0	0	0	0	0	0	0
6:46859173:G:A	0	0	0	0	0	0	0	0
6:46859336:A:G	0	0	0	0	0	0	0	0
6:46859389:C:T	0	0	0	0	0	0	0	0
6:46866948:G:A	0	0	0	0	0	0	0	0
6:47010050:C:G	0	0	0	0	0	0	0	0
6:49457808:C:T	3	0	3	3	0	1	1	0
6:49512037:T:C	0	0	0	0	0	0	0	0
6:49512062:A:T	0	0	0	0	0	0	0	0
6:49521684:C:A	0	0	0	0	0	0	0	0
6:49526528:A:G	0	0	0	0	0	0	0	0
6:49728760:G:T	0	0	0	0	0	0	0	0
6:49733726:C:A	0	0	0	0	0	0	0	0
6:50715296:T:C	0	0	0	0	0	0	0	0
6:50818858:G:A	0	0	0	0	0	0	0	0
6:50912766:C:T	0	0	0	0	0	0	0	0
6:50913130:G:A	0	0	0	0	0	0	0	0
6:51410244:T:C	3	0	3	3	0	1	1	0
6:51632705:C:A	0	0	0	0	0	0	0	0
6:51856040:T:C	0	0	0	0	0	0	0	0
6:51868009:C:T	0	0	0	0	0	0	0	0
6:52026025:G:A	0	0	0	0	0	0	0	0
6:52050158:G:A	0	0	0	0	0	0	0	0
6:52055687:G:A	0	0	0	0	0	0	0	0
6:52082439:G:A	0	0	0	0	0	0	0	0
6:52438493:C:T	6	1	6	5	1	1.0	1.0	0.0
6:52492273:A:C	4	3	4	1	3	1.0	0.0	1.0
6:52493222:A:T	0	0	0	0	0	0	0	0
6:52493831:C:A	1	1	1	0	1	1	0	1
6:52495313:C:G	0	0	0	0	0	0	0	0
6:52832944:C:G	0	0	0	0	0	0	0	0
6:53294292:G:T	178	83	183	100	83	1.0	1.0	0.0
6:53500576:C:T	0	0	0	0	0	0	0	0
6:54485250:G:A	0	0	0	0	0	0	0	0
6:54485624:G:A	0	0	0	0	0	0	0	0
6:54870324:A:G	0	0	0	0	0	0	0	0
6:54940000:T:C	0	0	0	0	0	0	0	0
6:55331789:C:T	0	0	0	0	0	0	0	0
6:55563852:T:C	0	0	0	0	0	0	0	0
6:55563860:A:C	0	0	0	0	0	0	0	0
6:55874755:A:G	0	0	0	0	0	0	0	0
6:56179780:T:C	0	0	0	0	0	0	0	0
6:56432639:G:A	0	0	0	0	0	0	0	0
6:56432770:G:A	0	0	0	0	0	0	0	0
6:56433098:C:T	0	0	0	0	0	0	0	0
6:56552484:C:T	0	0	0	0	0	0	0	0
6:56552747:T:C	0	0	0	0	0	0	0	0
6:56598612:T:C	0	0	0	0	0	0	0	0
6:56604521:G:T	0	0	0	0	0	0	0	0
6:56605753:T:A	0	0	0	0	0	0	0	0
6:56605892:G:A	0	0	0	0	0	0	0	0
6:56606305:C:T	0	0	0	0	0	0	0	0
6:56606604:G:A	0	0	0	0	0	0	0	0
6:56607197:C:T	0	0	0	0	0	0	0	0
6:56618003:C:G	0	0	0	0	0	0	0	0
6:56619960:C:T	0	0	0	0	0	0	0	0
6:57919865:G:A	3	2	5	1	4	1	0	1
6:57937593:T:C	0	0	0	0	0	0	0	0
6:57937654:G:A	0	0	0	0	0	0	0	0
6:57937674:A:G	0	0	0	0	0	0	0	0
6:60425399:A:T	0	0	0	0	0	0	0	0
6:61681011:T:C	7	2	18	13	5	2	2	0
6:61732699:A:G	4	1	7	6	1	1.0	1.0	0.0
6:63229890:T:C	0	0	0	0	0	0	0	0
6:63984461:C:T	0	0	0	0	0	0	0	0
6:65295964:T:A	0	0	0	0	0	0	0	0
6:65402516:A:G	0	0	0	0	0	0	0	0
6:65495052:G:A	0	0	0	0	0	0	0	0
6:65837285:G:A	0	0	0	0	0	0	0	0
6:65837429:T:G	0	0	0	0	0	0	0	0
6:65837453:C:G	1	0	1	1	0	1	1	0
6:66093642:C:A	0	0	0	0	0	0	0	0
6:67934005:G:A	0	0	0	0	0	0	0	0
6:69361281:G:A	0	0	0	0	0	0	0	0
6:69705583:A:G	6	2	20	18	2	1.5	1.5	0.0
6:70207184:A:C	1	0	4	4	0	4	4	0
6:70253421:A:C	0	0	0	0	0	0	0	0
6:71585126:T:G	0	0	0	0	0	0	0	0
6:72179769:A:G	0	0	0	0	0	0	0	0
6:72258249:G:A	0	0	0	0	0	0	0	0
6:72316775:A:G	0	0	0	0	0	0	0	0
6:73209990:A:G	0	0	0	0	0	0	0	0
6:73210003:T:G	0	0	0	0	0	0	0	0
6:73225412:G:C	0	0	0	0	0	0	0	0
6:73445623:G:T	4	0	5	5	0	1.0	1.0	0.0
6:73638419:T:C	8	5	13	7	6	1.0	0.0	1.0
6:75087586:C:T	0	0	0	0	0	0	0	0
6:75950834:G:C	0	0	0	0	0	0	0	0
6:78885380:A:G	19	8	35	21	14	1	1	0
6:78903083:G:A	0	0	0	0	0	0	0	0
6:78946845:A:T	28	12	59	33	26	1.0	1.0	0.0
6:78947674:G:A	28	13	34	19	15	1.0	1.0	0.0
6:78965984:A:G	15	5	30	20	10	1	1	0
6:78969860:A:G	20	14	27	7	20	1.0	0.0	1.0
6:79326585:A:C	0	0	0	0	0	0	0	0
6:79354598:C:G	0	0	0	0	0	0	0	0
6:79518824:A:G	0	0	0	0	0	0	0	0
6:79518956:T:C	0	0	0	0	0	0	0	0
6:80006121:T:G	0	0	0	0	0	0	0	0
6:80065613:G:A	0	0	0	0	0	0	0	0
6:80065919:A:G	0	0	0	0	0	0	0	0
6:80066021:C:G	0	0	0	0	0	0	0	0
6:80067750:C:T	0	0	0	0	0	0	0	0
6:80067891:G:A	0	0	0	0	0	0	0	0
6:80069136:G:C	0	0	0	0	0	0	0	0
6:80374073:T:C	0	0	0	0	0	0	0	0
6:80374207:T:C	0	0	0	0	0	0	0	0
6:80556995:C:T	0	0	0	0	0	0	0	0
6:83122011:C:T	2	0	3	3	0	1.5	1.5	0.0
6:83239542:T:C	0	0	0	0	0	0	0	0
6:83392831:A:C	0	0	0	0	0	0	0	0
6:84429658:T:C	0	0	0	0	0	0	0	0
6:84430595:C:A	1	0	1	1	0	1	1	0
6:85288029:G:A	0	0	0	0	0	0	0	0
6:85288459:G:A	0	0	0	0	0	0	0	0
6:85489515:A:G	3	2	18	2	16	2	0	2
6:85489525:T:C	3	2	18	2	16	2	0	2
6:86897124:G:A	0	0	0	0	0	0	0	0
6:87121949:T:G	0	0	0	0	0	0	0	0
6:87257918:A:G	5	2	5	3	2	1	1	0
6:87258847:A:G	14	5	14	9	5	1.0	1.0	0.0
6:87260583:C:G	44	27	45	18	27	1.0	0.0	1.0
6:87284297:A:G	0	0	0	0	0	0	0	0
6:87284854:G:A	1	0	1	1	0	1	1	0
6:87337082:G:A	110	64	127	52	75	1.0	0.0	1.0
6:87415824:G:A	0	0	0	0	0	0	0	0
6:87416705:G:C	0	0	0	0	0	0	0	0
6:87529548:T:C	6	3	6	3	3	1.0	0.5	0.5
6:87651299:G:A	0	0	0	0	0	0	0	0
6:88143916:C:T	0	0	0	0	0	0	0	0
6:89059905:T:C	1	1	1	0	1	1	0	1
6:89198154:G:A	0	0	0	0	0	0	0	0
6:89217243:T:C	0	0	0	0	0	0	0	0
6:89217247:T:C	0	0	0	0	0	0	0	0
6:89271694:T:C	0	0	0	0	0	0	0	0
6:89302716:G:A	0	0	0	0	0	0	0	0
6:89302744:C:A	0	0	0	0	0	0	0	0
6:89606070:A:G	1	0	8	8	0	8	8	0
6:89618154:G:A	0	0	0	0	0	0	0	0
6:89630557:G:A	3	1	5	2	3	1	1	0
6:89630727:C:T	5	1	5	4	1	1	1	0
6:89661483:G:A	8	1	19	15	4	1.5	1.0	0.0
6:89662855:A:C	11	5	20	7	13	1	1	0
6:89680724:C:A	7	2	9	5	4	1	1	0
6:89687413:G:C	2	2	2	0	2	1.0	0.0	1.0
6:89698870:A:G	3	3	5	0	5	1	0	1
6:89749735:G:A	1	0	10	10	0	10	10	0
6:89855523:A:G	36	22	42	19	23	1.0	0.0	1.0
6:93092320:G:A	1	0	1	1	0	1	1	0
6:93258133:C:T	0	0	0	0	0	0	0	0
6:93272406:A:G	0	0	0	0	0	0	0	0
6:96537435:T:C	6	3	7	3	4	1.0	0.5	0.5
6:96551849:C:T	6	5	7	1	6	1.0	0.0	1.0
6:96610677:A:G	0	0	0	0	0	0	0	0
6:96610698:G:A	0	0	0	0	0	0	0	0
6:97165287:T:C	0	0	0	0	0	0	0	0
6:97178498:A:G	0	0	0	0	0	0	0	0
6:98179534:C:A	0	0	0	0	0	0	0	0
6:99435818:T:C	0	0	0	0	0	0	0	0
6:99439801:C:T	3	2	4	2	2	1	0	1
6:99446062:T:C	3	2	8	6	2	1	0	1
6:99508684:T:C	136	68	196	96	100	1.0	0.5	0.5
6:99947926:A:G	0	0	0	0	0	0	0	0
6:102068385:G:A	0	0	0	0	0	0	0	0
6:105373574:A:G	4	2	7	5	2	1.0	0.5	0.5
6:106088378:G:A	3	2	5	3	2	1	1	1
6:107705198:A:C	8	4	8	4	4	1.0	0.5	0.5
6:107707887:G:A	2	2	2	0	2	1.0	0.0	1.0
6:107707905:T:C	4	2	4	2	2	1.0	0.5	0.5
6:108004420:C:T	1	0	1	1	0	1	1	0
6:108004845:A:G	4	4	4	0	4	1.0	0.0	1.0
6:108005358:G:C	5	5	5	0	5	1	0	1
6:108786137:T:C	0	0	0	0	0	0	0	0
6:109001351:C:T	12	5	17	7	10	1.0	1.0	0.0
6:109002316:G:T	31	16	48	29	19	1	1	1
6:109159359:T:C	0	0	0	0	0	0	0	0
6:109352852:C:T	0	0	0	0	0	0	0	0
6:109443332:G:T	9	4	13	7	6	1	1	0
6:109446727:GC:TT	15	7	19	11	8	1	1	0
6:109447092:G:A	18	5	27	20	7	1.0	1.0	0.0
6:109481881:C:T	510	265	636	320	316	1.0	1.0	1.0
6:109506513:C:T	2	0	2	2	0	1.0	1.0	0.0
6:109825100:G:A	32	9	38	25	13	1.0	1.0	0.0
6:110425059:C:T	0	0	0	0	0	0	0	0
6:110858415:T:C	2	1	2	1	1	1.0	0.5	0.5
6:110923760:A:G	0	0	0	0	0	0	0	0
6:110923871:T:C	0	0	0	0	0	0	0	0
6:111266063:T:C	1	1	4	0	4	4	0	4
6:111374065:C:T	4	3	4	1	3	1.0	0.0	1.0
6:111374684:G:A	16	8	16	8	8	1.0	0.5	0.5
6:111375054:G:A	10	5	11	5	6	1.0	0.5	0.5
6:111375649:T:C	4	1	5	3	2	1.0	1.0	0.0
6:111661835:G:C	10	5	11	5	6	1.0	0.5	0.5
6:112061110:G:T	0	0	0	0	0	0	0	0
6:112136181:G:C	0	0	0	0	0	0	0	0
6:112150486:G:C	0	0	0	0	0	0	0	0
6:112172670:A:G	0	0	0	0	0	0	0	0
6:112356173:C:A	0	0	0	0	0	0	0	0
6:112366582:T:C	0	0	0	0	0	0	0	0
6:113581628:T:C	4	0	4	4	0	1.0	1.0	0.0
6:114057806:C:T	0	0	0	0	0	0	0	0
6:114084540:A:G	0	0	0	0	0	0	0	0
6:114084639:A:C	0	0	0	0	0	0	0	0
6:116003979:C:T	2	1	2	1	1	1.0	0.5	0.5
6:116038978:T:C	0	0	0	0	0	0	0	0
6:116125413:A:G	0	0	0	0	0	0	0	0
6:116253292:G:A	11	6	20	11	9	1	0	1
6:116253920:C:A	89	42	122	66	56	1	1	0
6:116278502:T:C	10	4	15	11	4	1.0	1.0	0.0
6:116279611:C:G	316	174	374	185	189	1.0	1.0	1.0
6:116399324:C:T	84	27	115	82	33	1.0	1.0	0.0
6:116554264:G:A	0	0	0	0	0	0	0	0
6:116629571:G:A	1	1	1	0	1	1	0	1
6:116629670:T:C	1	1	2	0	2	2	0	2
6:116652019:T:C	4	1	7	4	3	1.5	1.0	0.0
6:116765215:C:A	0	0	0	0	0	0	0	0
6:116792490:T:C	0	0	0	0	0	0	0	0
6:116792862:G:A	0	0	0	0	0	0	0	0
6:116793060:T:A	0	0	0	0	0	0	0	0
6:116793127:A:G	0	0	0	0	0	0	0	0
6:116809381:A:C	0	0	0	0	0	0	0	0
6:116922097:T:C	0	0	0	0	0	0	0	0
6:116923211:T:C	0	0	0	0	0	0	0	0
6:116925556:C:T	0	0	0	0	0	0	0	0
6:116927055:T:C	0	0	0	0	0	0	0	0
6:116931509:C:A	0	0	0	0	0	0	0	0
6:117999202:A:G	1656	0	2691	2691	0	1.0	1.0	0.0
6:118566140:T:C	6	1	6	5	1	1.0	1.0	0.0
6:118815848:G:A	29	11	69	35	34	2	1	0
6:119189776:C:A	4	2	6	3	3	1.5	0.5	0.5
6:119348712:C:T	3	1	9	7	2	2	1	0
6:121170476:A:G	1	1	2	0	2	2	0	2
6:121256224:T:C	2	2	6	0	6	3.0	0.0	3.0
6:121308021:G:A	3	2	11	5	6	5	0	1
6:121680161:G:A	0	0	0	0	0	0	0	0
6:121680239:C:G	0	0	0	0	0	0	0	0
6:122859937:C:T	5	0	5	5	0	1	1	0
6:123366143:A:C	0	0	0	0	0	0	0	0
6:125889249:T:G	2	2	3	0	3	1.5	0.0	1.5
6:125957084:G:C	67	31	89	46	43	1	1	0
6:127155371:G:A	0	0	0	0	0	0	0	0
6:127453901:A:G	0	0	0	0	0	0	0	0
6:127514901:G:A	0	0	0	0	0	0	0	0
6:128082600:A:G	0	0	0	0	0	0	0	0
6:129049961:C:T	0	0	0	0	0	0	0	0
6:129401244:A:G	0	0	0	0	0	0	0	0
6:129401280:G:A	0	0	0	0	0	0	0	0
6:129833522:T:C	1	0	2	2	0	2	2	0
6:129833541:A:G	1	0	2	2	0	2	2	0
6:130052957:C:A	17	9	45	24	21	2	0	1
6:130060101:T:C	7	2	8	6	2	1	1	0
6:132538470:A:T	0	0	0	0	0	0	0	0
6:132608765:C:T	0	0	0	0	0	0	0	0
6:132608772:A:G	0	0	0	0	0	0	0	0
6:132609019:T:C	0	0	0	0	0	0	0	0
6:132713959:G:A	0	0	0	0	0	0	0	0
6:132724673:G:A	0	0	0	0	0	0	0	0
6:132724763:A:G	0	0	0	0	0	0	0	0
6:132731477:C:T	0	0	0	0	0	0	0	0
6:132753506:A:G	1	0	2	2	0	2	2	0
6:132753524:T:C	1	0	2	2	0	2	2	0
6:132755924:T:C	82	28	110	69	41	1.0	1.0	0.0
6:132797077:A:G	170	79	197	99	98	1.0	1.0	0.0
6:132814747:A:G	3094	2613	14010	7224	6786	4.0	2.0	2.0
6:132816871:T:C	10	6	36	14	22	2.5	0.0	2.0
6:134297407:C:T	0	0	0	0	0	0	0	0
6:134898077:G:A	0	0	0	0	0	0	0	0
6:135318506:C:T	0	0	0	0	0	0	0	0
6:136038308:A:C	0	0	0	0	0	0	0	0
6:136268287:G:T	82	1	87	86	1	1.0	1.0	0.0
6:136822571:T:C	4	2	13	11	2	1.5	1.0	0.5
6:137002076:G:A	0	0	0	0	0	0	0	0
6:137219198:C:T	31	13	96	51	45	3	1	0
6:137219233:A:G	25	9	80	47	33	3	1	0
6:137219383:A:G	8	4	21	8	13	1.0	1.0	0.5
6:137705978:C:A	0	0	0	0	0	0	0	0
6:138433186:A:G	0	0	0	0	0	0	0	0
6:138696520:T:C	0	0	0	0	0	0	0	0
6:142133993:C:T	0	0	0	0	0	0	0	0
6:142753563:T:C	3	1	3	2	1	1	1	0
6:142769597:T:C	1	0	1	1	0	1	1	0
6:142770632:G:A	9	4	11	6	5	1	1	0
6:143485139:A:G	2	2	2	0	2	1.0	0.0	1.0
6:143495722:C:T	14	6	16	10	6	1.0	1.0	0.0
6:143501975:G:A	6	5	6	1	5	1.0	0.0	1.0
6:143502020:T:C	6	3	8	5	3	1.0	0.5	0.5
6:143760472:C:T	0	0	0	0	0	0	0	0
6:143823715:G:A	5	5	9	0	9	2	0	2
6:144437663:A:G	19	11	31	8	23	1	0	1
6:144531065:G:A	11	6	12	5	7	1	0	1
6:146785705:A:G	0	0	0	0	0	0	0	0
6:147314277:A:G	0	0	0	0	0	0	0	0
6:147359223:A:G	0	0	0	0	0	0	0	0
6:148519875:C:T	0	0	0	0	0	0	0	0
6:149492002:G:C	2	0	2	2	0	1.0	1.0	0.0
6:149632845:C:T	10	3	14	11	3	1.0	1.0	0.0
6:149662080:G:A	21	6	73	55	18	3	2	0
6:149683643:A:G	11	8	14	4	10	1	0	1
6:149746539:A:G	0	0	0	0	0	0	0	0
6:149793609:G:A	29	12	31	19	12	1	1	0
6:149880043:A:G	0	0	0	0	0	0	0	0
6:149888581:C:G	0	0	0	0	0	0	0	0
6:149889545:GTGGC:ATGGT	0	0	0	0	0	0	0	0
6:149890867:C:T	0	0	0	0	0	0	0	0
6:149918194:C:T	0	0	0	0	0	0	0	0
6:149919693:G:C	0	0	0	0	0	0	0	0
6:149942050:A:C	0	0	0	0	0	0	0	0
6:150395560:T:C	0	0	0	0	0	0	0	0
6:150800779:G:A	18	10	29	11	18	1.0	0.0	1.0
6:151041806:T:C	0	0	0	0	0	0	0	0
6:151349037:A:C	0	0	0	0	0	0	0	0
6:151349762:T:C	0	0	0	0	0	0	0	0
6:151353191:A:C	0	0	0	0	0	0	0	0
6:151365770:C:T	6	5	10	1	9	1.5	0.0	1.5
6:151445417:G:A	7	4	7	3	4	1	0	1
6:151468777:C:T	4	1	4	3	1	1.0	1.0	0.0
6:151573370:T:C	0	0	0	0	0	0	0	0
6:151618046:G:A	0	0	0	0	0	0	0	0
6:151944387:G:C	0	0	0	0	0	0	0	0
6:152143704:A:G	4	1	8	7	1	1.5	1.5	0.0
6:152168159:T:C	0	0	0	0	0	0	0	0
6:152294013:C:T	53	29	56	26	30	1	0	1
6:152337007:T:C	0	0	0	0	0	0	0	0
6:152344126:C:A	0	0	0	0	0	0	0	0
6:152354719:A:G	0	0	0	0	0	0	0	0
6:152362278:G:T	0	0	0	0	0	0	0	0
6:152367432:C:T	0	0	0	0	0	0	0	0
6:152369424:G:A	0	0	0	0	0	0	0	0
6:152373049:T:C	0	0	0	0	0	0	0	0
6:152756197:C:T	0	0	0	0	0	0	0	0
6:153938894:G:A	0	0	0	0	0	0	0	0
6:154093428:A:G	0	0	0	0	0	0	0	0
6:154093438:C:T	0	0	0	0	0	0	0	0
6:154094299:G:T	0	0	0	0	0	0	0	0
6:154094300:C:T	0	0	0	0	0	0	0	0
6:154107567:A:G	0	0	0	0	0	0	0	0
6:154442267:G:A	0	0	0	0	0	0	0	0
6:155130218:G:A	0	0	0	0	0	0	0	0
6:155276013:C:T	1	1	2	0	2	2	0	2
6:155285191:C:T	8	5	21	6	15	3.0	0.0	2.0
6:155453474:C:T	0	0	0	0	0	0	0	0
6:157542711:G:A	2	1	8	7	1	4.0	3.5	0.5
6:158066538:C:T	0	0	0	0	0	0	0	0
6:158084056:A:G	1	0	1	1	0	1	1	0
6:158088718:A:G	2	1	8	3	5	4.0	1.5	2.5
6:158481311:C:T	0	0	0	0	0	0	0	0
6:158760708:C:T	10	5	23	7	16	2.0	0.5	0.5
6:159246929:T:G	0	0	0	0	0	0	0	0
6:159692840:A:G	489	260	1200	598	602	2	1	1
6:159727316:C:T	490	252	843	415	428	1.0	1.0	1.0
6:159761585:C:T	9	3	12	9	3	1	1	0
6:159775311:A:G	4	1	4	3	1	1.0	1.0	0.0
6:159777327:C:T	11	8	16	3	13	1	0	1
6:159785599:T:C	3	1	10	8	2	3	3	0
6:159785684:T:C	0	0	0	0	0	0	0	0
6:159790665:CAGC:TAGG	20	11	46	19	27	2.0	0.0	1.0
6:159803980:T:G	0	0	0	0	0	0	0	0
6:160243648:G:A	0	0	0	0	0	0	0	0
6:160348779:C:T	0	0	0	0	0	0	0	0
6:160586464:G:C	0	0	0	0	0	0	0	0
6:160586506:G:C	0	0	0	0	0	0	0	0
6:161144126:T:C	0	0	0	0	0	0	0	0
6:161161503:T:C	0	0	0	0	0	0	0	0
6:162568794:G:A	0	0	0	0	0	0	0	0
6:162569414:A:G	0	0	0	0	0	0	0	0
6:162569563:T:C	0	0	0	0	0	0	0	0
6:165299453:G:C	0	0	0	0	0	0	0	0
6:166165782:C:T	0	0	0	0	0	0	0	0
6:166166700:G:A	0	0	0	0	0	0	0	0
6:166326101:A:C	2	2	2	0	2	1.0	0.0	1.0
6:166335134:A:C	0	0	0	0	0	0	0	0
6:166342487:TGTTA:CGTTC	232	94	303	189	114	1.0	1.0	0.0
6:166412816:T:C	1	1	1	0	1	1	0	1
6:166448745:T:C	0	0	0	0	0	0	0	0
6:166938818:C:A	1	0	1	1	0	1	1	0
6:167000051:T:C	1	1	2	0	2	2	0	2
6:167296214:G:A	0	0	0	0	0	0	0	0
6:167305948:G:A	0	0	0	0	0	0	0	0
6:167384381:C:G	0	0	0	0	0	0	0	0
6:167915298:G:C	0	0	0	0	0	0	0	0
6:167917136:A:C	1	1	1	0	1	1	0	1
6:168288679:A:G	0	0	0	0	0	0	0	0
6:169217794:G:A	0	0	0	0	0	0	0	0
6:169241876:C:T	0	0	0	0	0	0	0	0
6:169248672:G:A	0	0	0	0	0	0	0	0
6:170553212:G:C	451	220	533	296	237	1	1	0
6:170569705:T:C	8	1	38	35	3	4.5	4.5	0.0
6:170578605:G:C	5	1	5	4	1	1	1	0
7:35489:G:A	0	0	0	0	0	0	0	0
7:498554:C:T	0	0	0	0	0	0	0	0
7:501104:G:A	0	0	0	0	0	0	0	0
7:741362:C:A	3	0	4	4	0	1	1	0
7:842031:C:T	19	9	20	11	9	1	1	0
7:900544:C:T	1	1	5	0	5	5	0	5
7:986689:C:T	0	0	0	0	0	0	0	0
7:1548634:G:A	0	0	0	0	0	0	0	0
7:1693546:C:T	0	0	0	0	0	0	0	0
7:1693556:C:T	0	0	0	0	0	0	0	0
7:1838741:A:G	2	1	13	4	9	6.5	2.0	4.5
7:2475979:G:A	0	0	0	0	0	0	0	0
7:2572244:T:C	6	4	6	2	4	1.0	0.0	1.0
7:2597055:C:T	0	0	0	0	0	0	0	0
7:2814376:G:A	0	0	0	0	0	0	0	0
7:2906827:T:C	59	28	71	37	34	1	1	0
7:3158234:T:C	0	0	0	0	0	0	0	0
7:4132374:C:T	0	0	0	0	0	0	0	0
7:4174245:T:C	0	0	0	0	0	0	0	0
7:4174308:T:C	0	0	0	0	0	0	0	0
7:4174343:A:G	0	0	0	0	0	0	0	0
7:4762404:A:G	1	0	1	1	0	1	1	0
7:4911222:G:C	0	0	0	0	0	0	0	0
7:5057327:T:C	6	3	9	4	5	1.0	0.5	0.5
7:5126869:A:G	0	0	0	0	0	0	0	0
7:5388021:G:A	0	0	0	0	0	0	0	0
7:5489252:G:A	0	0	0	0	0	0	0	0
7:5528735:A:G	26	14	29	14	15	1.0	0.0	1.0
7:5529696:G:A	70	28	72	43	29	1.0	1.0	0.0
7:5840761:G:C	19	10	40	11	29	1	0	1
7:6551377:C:T	0	0	0	0	0	0	0	0
7:6621625:C:G	8	4	8	4	4	1.0	0.5	0.5
7:6674305:C:T	0	0	0	0	0	0	0	0
7:6674354:A:G	0	0	0	0	0	0	0	0
7:6674397:G:A	0	0	0	0	0	0	0	0
7:6737325:A:G	1	1	2	0	2	2	0	2
7:6737738:T:C	4	1	24	9	15	4.0	1.5	0.0
7:6804943:C:G	22	8	25	16	9	1.0	1.0	0.0
7:6859662:A:G	0	0	0	0	0	0	0	0
7:6926937:A:T	0	0	0	0	0	0	0	0
7:6937920:C:T	0	0	0	0	0	0	0	0
7:6937926:G:A	0	0	0	0	0	0	0	0
7:6937947:C:T	0	0	0	0	0	0	0	0
7:7079282:G:A	0	0	0	0	0	0	0	0
7:7456104:T:C	0	0	0	0	0	0	0	0
7:7474604:C:G	0	0	0	0	0	0	0	0
7:7742256:G:A	0	0	0	0	0	0	0	0
7:8086334:C:T	14	11	22	3	19	1.0	0.0	1.0
7:9726520:G:A	0	0	0	0	0	0	0	0
7:9727882:C:A	0	0	0	0	0	0	0	0
7:9728030:C:A	0	0	0	0	0	0	0	0
7:9728096:G:T	0	0	0	0	0	0	0	0
7:9728182:T:G	0	0	0	0	0	0	0	0
7:10451479:A:G	8	0	8	8	0	1.0	1.0	0.0
7:10452541:A:G	0	0	0	0	0	0	0	0
7:10982937:G:A	28	13	28	15	13	1.0	1.0	0.0
7:11469911:T:C	0	0	0	0	0	0	0	0
7:11469934:G:C	0	0	0	0	0	0	0	0
7:11481915:T:C	0	0	0	0	0	0	0	0
7:12229791:C:G	9	6	19	5	14	1	0	1
7:12685841:C:A	0	0	0	0	0	0	0	0
7:13986141:T:A	0	0	0	0	0	0	0	0
7:14718648:C:T	0	0	0	0	0	0	0	0
7:16462765:T:C	0	0	0	0	0	0	0	0
7:16527020:C:G	0	0	0	0	0	0	0	0
7:16532692:T:A	0	0	0	0	0	0	0	0
7:16585992:A:C	0	0	0	0	0	0	0	0
7:16864444:T:C	0	0	0	0	0	0	0	0
7:16864813:T:C	0	0	0	0	0	0	0	0
7:16865727:G:A	0	0	0	0	0	0	0	0
7:18647919:A:T	10	7	15	7	8	1.0	0.0	1.0
7:20658647:A:G	0	0	0	0	0	0	0	0
7:20723023:G:T	0	0	0	0	0	0	0	0
7:20728390:G:A	0	0	0	0	0	0	0	0
7:20786833:T:G	0	0	0	0	0	0	0	0
7:21220752:G:A	0	0	0	0	0	0	0	0
7:21221332:C:T	0	0	0	0	0	0	0	0
7:21221372:A:G	0	0	0	0	0	0	0	0
7:21884396:A:G	0	0	0	0	0	0	0	0
7:22438588:G:T	1	1	1	0	1	1	0	1
7:22492641:A:G	9	2	25	22	3	2	1	0
7:22882139:A:G	0	0	0	0	0	0	0	0
7:23125082:C:T	2	1	2	1	1	1.0	0.5	0.5
7:23256914:G:A	0	0	0	0	0	0	0	0
7:23317702:C:T	2	2	4	0	4	2.0	0.0	2.0
7:23680147:G:A	1	1	3	0	3	3	0	3
7:23680160:G:A	2	1	4	1	3	2.0	0.5	1.5
7:23710213:G:T	0	0	0	0	0	0	0	0
7:23712117:A:G	0	0	0	0	0	0	0	0
7:23717543:G:C	0	0	0	0	0	0	0	0
7:23721623:G:A	0	0	0	0	0	0	0	0
7:24285390:G:A	0	0	0	0	0	0	0	0
7:24289514:C:T	0	0	0	0	0	0	0	0
7:25142293:T:C	12	7	22	10	12	2.0	0.0	1.0
7:25155046:G:C	3	1	3	2	1	1	1	0
7:25226781:G:A	0	0	0	0	0	0	0	0
7:26538486:A:G	0	0	0	0	0	0	0	0
7:27182790:G:A	0	0	0	0	0	0	0	0
7:27787484:T:A	44	17	46	28	18	1.0	1.0	0.0
7:27913416:A:G	0	0	0	0	0	0	0	0
7:28279615:A:C	0	0	0	0	0	0	0	0
7:28957328:T:C	0	0	0	0	0	0	0	0
7:29030704:C:T	0	0	0	0	0	0	0	0
7:29212547:A:G	0	0	0	0	0	0	0	0
7:29212942:G:C	0	0	0	0	0	0	0	0
7:29213076:T:G	0	0	0	0	0	0	0	0
7:29213108:A:T	0	0	0	0	0	0	0	0
7:29685453:C:T	0	0	0	0	0	0	0	0
7:29718048:G:A	0	0	0	0	0	0	0	0
7:29731985:G:A	0	0	0	0	0	0	0	0
7:30137662:C:T	0	0	0	0	0	0	0	0
7:30523336:C:G	3	2	14	8	6	3	0	3
7:30752232:G:A	0	0	0	0	0	0	0	0
7:30791466:C:T	0	0	0	0	0	0	0	0
7:30840797:G:A	0	0	0	0	0	0	0	0
7:30922175:G:A	0	0	0	0	0	0	0	0
7:31809092:A:G	0	0	0	0	0	0	0	0
7:31815955:G:A	0	0	0	0	0	0	0	0
7:31823142:T:C	0	0	0	0	0	0	0	0
7:32298725:G:A	0	0	0	0	0	0	0	0
7:33970334:C:T	0	0	0	0	0	0	0	0
7:34085808:G:T	0	0	0	0	0	0	0	0
7:34750392:C:T	0	0	0	0	0	0	0	0
7:34750737:G:A	0	0	0	0	0	0	0	0
7:34751230:G:C	0	0	0	0	0	0	0	0
7:34751340:T:C	0	0	0	0	0	0	0	0
7:34751589:G:A	0	0	0	0	0	0	0	0
7:34778501:A:T	0	0	0	0	0	0	0	0
7:34827570:C:T	0	0	0	0	0	0	0	0
7:35141055:G:T	0	0	0	0	0	0	0	0
7:35164938:G:A	0	0	0	0	0	0	0	0
7:35248765:C:T	0	0	0	0	0	0	0	0
7:36084682:G:A	0	0	0	0	0	0	0	0
7:36287708:C:T	0	0	0	0	0	0	0	0
7:36415868:T:C	0	0	0	0	0	0	0	0
7:36452603:C:T	0	0	0	0	0	0	0	0
7:36724067:C:T	55	39	105	38	67	1	0	1
7:36724083:C:T	56	18	107	69	38	1.0	1.0	0.0
7:37741024:C:T	0	0	0	0	0	0	0	0
7:37867702:T:C	0	0	0	0	0	0	0	0
7:37876853:A:G	0	0	0	0	0	0	0	0
7:37894544:TA:CT	0	0	0	0	0	0	0	0
7:37896928:T:C	0	0	0	0	0	0	0	0
7:37948987:C:T	0	0	0	0	0	0	0	0
7:38317237:G:T	0	0	0	0	0	0	0	0
7:38317474:T:C	0	0	0	0	0	0	0	0
7:38391829:A:G	0	0	0	0	0	0	0	0
7:38394126:T:G	0	0	0	0	0	0	0	0
7:38428242:A:G	0	0	0	0	0	0	0	0
7:38428863:C:T	0	0	0	0	0	0	0	0
7:38765615:C:T	12	3	16	11	5	1.0	1.0	0.0
7:39792137:T:C	1	0	1	1	0	1	1	0
7:40274566:G:A	0	0	0	0	0	0	0	0
7:40860368:G:C	0	0	0	0	0	0	0	0
7:41964300:C:A	0	0	0	0	0	0	0	0
7:41965002:G:A	0	0	0	0	0	0	0	0
7:41965053:G:A	0	0	0	0	0	0	0	0
7:41965066:C:T	0	0	0	0	0	0	0	0
7:41966247:C:G	0	0	0	0	0	0	0	0
7:41978737:G:A	0	0	0	0	0	0	0	0
7:42040166:G:A	0	0	0	0	0	0	0	0
7:42048623:T:C	0	0	0	0	0	0	0	0
7:42048633:G:A	0	0	0	0	0	0	0	0
7:42795907:A:G	0	0	0	0	0	0	0	0
7:43444382:G:C	0	0	0	0	0	0	0	0
7:43466559:T:C	0	0	0	0	0	0	0	0
7:43501288:A:C	0	0	0	0	0	0	0	0
7:43552233:G:A	0	0	0	0	0	0	0	0
7:43608280:C:T	54	26	74	38	36	1.0	1.0	0.0
7:43624599:A:G	27	14	29	15	14	1	0	1
7:43646595:G:A	0	0	0	0	0	0	0	0
7:43646625:C:T	0	0	0	0	0	0	0	0
7:43807004:A:G	2	1	2	1	1	1.0	0.5	0.5
7:43919894:G:A	2	2	7	0	7	3.5	0.0	3.5
7:43965929:C:T	2	1	12	8	4	6.0	4.0	2.0
7:43987723:G:A	1	0	5	5	0	5	5	0
7:43987749:A:G	1	0	8	8	0	8	8	0
7:44000025:C:T	3	2	10	2	8	2	0	1
7:44060065:T:C	39	13	46	32	14	1	1	0
7:44073274:G:T	19	7	22	13	9	1	1	0
7:44108954:A:G	18	10	20	10	10	1.0	0.0	1.0
7:44112667:C:T	13	6	13	7	6	1	1	0
7:44140445:T:A	0	0	0	0	0	0	0	0
7:44243278:A:G	0	0	0	0	0	0	0	0
7:44760577:G:T	7	5	9	3	6	1	0	1
7:45814655:T:C	2	1	3	2	1	1.5	1.0	0.5
7:45814732:G:A	1	1	1	0	1	1	0	1
7:45999922:G:C	0	0	0	0	0	0	0	0
7:47280125:C:T	1	0	1	1	0	1	1	0
7:47368846:C:G	3	3	4	0	4	1	0	1
7:47396900:G:A	8	3	21	16	5	1.5	1.0	0.0
7:47442004:G:A	94	47	181	94	87	1.0	1.0	0.5
7:47659087:A:G	0	0	0	0	0	0	0	0
7:47800789:C:T	1	1	8	0	8	8	0	8
7:47835032:G:A	0	0	0	0	0	0	0	0
7:47877489:C:T	0	0	0	0	0	0	0	0
7:47885733:C:G	0	0	0	0	0	0	0	0
7:47929330:C:A	0	0	0	0	0	0	0	0
7:47931978:A:G	0	0	0	0	0	0	0	0
7:47965365:C:T	6	5	10	1	9	1.0	0.0	1.0
7:48271966:T:G	0	0	0	0	0	0	0	0
7:48273913:A:G	0	0	0	0	0	0	0	0
7:48274682:G:A	0	0	0	0	0	0	0	0
7:48275201:G:T	0	0	0	0	0	0	0	0
7:48275763:A:G	0	0	0	0	0	0	0	0
7:48279214:C:T	0	0	0	0	0	0	0	0
7:48297247:C:T	0	0	0	0	0	0	0	0
7:48403973:G:A	0	0	0	0	0	0	0	0
7:48410560:T:C	0	0	0	0	0	0	0	0
7:48847039:C:G	0	0	0	0	0	0	0	0
7:48847150:C:T	0	0	0	0	0	0	0	0
7:48847187:G:A	0	0	0	0	0	0	0	0
7:48847952:G:C	0	0	0	0	0	0	0	0
7:50058101:A:G	1	1	7	0	7	7	0	7
7:50104342:C:T	0	0	0	0	0	0	0	0
7:50479886:A:C	0	0	0	0	0	0	0	0
7:50674483:C:T	0	0	0	0	0	0	0	0
7:51219773:A:G	0	0	0	0	0	0	0	0
7:51259839:G:A	0	0	0	0	0	0	0	0
7:51388850:G:A	0	0	0	0	0	0	0	0
7:53187753:A:G	0	0	0	0	0	0	0	0
7:53188169:C:T	0	0	0	0	0	0	0	0
7:54759137:G:C	7	4	18	7	11	2	0	1
7:54759235:C:T	10	1	10	9	1	1.0	1.0	0.0
7:54935552:T:A	0	0	0	0	0	0	0	0
7:54935634:T:C	0	0	0	0	0	0	0	0
7:54936356:C:T	0	0	0	0	0	0	0	0
7:54937572:A:G	0	0	0	0	0	0	0	0
7:55170575:G:A	0	0	0	0	0	0	0	0
7:55171181:T:A	0	0	0	0	0	0	0	0
7:55181233:T:C	0	0	0	0	0	0	0	0
7:55638803:T:C	0	0	0	0	0	0	0	0
7:55939883:C:T	0	0	0	0	0	0	0	0
7:55979879:C:T	1	1	1	0	1	1	0	1
7:56175726:G:A	0	0	0	0	0	0	0	0
7:56229369:G:T	0	0	0	0	0	0	0	0
7:56288450:G:T	0	0	0	0	0	0	0	0
7:56290106:A:G	0	0	0	0	0	0	0	0
7:56290742:T:C	0	0	0	0	0	0	0	0
7:56365015:T:C	0	0	0	0	0	0	0	0
7:56365021:C:A	0	0	0	0	0	0	0	0
7:56650617:C:G	0	0	0	0	0	0	0	0
7:56650630:G:A	0	0	0	0	0	0	0	0
7:56809671:C:T	0	0	0	0	0	0	0	0
7:56811895:C:T	0	0	0	0	0	0	0	0
7:56828037:G:A	0	0	0	0	0	0	0	0
7:56828059:C:T	0	0	0	0	0	0	0	0
7:56828334:C:T	0	0	0	0	0	0	0	0
7:56831151:G:A	0	0	0	0	0	0	0	0
7:56832716:G:A	0	0	0	0	0	0	0	0
7:57014342:A:G	0	0	0	0	0	0	0	0
7:57120309:A:G	0	0	0	0	0	0	0	0
7:57121011:T:C	0	0	0	0	0	0	0	0
7:57126056:T:C	0	0	0	0	0	0	0	0
7:57149542:A:G	0	0	0	0	0	0	0	0
7:57200843:C:T	0	0	0	0	0	0	0	0
7:57469291:T:C	0	0	0	0	0	0	0	0
7:57469686:A:C	0	0	0	0	0	0	0	0
7:57770880:C:T	0	0	0	0	0	0	0	0
7:57820182:A:G	0	0	0	0	0	0	0	0
7:57820256:G:C	0	0	0	0	0	0	0	0
7:57820566:T:C	0	0	0	0	0	0	0	0
7:63562512:G:C	0	0	0	0	0	0	0	0
7:63567802:G:C	0	0	0	0	0	0	0	0
7:63893284:C:T	3	3	3	0	3	1	0	1
7:63910319:T:C	0	0	0	0	0	0	0	0
7:63938080:A:C	0	0	0	0	0	0	0	0
7:64015061:C:T	0	0	0	0	0	0	0	0
7:64141624:C:T	0	0	0	0	0	0	0	0
7:64142051:G:A	0	0	0	0	0	0	0	0
7:64220023:C:T	0	0	0	0	0	0	0	0
7:64266267:T:C	0	0	0	0	0	0	0	0
7:64266615:G:A	0	0	0	0	0	0	0	0
7:64434180:A:C	1	0	1	1	0	1	1	0
7:64526451:G:C	0	0	0	0	0	0	0	0
7:64562993:T:C	92	30	168	116	52	1.0	1.0	0.0
7:64569738:C:T	1	0	6	6	0	6	6	0
7:64794523:T:C	221	98	376	217	159	1	1	0
7:64928711:A:C	4	3	14	1	13	1.0	0.0	1.0
7:64950054:A:G	0	0	0	0	0	0	0	0
7:64992360:G:A	1	1	1	0	1	1	0	1
7:64992452:C:T	1	1	1	0	1	1	0	1
7:65840645:C:A	0	0	0	0	0	0	0	0
7:65960907:A:G	18	10	18	8	10	1.0	0.0	1.0
7:65964372:G:A	18	6	20	13	7	1.0	1.0	0.0
7:65974892:G:C	3	1	3	2	1	1	1	0
7:66376994:A:G	5	1	20	18	2	3	3	0
7:66377234:A:G	3	2	8	3	5	3	0	1
7:66423483:T:C	0	0	0	0	0	0	0	0
7:66423583:C:A	10	9	10	1	9	1.0	0.0	1.0
7:66506022:T:G	1	0	4	4	0	4	4	0
7:66511623:G:A	0	0	0	0	0	0	0	0
7:66511647:A:G	0	0	0	0	0	0	0	0
7:66553954:G:A	19	12	38	16	22	1	0	1
7:66573485:G:A	387	186	1603	920	683	4	1	0
7:66824053:C:T	0	0	0	0	0	0	0	0
7:66998951:G:A	45	23	59	32	27	1	0	1
7:70781752:C:G	2	2	2	0	2	1.0	0.0	1.0
7:72829753:A:G	503	284	2800	1288	1512	5	0	1
7:73682908:G:A	7	3	8	5	3	1	1	0
7:73683324:C:T	123	65	128	61	67	1	0	1
7:73708593:A:G	5	4	5	1	4	1	0	1
7:73737314:A:G	2	0	6	6	0	3.0	3.0	0.0
7:73834835:T:A	0	0	0	0	0	0	0	0
7:73834969:G:C	1	1	1	0	1	1	0	1
7:73840482:T:C	3	2	5	1	4	2	0	2
7:73861171:T:C	0	0	0	0	0	0	0	0
7:73861235:T:A	0	0	0	0	0	0	0	0
7:73865690:C:T	0	0	0	0	0	0	0	0
7:74037810:G:A	0	0	0	0	0	0	0	0
7:74249121:G:A	2	0	2	2	0	1.0	1.0	0.0
7:75968227:C:T	0	0	0	0	0	0	0	0
7:76005369:G:A	8	7	10	1	9	1.0	0.0	1.0
7:76362061:A:G	0	0	0	0	0	0	0	0
7:76404488:A:T	0	0	0	0	0	0	0	0
7:76425055:G:A	2	0	4	4	0	2.0	2.0	0.0
7:76482677:C:G	5	2	9	7	2	1	1	0
7:76502378:A:G	15	8	27	12	15	1	0	1
7:76980778:C:T	3	3	10	0	10	3	0	3
7:76980982:A:G	3	0	7	7	0	2	2	0
7:77121935:C:G	73	43	219	81	138	2	0	1
7:77618504:G:A	10	7	15	3	12	1.0	0.0	1.0
7:77627396:A:G	26	11	26	15	11	1.0	1.0	0.0
7:78489792:C:T	0	0	0	0	0	0	0	0
7:81175947:C:T	0	0	0	0	0	0	0	0
7:81964138:G:A	0	0	0	0	0	0	0	0
7:81971792:C:T	0	0	0	0	0	0	0	0
7:82951261:G:T	0	0	0	0	0	0	0	0
7:83155140:A:G	0	0	0	0	0	0	0	0
7:83408415:C:G	0	0	0	0	0	0	0	0
7:83408435:C:A	0	0	0	0	0	0	0	0
7:87182209:T:G	9	6	14	3	11	1	0	1
7:87391707:G:C	3	2	9	1	8	1	0	1
7:87426860:T:C	3	0	3	3	0	1	1	0
7:87450090:T:A	0	0	0	0	0	0	0	0
7:88075684:G:A	0	0	0	0	0	0	0	0
7:88283906:C:T	0	0	0	0	0	0	0	0
7:88284046:C:T	0	0	0	0	0	0	0	0
7:88794801:C:G	0	0	0	0	0	0	0	0
7:89334686:C:T	0	0	0	0	0	0	0	0
7:89334882:T:A	0	0	0	0	0	0	0	0
7:89334912:CC:AG	0	0	0	0	0	0	0	0
7:89335827:A:G	0	0	0	0	0	0	0	0
7:89336295:A:G	0	0	0	0	0	0	0	0
7:90232576:G:T	0	0	0	0	0	0	0	0
7:90282987:G:A	0	0	0	0	0	0	0	0
7:90354494:T:G	67	25	92	61	31	1	1	0
7:90372182:G:C	67	26	98	49	49	1	1	0
7:90385094:G:A	9	7	22	10	12	2	0	1
7:90709536:C:T	43	27	65	23	42	1	0	1
7:93426441:A:G	0	0	0	0	0	0	0	0
7:93486987:A:G	0	0	0	0	0	0	0	0
7:94412625:A:C	0	0	0	0	0	0	0	0
7:94413927:C:G	0	0	0	0	0	0	0	0
7:96110119:T:C	0	0	0	0	0	0	0	0
7:96171508:T:C	3	1	9	8	1	3	3	0
7:97007553:A:C	0	0	0	0	0	0	0	0
7:98192898:G:A	1	1	1	0	1	1	0	1
7:98293539:C:T	0	0	0	0	0	0	0	0
7:98293563:G:A	0	0	0	0	0	0	0	0
7:98304289:C:T	0	0	0	0	0	0	0	0
7:99903276:T:C	12	7	21	9	12	1.0	0.0	1.0
7:99903288:A:G	14	8	22	10	12	1.0	0.0	1.0
7:100467096:A:G	24	11	48	21	27	1.0	1.0	0.0
7:100600763:C:T	1	1	1	0	1	1	0	1
7:100627408:G:A	0	0	0	0	0	0	0	0
7:100753140:T:G	0	0	0	0	0	0	0	0
7:100767944:C:T	0	0	0	0	0	0	0	0
7:100768661:T:C	0	0	0	0	0	0	0	0
7:100861173:T:C	17	6	19	13	6	1	1	0
7:100870662:A:G	1	1	1	0	1	1	0	1
7:100884405:T:C	25	12	43	17	26	1	1	0
7:100889035:T:G	0	0	0	0	0	0	0	0
7:100955225:T:A	0	0	0	0	0	0	0	0
7:100965216:G:C	0	0	0	0	0	0	0	0
7:100965345:C:A	0	0	0	0	0	0	0	0
7:100966916:T:C	0	0	0	0	0	0	0	0
7:100969664:C:T	0	0	0	0	0	0	0	0
7:100991195:C:G	1	0	2	2	0	2	2	0
7:100991359:T:G	0	0	0	0	0	0	0	0
7:100991924:C:T	0	0	0	0	0	0	0	0
7:100992380:T:C	0	0	0	0	0	0	0	0
7:100995606:A:C	0	0	0	0	0	0	0	0
7:101004748:G:A	0	0	0	0	0	0	0	0
7:101034805:T:C	0	0	0	0	0	0	0	0
7:101035089:C:T	0	0	0	0	0	0	0	0
7:101037723:C:T	0	0	0	0	0	0	0	0
7:101232848:A:C	5	4	10	4	6	1	0	1
7:101557447:G:A	0	0	0	0	0	0	0	0
7:102193869:G:A	4	2	15	7	8	3.5	1.0	0.5
7:102201571:A:G	0	0	0	0	0	0	0	0
7:102274250:G:A	1	0	3	3	0	3	3	0
7:102396098:C:G	2	2	2	0	2	1.0	0.0	1.0
7:102457563:G:A	4	2	10	8	2	1.0	0.5	0.5
7:102467816:A:G	3	1	8	7	1	1	1	0
7:102468085:G:A	1	1	1	0	1	1	0	1
7:102474302:C:G	3	2	3	1	2	1	0	1
7:103141663:C:G	178	0	199	199	0	1.0	1.0	0.0
7:103313097:T:C	8	1	8	7	1	1.0	1.0	0.0
7:103515258:A:G	0	0	0	0	0	0	0	0
7:103515417:A:G	0	0	0	0	0	0	0	0
7:103551285:G:A	0	0	0	0	0	0	0	0
7:105204647:T:C	0	0	0	0	0	0	0	0
7:105981066:G:T	0	0	0	0	0	0	0	0
7:107159552:G:A	1	1	1	0	1	1	0	1
7:107185936:C:T	16	10	24	10	14	1.0	0.0	1.0
7:107256792:A:C	7	5	8	2	6	1	0	1
7:107919057:A:C	7	1	16	12	4	1	1	0
7:107975061:C:T	0	0	0	0	0	0	0	0
7:108184445:C:G	0	0	0	0	0	0	0	0
7:108232372:G:A	0	0	0	0	0	0	0	0
7:112462300:T:G	7	5	14	2	12	1	0	1
7:112467944:T:C	4	3	7	1	6	1.0	0.0	1.0
7:112472224:G:A	20	9	47	32	15	1.0	1.0	0.0
7:113451176:A:G	0	0	0	0	0	0	0	0
7:114656490:A:C	0	0	0	0	0	0	0	0
7:114692191:G:T	0	0	0	0	0	0	0	0
7:116257338:G:C	29	14	44	22	22	1	1	0
7:117384766:T:G	0	0	0	0	0	0	0	0
7:117480087:G:C	0	0	0	0	0	0	0	0
7:117559479:G:A	0	0	0	0	0	0	0	0
7:117595001:T:G	0	0	0	0	0	0	0	0
7:118224974:G:A	0	0	0	0	0	0	0	0
7:118880929:C:T	0	0	0	0	0	0	0	0
7:118950986:T:C	0	0	0	0	0	0	0	0
7:121236781:A:G	19	9	28	17	11	1	1	0
7:121261641:G:A	16	6	39	22	17	1.0	1.0	0.0
7:121329715:G:A	179	99	448	203	245	2	0	1
7:121339035:C:T	7	5	9	2	7	1	0	1
7:121976196:G:A	0	0	0	0	0	0	0	0
7:122013344:G:A	0	0	0	0	0	0	0	0
7:122438360:T:G	0	0	0	0	0	0	0	0
7:123169180:T:C	0	0	0	0	0	0	0	0
7:123457414:T:C	0	0	0	0	0	0	0	0
7:123479936:T:C	0	0	0	0	0	0	0	0
7:123624750:C:T	0	0	0	0	0	0	0	0
7:123748678:G:A	37	16	42	26	16	1	1	0
7:124747038:C:G	0	0	0	0	0	0	0	0
7:126439090:A:G	0	0	0	0	0	0	0	0
7:127295745:G:A	0	0	0	0	0	0	0	0
7:127295755:C:G	0	0	0	0	0	0	0	0
7:127611738:G:A	0	0	0	0	0	0	0	0
7:128029804:A:T	0	0	0	0	0	0	0	0
7:128081455:T:C	41	16	55	33	22	1	1	0
7:128313185:G:A	4	3	6	1	5	1.0	0.0	1.0
7:128341151:C:T	0	0	0	0	0	0	0	0
7:128477173:G:A	21	1	24	22	2	1	1	0
7:128724841:A:G	0	0	0	0	0	0	0	0
7:128815862:G:A	0	0	0	0	0	0	0	0
7:128838049:C:T	0	0	0	0	0	0	0	0
7:128844762:A:G	0	0	0	0	0	0	0	0
7:128846309:C:T	0	0	0	0	0	0	0	0
7:128846392:C:T	0	0	0	0	0	0	0	0
7:128851549:T:C	0	0	0	0	0	0	0	0
7:128855284:C:T	0	0	0	0	0	0	0	0
7:128892926:T:C	0	0	0	0	0	0	0	0
7:128904080:G:T	0	0	0	0	0	0	0	0
7:128913981:G:A	0	0	0	0	0	0	0	0
7:128914021:C:T	0	0	0	0	0	0	0	0
7:128955279:G:T	21	10	25	12	13	1	1	0
7:128990173:C:T	3	2	14	4	10	4	0	2
7:129127356:A:G	0	0	0	0	0	0	0	0
7:129127436:T:C	0	0	0	0	0	0	0	0
7:129127452:T:G	0	0	0	0	0	0	0	0
7:130275166:C:T	0	0	0	0	0	0	0	0
7:130310900:G:T	0	0	0	0	0	0	0	0
7:130362476:T:C	0	0	0	0	0	0	0	0
7:130367540:T:C	0	0	0	0	0	0	0	0
7:130367547:G:T	0	0	0	0	0	0	0	0
7:130368444:T:C	0	0	0	0	0	0	0	0
7:130382200:C:T	0	0	0	0	0	0	0	0
7:130383698:C:T	0	0	0	0	0	0	0	0
7:130397032:C:A	0	0	0	0	0	0	0	0
7:130440971:T:G	6	4	7	3	4	1.0	0.0	1.0
7:131505937:T:C	0	0	0	0	0	0	0	0
7:131510953:G:A	0	0	0	0	0	0	0	0
7:131511200:C:T	0	0	0	0	0	0	0	0
7:131754113:T:C	0	0	0	0	0	0	0	0
7:132130551:A:G	0	0	0	0	0	0	0	0
7:132133091:T:C	0	0	0	0	0	0	0	0
7:133169748:C:G	1	0	1	1	0	1	1	0
7:133895694:G:A	8	5	24	7	17	2.0	0.0	1.5
7:134530651:T:C	0	0	0	0	0	0	0	0
7:135129101:G:A	0	0	0	0	0	0	0	0
7:135129568:T:C	0	0	0	0	0	0	0	0
7:135164825:A:C	5	3	5	2	3	1	0	1
7:135211415:C:A	31	12	34	19	15	1	1	0
7:135584907:TG:CA	1	1	1	0	1	1	0	1
7:135607332:G:A	5	0	21	21	0	1	1	0
7:135607350:G:A	5	0	20	20	0	1	1	0
7:135644942:T:C	7	1	8	6	2	1	1	0
7:135660248:T:C	1	0	3	3	0	3	3	0
7:136714043:G:A	0	0	0	0	0	0	0	0
7:136714431:A:G	0	0	0	0	0	0	0	0
7:138440947:C:T	0	0	0	0	0	0	0	0
7:138621061:T:C	0	0	0	0	0	0	0	0
7:138627377:A:C	0	0	0	0	0	0	0	0
7:138679022:A:G	0	0	0	0	0	0	0	0
7:138689171:T:C	0	0	0	0	0	0	0	0
7:138771243:A:G	0	0	0	0	0	0	0	0
7:138899094:C:A	0	0	0	0	0	0	0	0
7:138917671:G:A	0	0	0	0	0	0	0	0
7:138917777:T:C	0	0	0	0	0	0	0	0
7:138918170:G:C	0	0	0	0	0	0	0	0
7:139076288:G:C	12	6	22	14	8	1.0	0.5	0.5
7:139079314:G:A	1	1	1	0	1	1	0	1
7:139079399:T:C	1	1	1	0	1	1	0	1
7:139079487:C:T	8	2	8	6	2	1.0	1.0	0.0
7:139454125:T:G	0	0	0	0	0	0	0	0
7:139962273:T:C	0	0	0	0	0	0	0	0
7:140097631:G:T	7	1	9	8	1	1	1	0
7:140101977:T:G	16	8	22	12	10	1.0	0.5	0.5
7:140459921:T:C	496	238	606	332	274	1.0	1.0	0.0
7:140473302:T:G	0	0	0	0	0	0	0	0
7:140726457:A:G	8	5	22	7	15	2.5	0.0	2.0
7:142021734:T:C	0	0	0	0	0	0	0	0
7:142052413:C:A	0	0	0	0	0	0	0	0
7:142084526:G:C	0	0	0	0	0	0	0	0
7:142353182:C:G	2	2	2	0	2	1.0	0.0	1.0
7:142400249:C:A	0	0	0	0	0	0	0	0
7:142400325:G:T	0	0	0	0	0	0	0	0
7:142469796:G:A	0	0	0	0	0	0	0	0
7:142469878:G:C	1	0	1	1	0	1	1	0
7:142492164:T:G	0	0	0	0	0	0	0	0
7:142492174:G:A	0	0	0	0	0	0	0	0
7:142529598:C:G	1	0	1	1	0	1	1	0
7:142529616:C:T	0	0	0	0	0	0	0	0
7:142529646:AA:GG	0	0	0	0	0	0	0	0
7:142627230:C:A	0	0	0	0	0	0	0	0
7:142637247:C:T	0	0	0	0	0	0	0	0
7:142657056:A:G	0	0	0	0	0	0	0	0
7:143026975:C:T	0	0	0	0	0	0	0	0
7:143052640:C:T	0	0	0	0	0	0	0	0
7:143052726:G:A	0	0	0	0	0	0	0	0
7:143052856:C:T	0	0	0	0	0	0	0	0
7:143053050:C:T	0	0	0	0	0	0	0	0
7:143139110:A:T	1	1	4	0	4	4	0	4
7:143319835:C:T	0	0	0	0	0	0	0	0
7:143391433:T:C	0	0	0	0	0	0	0	0
7:143573079:A:G	0	0	0	0	0	0	0	0
7:143724551:C:A	5	3	6	2	4	1	0	1
7:144051271:T:C	0	0	0	0	0	0	0	0
7:144074315:G:C	0	0	0	0	0	0	0	0
7:144074443:G:A	0	0	0	0	0	0	0	0
7:144074844:G:C	0	0	0	0	0	0	0	0
7:144118651:T:C	0	0	0	0	0	0	0	0
7:144118687:G:T	0	0	0	0	0	0	0	0
7:144118696:C:T	0	0	0	0	0	0	0	0
7:144118768:G:C	0	0	0	0	0	0	0	0
7:144129510:G:T	0	0	0	0	0	0	0	0
7:144142315:C:T	0	0	0	0	0	0	0	0
7:144142512:T:C	0	0	0	0	0	0	0	0
7:144267174:A:G	0	0	0	0	0	0	0	0
7:144435108:C:A	0	0	0	0	0	0	0	0
7:145005991:G:A	0	0	0	0	0	0	0	0
7:145006027:C:G	0	0	0	0	0	0	0	0
7:145010745:C:A	0	0	0	0	0	0	0	0
7:145040761:A:T	0	0	0	0	0	0	0	0
7:148409398:G:A	31	20	38	17	21	1	0	1
7:149151266:G:A	1	1	2	0	2	2	0	2
7:149154121:G:A	3	2	3	1	2	1	0	1
7:149266561:C:T	23	6	24	17	7	1	1	0
7:149293767:C:T	2	0	4	4	0	2.0	2.0	0.0
7:149293842:G:A	2	0	3	3	0	1.5	1.5	0.0
7:149321884:T:C	0	0	0	0	0	0	0	0
7:149334295:C:T	3	0	3	3	0	1	1	0
7:149455815:G:A	2	1	2	1	1	1.0	0.5	0.5
7:149619971:C:T	1	0	8	8	0	8	8	0
7:149721765:C:T	0	0	0	0	0	0	0	0
7:149722544:T:G	1	1	1	0	1	1	0	1
7:149821059:A:G	0	0	0	0	0	0	0	0
7:149821872:T:C	0	0	0	0	0	0	0	0
7:149825277:T:G	0	0	0	0	0	0	0	0
7:149826495:C:T	0	0	0	0	0	0	0	0
7:149847808:G:A	11	5	12	6	6	1	1	0
7:149859429:C:T	0	0	0	0	0	0	0	0
7:149861320:G:C	0	0	0	0	0	0	0	0
7:149862184:C:T	0	0	0	0	0	0	0	0
7:149862376:C:T	0	0	0	0	0	0	0	0
7:149878795:T:C	7	3	7	4	3	1	1	0
7:150338699:G:C	0	0	0	0	0	0	0	0
7:150371844:T:C	15	8	17	9	8	1	0	1
7:150793288:C:T	7	0	7	7	0	1	1	0
7:150857799:G:A	0	0	0	0	0	0	0	0
7:150858914:T:C	0	0	0	0	0	0	0	0
7:150860534:G:A	0	0	0	0	0	0	0	0
7:150860577:C:G	0	0	0	0	0	0	0	0
7:150952443:G:A	3	2	4	1	3	1	0	1
7:150952515:G:A	3	1	3	2	1	1	1	0
7:151119988:C:T	2	2	2	0	2	1.0	0.0	1.0
7:151215664:G:T	20	9	53	28	25	2.0	1.0	0.0
7:151215700:T:C	22	10	55	29	26	1.0	1.0	0.0
7:151219142:G:A	15	8	48	30	18	3	0	1
7:151234182:C:G	8	4	9	4	5	1.0	0.5	0.5
7:151876646:G:A	34	21	38	13	25	1.0	0.0	1.0
7:151982987:T:C	0	0	0	0	0	0	0	0
7:151983090:C:T	0	0	0	0	0	0	0	0
7:152229936:C:A	6	0	20	20	0	2.5	2.5	0.0
7:152229941:T:C	6	0	20	20	0	2.5	2.5	0.0
7:152273771:T:A	6	0	13	13	0	1.0	1.0	0.0
7:152442769:A:C	0	0	0	0	0	0	0	0
7:152446659:A:G	0	0	0	0	0	0	0	0
7:152648922:C:T	0	0	0	0	0	0	0	0
7:154637850:C:T	0	0	0	0	0	0	0	0
7:154875918:A:G	0	0	0	0	0	0	0	0
7:154875933:G:A	0	0	0	0	0	0	0	0
7:154944064:T:C	65	34	82	46	36	1	0	1
7:154947969:T:C	15	9	20	6	14	1	0	1
7:155071387:C:T	0	0	0	0	0	0	0	0
7:155738260:T:C	18	8	29	18	11	1.0	1.0	0.0
7:155806606:C:T	0	0	0	0	0	0	0	0
7:157197860:C:T	0	0	0	0	0	0	0	0
7:157207482:T:C	6	2	6	4	2	1.0	1.0	0.0
7:157369374:T:C	1	1	2	0	2	2	0	2
7:157369409:A:G	1	1	2	0	2	2	0	2
7:158138427:A:G	0	0	0	0	0	0	0	0
7:158138452:C:T	0	0	0	0	0	0	0	0
7:158167187:C:T	0	0	0	0	0	0	0	0
7:158167203:C:T	0	0	0	0	0	0	0	0
7:158532800:G:A	0	0	0	0	0	0	0	0
7:158879928:A:G	10	3	15	8	7	1.0	1.0	0.0
8:232934:T:C	2	1	3	2	1	1.5	1.0	0.5
8:232949:C:A	2	1	3	2	1	1.5	1.0	0.5
8:245254:C:A	3	1	3	2	1	1	1	0
8:413192:G:A	104	65	124	44	80	1.0	0.0	1.0
8:615219:C:G	1	0	1	1	0	1	1	0
8:615232:C:G	1	0	1	1	0	1	1	0
8:668728:A:G	26	17	33	14	19	1.0	0.0	1.0
8:1565843:C:A	0	0	0	0	0	0	0	0
8:1668552:A:G	0	0	0	0	0	0	0	0
8:1858063:A:C	12	11	49	3	46	3.0	0.0	2.5
8:1885635:G:C	1	1	4	0	4	4	0	4
8:1898522:C:T	0	0	0	0	0	0	0	0
8:1909382:T:C	1	0	3	3	0	3	3	0
8:3214585:G:C	0	0	0	0	0	0	0	0
8:3396246:C:T	0	0	0	0	0	0	0	0
8:4788211:T:A	0	0	0	0	0	0	0	0
8:6414878:G:T	329	165	481	264	217	1	1	1
8:6444633:G:T	7	2	8	6	2	1	1	0
8:6444662:G:C	5	3	5	2	3	1	0	1
8:6474091:G:A	2	1	15	9	6	7.5	4.5	3.0
8:6480785:C:A	10	3	16	10	6	1.0	1.0	0.0
8:6499786:T:C	2	2	5	0	5	2.5	0.0	2.5
8:6513770:A:G	0	0	0	0	0	0	0	0
8:6519912:C:T	0	0	0	0	0	0	0	0
8:6621435:A:G	1	0	1	1	0	1	1	0
8:6621465:C:T	8	4	10	6	4	1.0	0.5	0.5
8:6621521:C:T	10	6	12	6	6	1.0	0.0	1.0
8:6877877:C:T	0	0	0	0	0	0	0	0
8:6877901:C:G	0	0	0	0	0	0	0	0
8:6898999:T:C	0	0	0	0	0	0	0	0
8:6899055:A:G	0	0	0	0	0	0	0	0
8:6899060:G:C	0	0	0	0	0	0	0	0
8:6936018:C:T	1	0	3	3	0	3	3	0
8:7055509:G:A	0	0	0	0	0	0	0	0
8:7297095:T:A	0	0	0	0	0	0	0	0
8:7297143:G:A	0	0	0	0	0	0	0	0
8:7297152:G:C	0	0	0	0	0	0	0	0
8:7297395:A:C	0	0	0	0	0	0	0	0
8:7357924:T:C	0	0	0	0	0	0	0	0
8:7358172:A:G	0	0	0	0	0	0	0	0
8:7860665:T:G	0	0	0	0	0	0	0	0
8:8234503:G:A	11	3	35	28	7	3	2	0
8:8236056:T:C	2	1	2	1	1	1.0	0.5	0.5
8:8237150:T:C	4	3	16	10	6	2.5	0.0	1.5
8:8240516:T:C	5	2	21	14	7	4	2	0
8:8319038:C:T	15	7	15	8	7	1	1	0
8:8797388:C:T	40	34	74	13	61	1.0	0.0	1.0
8:8892219:G:C	5	4	5	1	4	1	0	1
8:8933743:C:A	3	3	3	0	3	1	0	1
8:9011689:T:G	2	2	3	0	3	1.5	0.0	1.5
8:9706927:A:G	9	6	22	5	17	1	0	1
8:10353665:C:T	2	0	9	9	0	4.5	4.5	0.0
8:10525628:G:A	0	0	0	0	0	0	0	0
8:10532942:C:T	0	0	0	0	0	0	0	0
8:10607245:C:T	0	0	0	0	0	0	0	0
8:10607375:T:C	0	0	0	0	0	0	0	0
8:10607587:C:T	0	0	0	0	0	0	0	0
8:10608238:T:C	0	0	0	0	0	0	0	0
8:10609650:G:A	0	0	0	0	0	0	0	0
8:10610079:T:C	0	0	0	0	0	0	0	0
8:10610094:C:A	0	0	0	0	0	0	0	0
8:10611830:G:A	0	0	0	0	0	0	0	0
8:10612558:C:T	0	0	0	0	0	0	0	0
8:10831702:C:T	105	56	256	119	137	2	0	1
8:11062816:C:T	0	0	0	0	0	0	0	0
8:11304987:A:C	4	2	5	3	2	1.0	0.5	0.5
8:11331234:C:T	0	0	0	0	0	0	0	0
8:11331243:G:A	0	0	0	0	0	0	0	0
8:11438540:T:A	0	0	0	0	0	0	0	0
8:11444092:G:C	0	0	0	0	0	0	0	0
8:11558662:T:C	12	6	46	26	20	3.0	0.5	0.5
8:11558919:C:T	8	3	14	6	8	1.0	1.0	0.0
8:11560876:G:A	15	2	15	13	2	1	1	0
8:11761654:A:G	0	0	0	0	0	0	0	0
8:11761995:T:A	0	0	0	0	0	0	0	0
8:11783275:A:G	6	4	6	2	4	1.0	0.0	1.0
8:11786294:C:T	4	2	12	2	10	1.0	0.5	0.5
8:11802542:A:G	2	0	5	5	0	2.5	2.5	0.0
8:11803407:C:T	39	17	45	27	18	1	1	0
8:11831610:G:C	80	44	120	55	65	1.0	0.0	1.0
8:11848168:C:G	1	1	1	0	1	1	0	1
8:11853379:G:C	564	269	697	389	308	1.0	1.0	0.0
8:11853465:G:A	313	138	372	212	160	1	1	0
8:11920468:C:G	0	0	0	0	0	0	0	0
8:11920683:C:T	0	0	0	0	0	0	0	0
8:11929482:T:C	0	0	0	0	0	0	0	0
8:11974570:A:G	0	0	0	0	0	0	0	0
8:12128210:A:T	0	0	0	0	0	0	0	0
8:12128324:C:T	0	0	0	0	0	0	0	0
8:12133373:C:T	0	0	0	0	0	0	0	0
8:12133528:G:C	0	0	0	0	0	0	0	0
8:12133598:TGTG:GGTA	0	0	0	0	0	0	0	0
8:12137448:T:C	0	0	0	0	0	0	0	0
8:12137975:C:T	0	0	0	0	0	0	0	0
8:12138314:C:T	0	0	0	0	0	0	0	0
8:12415278:T:C	0	0	0	0	0	0	0	0
8:12659763:CTGTT:GTGTG	0	0	0	0	0	0	0	0
8:12676095:A:G	0	0	0	0	0	0	0	0
8:12684783:A:G	0	0	0	0	0	0	0	0
8:12952182:A:G	0	0	0	0	0	0	0	0
8:12990911:G:C	0	0	0	0	0	0	0	0
8:13021298:T:G	0	0	0	0	0	0	0	0
8:13021334:C:A	0	0	0	0	0	0	0	0
8:13031234:A:G	0	0	0	0	0	0	0	0
8:13031399:T:G	0	0	0	0	0	0	0	0
8:15806916:C:A	0	0	0	0	0	0	0	0
8:17210450:C:G	10	5	17	8	9	1.0	0.5	0.5
8:17755185:C:G	0	0	0	0	0	0	0	0
8:17868685:G:A	0	0	0	0	0	0	0	0
8:17874452:G:A	0	0	0	0	0	0	0	0
8:17882130:C:A	0	0	0	0	0	0	0	0
8:17885542:A:T	0	0	0	0	0	0	0	0
8:17960044:G:T	17	8	20	12	8	1	1	0
8:17963205:A:T	15	6	19	10	9	1	1	0
8:18069771:G:T	0	0	0	0	0	0	0	0
8:18069785:C:T	0	0	0	0	0	0	0	0
8:18069818:T:C	548	319	662	297	365	1.0	0.0	1.0
8:18071302:C:T	706	400	899	392	507	1.0	1.0	1.0
8:18071411:T:C	0	0	0	0	0	0	0	0
8:18089554:T:C	0	0	0	0	0	0	0	0
8:19332980:A:G	0	0	0	0	0	0	0	0
8:19334821:G:T	0	0	0	0	0	0	0	0
8:19361255:A:G	0	0	0	0	0	0	0	0
8:19458575:G:A	0	0	0	0	0	0	0	0
8:20179316:C:G	0	0	0	0	0	0	0	0
8:21976454:C:T	4	3	14	2	12	3.0	0.0	2.5
8:21989075:G:C	5	3	5	2	3	1	0	1
8:22005040:A:G	9	6	15	3	12	1	0	1
8:22102585:C:T	13	5	34	13	21	1	1	0
8:22125478:T:C	0	0	0	0	0	0	0	0
8:22125484:A:G	0	0	0	0	0	0	0	0
8:22127252:C:T	0	0	0	0	0	0	0	0
8:22140225:A:T	6	0	15	15	0	1.0	1.0	0.0
8:22571077:G:A	12	7	12	5	7	1.0	0.0	1.0
8:22585148:A:G	13	7	14	6	8	1	0	1
8:22606110:C:T	127	66	169	77	92	1	0	1
8:22623936:A:G	14	8	16	7	9	1.0	0.0	1.0
8:22713505:A:G	2	1	5	1	4	2.5	0.5	2.0
8:22727205:T:C	0	0	0	0	0	0	0	0
8:22927646:G:A	1	0	1	1	0	1	1	0
8:23022649:G:C	5	4	5	1	4	1	0	1
8:23027818:A:T	0	0	0	0	0	0	0	0
8:23068800:G:A	90	44	155	71	84	1.0	1.0	0.0
8:23068985:G:A	11	7	11	4	7	1	0	1
8:23083134:G:A	0	0	0	0	0	0	0	0
8:23103191:G:C	1	0	1	1	0	1	1	0
8:23116812:G:A	0	0	0	0	0	0	0	0
8:23116937:T:C	0	0	0	0	0	0	0	0
8:23201811:C:G	14	10	20	7	13	1.0	0.0	1.0
8:23202743:T:C	49	22	85	46	39	1	1	0
8:23260642:T:C	85	42	133	69	64	1	1	0
8:23294821:A:G	13	8	16	5	11	1	0	1
8:23806140:C:A	0	0	0	0	0	0	0	0
8:24351334:G:A	5	2	12	6	6	1	1	0
8:24351421:C:A	4	3	9	3	6	2.0	0.0	1.0
8:24398539:C:T	0	0	0	0	0	0	0	0
8:24398957:C:T	0	0	0	0	0	0	0	0
8:24404013:A:G	0	0	0	0	0	0	0	0
8:25372652:C:T	0	0	0	0	0	0	0	0
8:25410106:A:G	0	0	0	0	0	0	0	0
8:25423284:C:G	1	1	1	0	1	1	0	1
8:25460308:A:T	0	0	0	0	0	0	0	0
8:26383130:A:G	182	121	226	73	153	1.0	0.0	1.0
8:26653276:T:C	0	0	0	0	0	0	0	0
8:26770511:A:G	0	0	0	0	0	0	0	0
8:26779389:T:A	0	0	0	0	0	0	0	0
8:26779408:T:C	0	0	0	0	0	0	0	0
8:26859105:G:A	0	0	0	0	0	0	0	0
8:26859198:G:A	0	0	0	0	0	0	0	0
8:27087216:G:A	0	0	0	0	0	0	0	0
8:27243762:C:T	0	0	0	0	0	0	0	0
8:27397563:A:G	182	85	218	117	101	1.0	1.0	0.0
8:27397611:T:C	241	112	277	154	123	1	1	0
8:27397629:G:A	265	120	294	162	132	1	1	0
8:27397746:A:G	159	66	208	133	75	1	1	0
8:27597165:G:A	0	0	0	0	0	0	0	0
8:27604964:A:G	0	0	0	0	0	0	0	0
8:27776547:C:T	0	0	0	0	0	0	0	0
8:27810452:C:G	0	0	0	0	0	0	0	0
8:27872015:G:A	0	0	0	0	0	0	0	0
8:28067687:T:C	2	1	4	1	3	2.0	0.5	1.5
8:28447252:C:T	0	0	0	0	0	0	0	0
8:28717286:G:A	0	0	0	0	0	0	0	0
8:28743055:G:C	0	0	0	0	0	0	0	0
8:28793917:C:T	5	3	8	5	3	1	0	1
8:29340155:A:G	1	0	1	1	0	1	1	0
8:30028119:A:G	0	0	0	0	0	0	0	0
8:30028190:C:T	1	0	1	1	0	1	1	0
8:30028412:C:G	0	0	0	0	0	0	0	0
8:30028625:G:C	0	0	0	0	0	0	0	0
8:30028641:G:A	0	0	0	0	0	0	0	0
8:30028857:G:A	0	0	0	0	0	0	0	0
8:30117715:T:C	1	0	1	1	0	1	1	0
8:30132316:C:T	1	1	1	0	1	1	0	1
8:30744288:C:T	18	7	18	11	7	1.0	1.0	0.0
8:30837446:A:C	0	0	0	0	0	0	0	0
8:30843082:T:C	0	0	0	0	0	0	0	0
8:31081188:G:A	1	1	3	0	3	3	0	3
8:31116441:G:T	3	1	6	3	3	2	1	0
8:31120201:T:C	1	0	1	1	0	1	1	0
8:31141764:G:T	1	0	5	5	0	5	5	0
8:31167122:C:T	0	0	0	0	0	0	0	0
8:31220751:G:T	0	0	0	0	0	0	0	0
8:32756465:T:C	4	1	5	3	2	1.0	1.0	0.0
8:33389396:G:A	1	0	1	1	0	1	1	0
8:33436311:T:C	0	0	0	0	0	0	0	0
8:33455811:G:A	0	0	0	0	0	0	0	0
8:33498556:A:G	1	1	2	0	2	2	0	2
8:33512426:T:C	31	15	33	16	17	1	1	0
8:33512476:A:G	46	24	50	22	28	1.0	0.0	1.0
8:36845805:C:G	0	0	0	0	0	0	0	0
8:37872850:G:A	2	0	4	4	0	2.0	2.0	0.0
8:37872938:G:T	3	3	7	0	7	2	0	2
8:38991331:C:T	2	1	6	5	1	3.0	2.5	0.5
8:39107128:G:A	0	0	0	0	0	0	0	0
8:39107752:C:T	0	0	0	0	0	0	0	0
8:39465868:T:C	0	0	0	0	0	0	0	0
8:39473491:G:A	0	0	0	0	0	0	0	0
8:39473524:C:T	0	0	0	0	0	0	0	0
8:39473574:T:C	0	0	0	0	0	0	0	0
8:40581238:T:C	0	0	0	0	0	0	0	0
8:40786704:C:G	0	0	0	0	0	0	0	0
8:47817545:T:C	51	31	195	81	114	3	0	1
8:48384907:A:G	0	0	0	0	0	0	0	0
8:52940318:G:A	0	0	0	0	0	0	0	0
8:52940600:T:C	0	0	0	0	0	0	0	0
8:53832978:C:G	4	2	4	2	2	1.0	0.5	0.5
8:54523073:G:A	1	1	1	0	1	1	0	1
8:54626497:G:A	0	0	0	0	0	0	0	0
8:54628890:G:A	0	0	0	0	0	0	0	0
8:54628953:T:C	0	0	0	0	0	0	0	0
8:54629057:A:G	0	0	0	0	0	0	0	0
8:54720202:C:T	0	0	0	0	0	0	0	0
8:55142136:C:T	0	0	0	0	0	0	0	0
8:56050921:G:A	26	0	28	28	0	1.0	1.0	0.0
8:56216732:A:T	18	6	22	14	8	1.0	1.0	0.0
8:58659297:A:C	10	6	15	9	6	1.0	0.0	1.0
8:60742450:A:G	26	9	34	24	10	1.0	1.0	0.0
8:60938530:C:T	1	0	1	1	0	1	1	0
8:62249053:C:G	0	0	0	0	0	0	0	0
8:63035706:C:T	41	16	60	38	22	1	1	0
8:65605314:T:C	17	9	31	15	16	1	0	1
8:66595680:C:T	0	0	0	0	0	0	0	0
8:66985612:G:C	0	0	0	0	0	0	0	0
8:67064428:A:G	8	5	11	3	8	1.0	0.0	1.0
8:67624235:A:G	0	0	0	0	0	0	0	0
8:68134174:G:A	0	0	0	0	0	0	0	0
8:69130028:A:G	1	1	1	0	1	1	0	1
8:69942974:C:T	0	0	0	0	0	0	0	0
8:69943390:C:T	1	0	1	1	0	1	1	0
8:69943403:T:C	1	0	1	1	0	1	1	0
8:69987450:G:T	0	0	0	0	0	0	0	0
8:69987529:G:A	0	0	0	0	0	0	0	0
8:70052164:A:G	0	0	0	0	0	0	0	0
8:70055372:T:C	0	0	0	0	0	0	0	0
8:71199364:A:G	0	0	0	0	0	0	0	0
8:71216774:G:A	0	0	0	0	0	0	0	0
8:72022804:C:T	0	0	0	0	0	0	0	0
8:72053738:G:A	0	0	0	0	0	0	0	0
8:72071806:C:G	0	0	0	0	0	0	0	0
8:72075403:G:A	0	0	0	0	0	0	0	0
8:74361906:T:G	4	0	4	4	0	1.0	1.0	0.0
8:74366222:A:G	1	1	1	0	1	1	0	1
8:74603964:G:C	5	5	5	0	5	1	0	1
8:75540078:G:A	0	0	0	0	0	0	0	0
8:76833399:G:A	0	0	0	0	0	0	0	0
8:76853162:A:G	0	0	0	0	0	0	0	0
8:76856154:T:G	0	0	0	0	0	0	0	0
8:78698475:A:G	2	2	2	0	2	1.0	0.0	1.0
8:79571320:T:C	0	0	0	0	0	0	0	0
8:80080435:C:T	0	0	0	0	0	0	0	0
8:80301435:G:T	0	0	0	0	0	0	0	0
8:80595331:G:A	0	0	0	0	0	0	0	0
8:81521735:G:A	0	0	0	0	0	0	0	0
8:81634976:G:A	0	0	0	0	0	0	0	0
8:81694547:A:G	0	0	0	0	0	0	0	0
8:81808116:C:A	4	0	4	4	0	1.0	1.0	0.0
8:81808169:T:C	0	0	0	0	0	0	0	0
8:81808465:G:A	0	0	0	0	0	0	0	0
8:81808525:G:A	0	0	0	0	0	0	0	0
8:81815334:T:C	1	0	1	1	0	1	1	0
8:85109697:T:A	11	8	11	3	8	1	0	1
8:85115183:A:G	5	1	13	6	7	1	1	0
8:85222745:T:C	0	0	0	0	0	0	0	0
8:85439768:G:A	0	0	0	0	0	0	0	0
8:85474468:C:T	0	0	0	0	0	0	0	0
8:85477174:T:C	0	0	0	0	0	0	0	0
8:86064291:C:A	0	0	0	0	0	0	0	0
8:86214471:A:G	0	0	0	0	0	0	0	0
8:86217719:T:A	0	0	0	0	0	0	0	0
8:86482745:G:C	6	4	29	10	19	3.0	0.0	2.0
8:86503659:G:T	0	0	0	0	0	0	0	0
8:86504972:A:G	0	0	0	0	0	0	0	0
8:86507086:T:G	250	148	349	143	206	1.0	0.0	1.0
8:86554965:C:T	8	4	13	4	9	1.0	0.5	0.5
8:86593820:T:G	0	0	0	0	0	0	0	0
8:88327933:G:C	0	0	0	0	0	0	0	0
8:90082101:T:G	0	0	0	0	0	0	0	0
8:91351872:T:C	0	0	0	0	0	0	0	0
8:93134427:G:T	0	0	0	0	0	0	0	0
8:93734470:G:T	4	2	4	2	2	1.0	0.5	0.5
8:93734907:G:A	6	3	6	3	3	1.0	0.5	0.5
8:93795937:A:G	2	1	3	2	1	1.5	1.0	0.5
8:93819118:G:A	0	0	0	0	0	0	0	0
8:93923709:T:C	5	3	5	2	3	1	0	1
8:94174154:G:A	0	0	0	0	0	0	0	0
8:94202976:C:T	0	0	0	0	0	0	0	0
8:94526480:G:A	0	0	0	0	0	0	0	0
8:94529143:T:A	4	1	4	3	1	1.0	1.0	0.0
8:94865559:T:C	9	2	10	8	2	1	1	0
8:94876079:C:T	13	5	16	11	5	1	1	0
8:94883878:G:C	2	0	12	12	0	6.0	6.0	0.0
8:96226898:T:C	0	0	0	0	0	0	0	0
8:96227385:A:C	1	0	1	1	0	1	1	0
8:96227901:C:T	0	0	0	0	0	0	0	0
8:96228619:A:G	0	0	0	0	0	0	0	0
8:96229896:G:A	2	0	2	2	0	1.0	1.0	0.0
8:96231406:G:A	55	46	59	9	50	1	0	1
8:96372180:C:T	0	0	0	0	0	0	0	0
8:98089748:A:C	0	0	0	0	0	0	0	0
8:98102854:C:T	12	8	15	7	8	1.0	0.0	1.0
8:98140860:A:C	0	0	0	0	0	0	0	0
8:99431657:C:T	3	0	3	3	0	1	1	0
8:100140796:G:A	0	0	0	0	0	0	0	0
8:100194303:G:A	0	0	0	0	0	0	0	0
8:100240452:T:C	4	1	7	6	1	1.0	1.0	0.0
8:100551555:C:T	11	2	30	28	2	1	1	0
8:100551580:C:T	6	1	17	16	1	1.5	1.5	0.0
8:100573905:T:C	0	0	0	0	0	0	0	0
8:100635936:C:G	0	0	0	0	0	0	0	0
8:100657798:G:T	0	0	0	0	0	0	0	0
8:100706737:GGAC:AGAT	384	0	511	511	0	1.0	1.0	0.0
8:100706759:G:A	361	0	491	491	0	1	1	0
8:100706776:G:A	381	1	518	517	1	1	1	0
8:100706910:C:T	387	0	535	535	0	1	1	0
8:100706973:A:G	415	2	576	574	2	1	1	0
8:100709671:C:A	375	7	601	594	7	1	1	0
8:100717845:T:C	272	0	338	338	0	1.0	1.0	0.0
8:102238763:C:T	36	21	90	35	55	2.0	0.0	1.0
8:102293637:T:C	5	3	9	2	7	1	0	1
8:102529359:G:A	21	14	52	23	29	1	0	1
8:102560773:C:G	0	0	0	0	0	0	0	0
8:102560778:G:A	0	0	0	0	0	0	0	0
8:102838824:T:C	11	8	16	3	13	1	0	1
8:103300204:A:G	0	0	0	0	0	0	0	0
8:103382516:T:C	0	0	0	0	0	0	0	0
8:103415313:C:T	8	5	15	3	12	1.0	0.0	1.0
8:103415324:C:G	8	5	14	3	11	1.0	0.0	1.0
8:103415350:T:C	6	4	9	2	7	1.0	0.0	1.0
8:103420317:A:G	209	85	240	146	94	1	1	0
8:103918517:T:A	0	0	0	0	0	0	0	0
8:105196739:G:A	0	0	0	0	0	0	0	0
8:105795815:C:T	0	0	0	0	0	0	0	0
8:106697617:C:A	6	0	6	6	0	1.0	1.0	0.0
8:106769837:A:G	0	0	0	0	0	0	0	0
8:106770107:G:A	0	0	0	0	0	0	0	0
8:109289769:T:C	3	1	4	2	2	1	1	0
8:109289818:T:G	3	2	4	1	3	1	0	1
8:112228859:T:G	0	0	0	0	0	0	0	0
8:112255480:A:G	0	0	0	0	0	0	0	0
8:113600377:C:T	0	0	0	0	0	0	0	0
8:117171166:C:T	0	0	0	0	0	0	0	0
8:117807339:C:T	2	1	2	1	1	1.0	0.5	0.5
8:117835543:G:A	1	0	1	1	0	1	1	0
8:118379627:G:A	1	1	1	0	1	1	0	1
8:118928934:A:G	0	0	0	0	0	0	0	0
8:118951813:G:C	0	0	0	0	0	0	0	0
8:119089699:A:G	0	0	0	0	0	0	0	0
8:119732109:T:C	3	2	3	1	2	1	0	1
8:119732159:C:T	3	2	5	1	4	1	0	1
8:119778064:T:C	2	1	2	1	1	1.0	0.5	0.5
8:119781056:C:T	3	0	14	14	0	2	2	0
8:119791414:C:T	2	1	2	1	1	1.0	0.5	0.5
8:119834883:C:T	0	0	0	0	0	0	0	0
8:120280940:G:A	0	0	0	0	0	0	0	0
8:120285917:G:C	0	0	0	0	0	0	0	0
8:122952579:G:A	12	5	23	15	8	1.0	1.0	0.0
8:122953919:G:C	1	0	1	1	0	1	1	0
8:123109558:A:G	1	0	1	1	0	1	1	0
8:123361557:C:T	4	0	6	6	0	1.5	1.5	0.0
8:123651890:C:T	0	0	0	0	0	0	0	0
8:123651927:T:C	0	0	0	0	0	0	0	0
8:123652552:C:T	0	0	0	0	0	0	0	0
8:123652633:AT:GC	0	0	0	0	0	0	0	0
8:124023511:G:A	0	0	0	0	0	0	0	0
8:124103179:G:A	0	0	0	0	0	0	0	0
8:124451009:T:C	90	52	93	38	55	1.0	0.0	1.0
8:124451303:T:C	5	2	5	3	2	1	1	0
8:124486306:C:T	8	1	8	7	1	1.0	1.0	0.0
8:124555921:A:G	6	3	6	3	3	1.0	0.5	0.5
8:125000003:A:C	2	0	8	8	0	4.0	4.0	0.0
8:127086316:T:A	0	0	0	0	0	0	0	0
8:127086593:G:A	0	0	0	0	0	0	0	0
8:127087287:G:T	0	0	0	0	0	0	0	0
8:129728893:A:G	0	0	0	0	0	0	0	0
8:129728937:G:T	0	0	0	0	0	0	0	0
8:129729977:T:C	0	0	0	0	0	0	0	0
8:129748604:A:G	0	0	0	0	0	0	0	0
8:130340893:T:C	0	0	0	0	0	0	0	0
8:131970577:A:G	11	5	23	15	8	1	1	0
8:132034824:G:A	0	0	0	0	0	0	0	0
8:133094979:A:G	0	0	0	0	0	0	0	0
8:133096302:T:C	0	0	0	0	0	0	0	0
8:133102527:C:T	0	0	0	0	0	0	0	0
8:133113438:G:A	0	0	0	0	0	0	0	0
8:133326124:G:A	0	0	0	0	0	0	0	0
8:133408330:G:A	69	0	72	72	0	1	1	0
8:133461905:C:T	11	6	11	5	6	1	0	1
8:134512554:G:T	8	4	12	7	5	1.0	0.5	0.5
8:134600502:A:G	34	17	36	18	18	1.0	0.5	0.5
8:134602462:A:G	8	6	14	2	12	1.0	0.0	1.0
8:134637605:G:A	2	1	2	1	1	1.0	0.5	0.5
8:138137163:G:A	0	0	0	0	0	0	0	0
8:138153029:T:C	0	0	0	0	0	0	0	0
8:138153046:T:C	0	0	0	0	0	0	0	0
8:138685235:T:C	0	0	0	0	0	0	0	0
8:138688966:G:T	0	0	0	0	0	0	0	0
8:138826669:T:C	0	0	0	0	0	0	0	0
8:139618747:A:G	0	0	0	0	0	0	0	0
8:140300545:G:A	6	4	6	2	4	1.0	0.0	1.0
8:140450963:G:A	6	4	14	7	7	1.0	0.0	1.0
8:140451086:A:G	21	9	27	13	14	1	1	0
8:140451167:A:G	68	42	82	36	46	1.0	0.0	1.0
8:140515193:A:C	85	38	95	52	43	1	1	0
8:140541308:G:A	4	1	4	3	1	1.0	1.0	0.0
8:140669718:T:C	1	1	1	0	1	1	0	1
8:141180817:G:A	3	0	3	3	0	1	1	0
8:141192785:T:C	0	0	0	0	0	0	0	0
8:141194227:C:G	5	4	5	1	4	1	0	1
8:141218559:T:C	1	0	1	1	0	1	1	0
8:141256592:A:C	0	0	0	0	0	0	0	0
8:141459726:G:A	0	0	0	0	0	0	0	0
8:141477438:A:G	0	0	0	0	0	0	0	0
8:141480020:G:T	0	0	0	0	0	0	0	0
8:141480347:A:C	0	0	0	0	0	0	0	0
8:141507122:A:G	0	0	0	0	0	0	0	0
8:141507127:C:T	0	0	0	0	0	0	0	0
8:142331782:C:T	7	5	9	2	7	1	0	1
8:142345817:C:G	32	19	39	15	24	1.0	0.0	1.0
8:142354673:A:G	27	16	77	40	37	1	0	1
8:142539461:T:C	0	0	0	0	0	0	0	0
8:142613783:G:A	0	0	0	0	0	0	0	0
8:142680513:C:T	0	0	0	0	0	0	0	0
8:142682200:CACCC:GACCT	0	0	0	0	0	0	0	0
8:142682272:G:A	0	0	0	0	0	0	0	0
8:142682339:T:G	0	0	0	0	0	0	0	0
8:142727533:C:T	107	41	107	66	41	1	1	0
8:142841204:C:T	0	0	0	0	0	0	0	0
8:143043095:T:C	15	0	23	23	0	1	1	0
8:143213279:C:T	0	0	0	0	0	0	0	0
8:143249912:T:C	2	1	6	5	1	3.0	2.5	0.5
8:143321279:G:A	15	10	20	7	13	1	0	1
8:143324535:C:T	12	4	15	10	5	1.0	1.0	0.0
8:143541404:T:C	10	5	12	6	6	1.0	0.5	0.5
8:143560999:C:T	12	1	24	20	4	2.0	1.5	0.0
8:143719073:C:T	0	0	0	0	0	0	0	0
8:143727098:C:T	0	0	0	0	0	0	0	0
8:143807002:A:G	8	5	8	3	5	1.0	0.0	1.0
8:143810914:G:A	0	0	0	0	0	0	0	0
8:143812326:G:A	0	0	0	0	0	0	0	0
8:143813499:G:A	1	1	1	0	1	1	0	1
8:143822520:A:G	0	0	0	0	0	0	0	0
8:143835782:G:A	0	0	0	0	0	0	0	0
8:143866611:G:A	0	0	0	0	0	0	0	0
8:143870058:G:A	0	0	0	0	0	0	0	0
8:143916360:A:G	22	7	25	18	7	1.0	1.0	0.0
8:143917935:T:C	9	3	9	6	3	1	1	0
8:143918694:A:G	6	2	6	4	2	1.0	1.0	0.0
8:143919156:C:T	4	2	4	2	2	1.0	0.5	0.5
8:143919209:A:G	1	0	2	2	0	2	2	0
8:143921326:C:T	3	1	3	2	1	1	1	0
8:143921861:A:G	1	1	1	0	1	1	0	1
8:143921943:C:T	2	0	2	2	0	1.0	1.0	0.0
8:143922240:T:G	4	2	4	2	2	1.0	0.5	0.5
8:143923488:C:T	3	0	3	3	0	1	1	0
8:143923759:G:A	2	2	6	0	6	3.0	0.0	3.0
8:143925249:C:T	4	3	4	1	3	1.0	0.0	1.0
8:143925453:C:T	6	3	6	3	3	1.0	0.5	0.5
8:143925474:A:C	8	4	9	5	4	1.0	0.5	0.5
8:143925516:A:G	8	4	9	5	4	1.0	0.5	0.5
8:143926863:T:C	8	4	15	5	10	1.5	0.5	0.5
8:143927420:C:T	5	3	10	3	7	1	0	1
8:143934392:A:G	6	2	6	4	2	1.0	1.0	0.0
8:143942489:G:C	25	14	127	65	62	4	0	1
8:143984818:A:G	7	5	7	2	5	1	0	1
8:143985257:T:C	9	7	16	2	14	1	0	1
8:144057076:G:A	0	0	0	0	0	0	0	0
8:144085105:C:T	16	6	16	10	6	1.0	1.0	0.0
8:144239149:G:A	1	1	1	0	1	1	0	1
8:144398573:G:A	15	7	17	8	9	1	1	0
8:144414342:T:C	0	0	0	0	0	0	0	0
8:144416180:T:G	0	0	0	0	0	0	0	0
8:144498036:T:G	2	1	6	2	4	3.0	1.0	2.0
8:144504344:C:A	0	0	0	0	0	0	0	0
8:144931718:C:G	0	0	0	0	0	0	0	0
9:117666:T:C	0	0	0	0	0	0	0	0
9:117696:G:A	0	0	0	0	0	0	0	0
9:117877:C:T	0	0	0	0	0	0	0	0
9:118032:G:A	0	0	0	0	0	0	0	0
9:214719:C:T	6	3	8	5	3	1.0	0.5	0.5
9:286491:G:A	282	127	482	268	214	1.0	1.0	0.0
9:286593:C:A	633	364	820	384	436	1	0	1
9:312124:T:C	18	5	26	17	9	1.0	1.0	0.0
9:334337:A:G	28	9	41	24	17	1.0	1.0	0.0
9:370244:A:G	71	31	156	95	61	2	1	0
9:377111:G:C	9	4	10	6	4	1	1	0
9:390512:C:T	16	8	29	17	12	1.0	0.5	0.5
9:421032:C:G	10	4	28	21	7	2.0	1.5	0.0
9:676954:T:C	1	0	2	2	0	2	2	0
9:712060:G:C	0	0	0	0	0	0	0	0
9:712599:C:T	1	1	1	0	1	1	0	1
9:1056728:G:C	0	0	0	0	0	0	0	0
9:2718642:C:T	0	0	0	0	0	0	0	0
9:2811505:G:A	7	3	8	4	4	1	1	0
9:2828765:C:G	12	6	20	11	9	1.0	0.5	0.5
9:4285986:G:C	0	0	0	0	0	0	0	0
9:4564432:G:A	0	0	0	0	0	0	0	0
9:4576680:T:C	0	0	0	0	0	0	0	0
9:5050706:C:T	3	2	4	2	2	1	0	1
9:5085417:C:T	1	0	6	6	0	6	6	0
9:5231712:T:A	0	0	0	0	0	0	0	0
9:5557708:T:C	0	0	0	0	0	0	0	0
9:5762600:G:A	2	0	3	3	0	1.5	1.5	0.0
9:5774225:T:G	7	4	10	6	4	1	0	1
9:5920454:T:G	3	2	3	1	2	1	0	1
9:5920886:G:A	2	2	2	0	2	1.0	0.0	1.0
9:7076463:G:A	3	1	3	2	1	1	1	0
9:7103816:C:T	18	9	18	9	9	1.0	0.5	0.5
9:7174673:G:A	19	11	21	9	12	1	0	1
9:7477573:T:C	0	0	0	0	0	0	0	0
9:7477728:T:C	1	0	1	1	0	1	1	0
9:7597988:C:T	0	0	0	0	0	0	0	0
9:8465598:A:G	0	0	0	0	0	0	0	0
9:8485834:G:A	0	0	0	0	0	0	0	0
9:13987095:A:C	0	0	0	0	0	0	0	0
9:13987877:C:G	0	0	0	0	0	0	0	0
9:14722479:G:C	0	0	0	0	0	0	0	0
9:14722618:G:A	0	0	0	0	0	0	0	0
9:14737508:T:G	0	0	0	0	0	0	0	0
9:14770785:C:A	0	0	0	0	0	0	0	0
9:14776029:C:T	0	0	0	0	0	0	0	0
9:14846038:C:G	0	0	0	0	0	0	0	0
9:14859358:T:C	0	0	0	0	0	0	0	0
9:15486872:A:G	40	20	65	35	30	1.0	0.5	0.5
9:15527350:AC:TA	0	0	0	0	0	0	0	0
9:15527571:G:A	7	6	7	1	6	1	0	1
9:15527607:T:A	14	0	15	15	0	1.0	1.0	0.0
9:15784633:A:G	3	2	3	1	2	1	0	1
9:17340866:C:T	0	0	0	0	0	0	0	0
9:17394998:T:C	0	0	0	0	0	0	0	0
9:17409368:G:A	0	0	0	0	0	0	0	0
9:18622276:G:A	0	0	0	0	0	0	0	0
9:18718116:A:C	0	0	0	0	0	0	0	0
9:18829954:A:G	0	0	0	0	0	0	0	0
9:18928212:G:A	0	0	0	0	0	0	0	0
9:18950789:G:A	0	0	0	0	0	0	0	0
9:18950897:T:C	1	1	2	0	2	2	0	2
9:19341047:A:G	3	1	3	2	1	1	1	0
9:19516092:C:G	0	0	0	0	0	0	0	0
9:19622270:T:C	0	0	0	0	0	0	0	0
9:20786995:G:C	0	0	0	0	0	0	0	0
9:20953050:A:G	0	0	0	0	0	0	0	0
9:20988427:A:G	0	0	0	0	0	0	0	0
9:21187312:C:T	0	0	0	0	0	0	0	0
9:21695894:A:G	0	0	0	0	0	0	0	0
9:22447656:T:A	0	0	0	0	0	0	0	0
9:24545515:G:A	0	0	0	0	0	0	0	0
9:24545959:G:C	0	0	0	0	0	0	0	0
9:26995789:G:A	0	0	0	0	0	0	0	0
9:27009102:T:C	3	2	5	2	3	2	0	1
9:27220068:G:A	0	0	0	0	0	0	0	0
9:27608587:G:C	0	0	0	0	0	0	0	0
9:27609281:T:C	0	0	0	0	0	0	0	0
9:30689773:A:G	0	0	0	0	0	0	0	0
9:30689790:A:G	0	0	0	0	0	0	0	0
9:30689858:C:T	0	0	0	0	0	0	0	0
9:30774208:A:T	0	0	0	0	0	0	0	0
9:30799997:C:G	0	0	0	0	0	0	0	0
9:32425912:A:G	3	3	5	0	5	1	0	1
9:32450189:T:C	2	1	2	1	1	1.0	0.5	0.5
9:32459452:T:G	26	13	38	23	15	1.0	0.5	0.5
9:32526148:G:A	164	77	236	126	110	1.0	1.0	0.0
9:32541534:A:G	17	6	17	11	6	1	1	0
9:32542206:A:G	18	5	19	13	6	1.0	1.0	0.0
9:32635391:C:T	1	0	1	1	0	1	1	0
9:32973779:C:T	1	1	3	0	3	3	0	3
9:33001443:G:A	70	26	254	176	78	3.0	1.5	0.0
9:33465786:G:A	2	2	2	0	2	1.0	0.0	1.0
9:33618360:A:G	0	0	0	0	0	0	0	0
9:33625084:G:C	0	0	0	0	0	0	0	0
9:33625187:C:T	2	0	2	2	0	1.0	1.0	0.0
9:33649385:C:A	0	0	0	0	0	0	0	0
9:33941761:T:C	4	2	5	3	2	1.0	0.5	0.5
9:34017108:C:T	60	28	124	59	65	1.0	1.0	0.0
9:34133441:C:A	0	0	0	0	0	0	0	0
9:34133499:G:C	0	0	0	0	0	0	0	0
9:34133603:T:C	0	0	0	0	0	0	0	0
9:34133636:G:A	0	0	0	0	0	0	0	0
9:34256349:C:T	0	0	0	0	0	0	0	0
9:34257097:G:A	1	1	1	0	1	1	0	1
9:34311022:T:C	0	0	0	0	0	0	0	0
9:34372338:G:A	0	0	0	0	0	0	0	0
9:34379694:C:T	6	1	12	11	1	1.0	1.0	0.0
9:34382728:A:G	0	0	0	0	0	0	0	0
9:34725050:C:T	0	0	0	0	0	0	0	0
9:34725072:T:A	0	0	0	0	0	0	0	0
9:34834497:C:T	0	0	0	0	0	0	0	0
9:34835276:A:C	0	0	0	0	0	0	0	0
9:35059804:G:A	3	2	6	1	5	2	0	2
9:35074920:T:C	1	1	1	0	1	1	0	1
9:35091883:C:T	0	0	0	0	0	0	0	0
9:35147899:A:G	0	0	0	0	0	0	0	0
9:35147966:C:T	0	0	0	0	0	0	0	0
9:35148206:C:G	0	0	0	0	0	0	0	0
9:35606887:G:A	7	4	7	3	4	1	0	1
9:35616586:A:T	104	67	143	49	94	1.0	0.0	1.0
9:35660993:A:G	9	3	9	6	3	1	1	0
9:35663231:G:C	0	0	0	0	0	0	0	0
9:35674056:G:A	0	0	0	0	0	0	0	0
9:35722178:G:A	22	12	39	19	20	1.0	0.0	1.0
9:35740905:C:T	4	2	8	2	6	1.0	0.5	0.5
9:35870004:T:C	0	0	0	0	0	0	0	0
9:35943650:C:T	0	0	0	0	0	0	0	0
9:35943786:T:C	0	0	0	0	0	0	0	0
9:35957358:G:A	0	0	0	0	0	0	0	0
9:35957672:T:C	0	0	0	0	0	0	0	0
9:35958050:T:C	0	0	0	0	0	0	0	0
9:36105267:A:G	0	0	0	0	0	0	0	0
9:36169497:G:A	0	0	0	0	0	0	0	0
9:36169601:T:C	0	0	0	0	0	0	0	0
9:36169726:G:A	0	0	0	0	0	0	0	0
9:36303539:G:A	0	0	0	0	0	0	0	0
9:37305612:C:T	127	61	171	91	80	1	1	0
9:37486606:A:G	2	1	3	1	2	1.5	0.5	1.0
9:37490561:T:C	0	0	0	0	0	0	0	0
9:37692657:A:C	1	0	3	3	0	3	3	0
9:37729789:C:T	0	0	0	0	0	0	0	0
9:37740640:T:C	0	0	0	0	0	0	0	0
9:37782114:C:T	3	1	3	2	1	1	1	0
9:37888104:C:T	4	3	4	1	3	1.0	0.0	1.0
9:37974746:T:C	0	0	0	0	0	0	0	0
9:38396505:G:A	2	1	2	1	1	1.0	0.5	0.5
9:38571133:C:A	0	0	0	0	0	0	0	0
9:39078846:A:G	0	0	0	0	0	0	0	0
9:39809758:C:G	282	275	571	9	562	1.0	0.0	1.0
9:40223596:A:G	0	0	0	0	0	0	0	0
9:40883716:G:A	1	0	1	1	0	1	1	0
9:41044504:A:G	2	0	3	3	0	1.5	1.5	0.0
9:41044513:A:G	2	0	3	3	0	1.5	1.5	0.0
9:41044583:T:C	0	0	0	0	0	0	0	0
9:41074407:C:T	0	0	0	0	0	0	0	0
9:42852700:G:A	0	0	0	0	0	0	0	0
9:63318499:G:A	0	0	0	0	0	0	0	0
9:63379956:G:A	0	0	0	0	0	0	0	0
9:63379977:T:C	0	0	0	0	0	0	0	0
9:63762554:G:A	0	0	0	0	0	0	0	0
9:63762561:C:T	0	0	0	0	0	0	0	0
9:63762568:G:A	0	0	0	0	0	0	0	0
9:65719983:C:T	2	0	2	2	0	1.0	1.0	0.0
9:65737974:G:T	0	0	0	0	0	0	0	0
9:66919504:G:A	1	1	1	0	1	1	0	1
9:66976959:C:A	0	0	0	0	0	0	0	0
9:68610012:C:A	0	0	0	0	0	0	0	0
9:69228107:C:A	1	1	2	0	2	2	0	2
9:69388120:T:C	0	0	0	0	0	0	0	0
9:69902377:G:T	0	0	0	0	0	0	0	0
9:70126331:C:T	0	0	0	0	0	0	0	0
9:70126382:G:A	0	0	0	0	0	0	0	0
9:70413226:C:A	247	133	266	128	138	1	1	1
9:70846421:T:A	0	0	0	0	0	0	0	0
9:70917241:G:A	5	0	5	5	0	1	1	0
9:71718054:G:A	5	3	13	6	7	1	0	1
9:71745479:T:C	19	10	58	29	29	1	0	1
9:72007937:G:A	2	0	3	3	0	1.5	1.5	0.0
9:72008025:G:T	6	0	6	6	0	1.0	1.0	0.0
9:72056803:T:C	1	1	2	0	2	2	0	2
9:72149504:C:T	0	0	0	0	0	0	0	0
9:72655917:A:T	0	0	0	0	0	0	0	0
9:72816160:C:T	0	0	0	0	0	0	0	0
9:74761717:A:G	0	0	0	0	0	0	0	0
9:74761731:T:C	0	0	0	0	0	0	0	0
9:74792720:C:T	0	0	0	0	0	0	0	0
9:74821725:G:A	0	0	0	0	0	0	0	0
9:74827700:C:T	0	0	0	0	0	0	0	0
9:75069774:A:C	2	1	2	1	1	1.0	0.5	0.5
9:75078400:C:T	4	1	4	3	1	1.0	1.0	0.0
9:76159037:G:A	0	0	0	0	0	0	0	0
9:76239000:G:C	0	0	0	0	0	0	0	0
9:76328040:A:G	0	0	0	0	0	0	0	0
9:76354143:C:A	0	0	0	0	0	0	0	0
9:76502835:A:G	0	0	0	0	0	0	0	0
9:76503413:G:A	0	0	0	0	0	0	0	0
9:76644769:C:T	0	0	0	0	0	0	0	0
9:77405970:T:C	6	4	6	2	4	1.0	0.0	1.0
9:77425652:A:G	0	0	0	0	0	0	0	0
9:77434382:C:T	0	0	0	0	0	0	0	0
9:78179199:T:C	0	0	0	0	0	0	0	0
9:78180500:T:C	0	0	0	0	0	0	0	0
9:78236434:G:C	25	13	25	12	13	1	0	1
9:78297199:G:C	5	1	9	8	1	1	1	0
9:79391690:C:T	0	0	0	0	0	0	0	0
9:81915451:A:G	0	0	0	0	0	0	0	0
9:81915497:A:C	0	0	0	0	0	0	0	0
9:81992843:T:A	0	0	0	0	0	0	0	0
9:81994142:C:T	0	0	0	0	0	0	0	0
9:81994998:C:T	0	0	0	0	0	0	0	0
9:83012493:G:A	0	0	0	0	0	0	0	0
9:83663998:C:T	24	9	48	35	13	1.5	1.0	0.0
9:83669263:C:A	14	8	21	10	11	1.0	0.0	1.0
9:83850216:T:C	2	1	5	3	2	2.5	1.5	1.0
9:83859200:T:C	3	1	7	4	3	2	2	0
9:83903881:T:C	1	1	1	0	1	1	0	1
9:86345023:C:T	23	14	33	13	20	1	0	1
9:87525315:AG:CC	0	0	0	0	0	0	0	0
9:87650100:C:T	0	0	0	0	0	0	0	0
9:87858575:T:C	0	0	0	0	0	0	0	0
9:87858717:G:A	0	0	0	0	0	0	0	0
9:87886533:C:A	0	0	0	0	0	0	0	0
9:87887543:T:A	0	0	0	0	0	0	0	0
9:87887904:T:C	0	0	0	0	0	0	0	0
9:87888092:A:G	0	0	0	0	0	0	0	0
9:87888536:G:A	0	0	0	0	0	0	0	0
9:87921037:C:G	0	0	0	0	0	0	0	0
9:87973988:C:T	0	0	0	0	0	0	0	0
9:88016582:T:C	0	0	0	0	0	0	0	0
9:88325143:G:A	0	0	0	0	0	0	0	0
9:88647578:AG:CT	0	0	0	0	0	0	0	0
9:89450455:T:C	0	0	0	0	0	0	0	0
9:89450567:C:T	0	0	0	0	0	0	0	0
9:90751960:G:A	0	0	0	0	0	0	0	0
9:91724406:G:A	0	0	0	0	0	0	0	0
9:91737515:A:G	0	0	0	0	0	0	0	0
9:92104915:G:A	0	0	0	0	0	0	0	0
9:92136701:G:A	0	0	0	0	0	0	0	0
9:92305764:C:T	21	12	22	9	13	1	0	1
9:92512056:A:G	0	0	0	0	0	0	0	0
9:92517703:C:A	0	0	0	0	0	0	0	0
9:92522700:T:G	0	0	0	0	0	0	0	0
9:92837543:G:A	28	12	88	45	43	2.0	1.0	0.0
9:92837566:C:T	33	12	115	61	54	2	1	0
9:92882738:A:C	0	0	0	0	0	0	0	0
9:92885245:C:A	0	0	0	0	0	0	0	0
9:92885692:G:C	0	0	0	0	0	0	0	0
9:92886148:C:T	0	0	0	0	0	0	0	0
9:92886159:C:T	0	0	0	0	0	0	0	0
9:92887825:A:G	0	0	0	0	0	0	0	0
9:92976499:C:A	37	18	41	23	18	1	1	0
9:93125038:G:T	9	3	10	6	4	1	1	0
9:93252974:C:T	0	0	0	0	0	0	0	0
9:93259030:G:A	0	0	0	0	0	0	0	0
9:93261900:G:A	0	0	0	0	0	0	0	0
9:93335465:C:T	0	0	0	0	0	0	0	0
9:93450864:T:A	2	1	5	4	1	2.5	2.0	0.5
9:93476296:C:T	8	5	9	3	6	1.0	0.0	1.0
9:93667157:G:A	4	2	7	4	3	1.5	0.5	0.5
9:93676737:C:A	4	3	4	1	3	1.0	0.0	1.0
9:93679273:C:T	4	2	4	2	2	1.0	0.5	0.5
9:93952209:C:G	0	0	0	0	0	0	0	0
9:94287723:A:G	0	0	0	0	0	0	0	0
9:94293028:C:T	69	35	136	61	75	1	1	1
9:94300013:C:T	1	0	1	1	0	1	1	0
9:94498088:T:C	0	0	0	0	0	0	0	0
9:94603438:T:C	0	0	0	0	0	0	0	0
9:95006004:T:C	0	0	0	0	0	0	0	0
9:95413362:T:G	0	0	0	0	0	0	0	0
9:95447312:G:A	0	0	0	0	0	0	0	0
9:95476076:G:A	0	0	0	0	0	0	0	0
9:96244296:T:C	0	0	0	0	0	0	0	0
9:96302143:T:C	0	0	0	0	0	0	0	0
9:96937203:G:C	0	0	0	0	0	0	0	0
9:97162752:A:T	0	0	0	0	0	0	0	0
9:97287688:GTA:CTC	2	1	5	4	1	2.5	2.0	0.5
9:97308069:G:C	5	4	18	1	17	1	0	1
9:97309446:G:A	1	0	1	1	0	1	1	0
9:97312164:C:T	1	1	1	0	1	1	0	1
9:97343500:C:G	3	0	5	5	0	1	1	0
9:97360009:T:C	0	0	0	0	0	0	0	0
9:97376879:A:G	2	2	2	0	2	1.0	0.0	1.0
9:97625837:G:T	0	0	0	0	0	0	0	0
9:97633890:G:A	66	30	128	74	54	1.0	1.0	0.0
9:97697296:T:C	65	35	87	38	49	1	0	1
9:97700598:G:A	0	0	0	0	0	0	0	0
9:97855093:T:C	0	0	0	0	0	0	0	0
9:97922437:A:C	143	91	288	105	183	1	0	1
9:98060802:T:C	302	180	390	170	220	1.0	0.0	1.0
9:98060853:G:C	276	170	333	136	197	1.0	0.0	1.0
9:98209066:T:C	1	1	3	0	3	3	0	3
9:98306298:G:A	0	0	0	0	0	0	0	0
9:98306367:G:A	0	0	0	0	0	0	0	0
9:99035397:C:G	0	0	0	0	0	0	0	0
9:99059938:C:T	0	0	0	0	0	0	0	0
9:99305776:A:G	0	0	0	0	0	0	0	0
9:99915307:T:C	242	116	277	133	144	1.0	1.0	0.0
9:100292669:T:C	0	0	0	0	0	0	0	0
9:100352511:G:C	6	3	19	4	15	1.0	0.5	0.5
9:100586352:G:A	0	0	0	0	0	0	0	0
9:100976127:A:G	0	0	0	0	0	0	0	0
9:101185528:T:G	0	0	0	0	0	0	0	0
9:101368187:C:G	1	1	3	0	3	3	0	3
9:101371346:C:T	0	0	0	0	0	0	0	0
9:101408068:A:G	6	4	11	3	8	1.5	0.0	1.0
9:101421740:G:A	0	0	0	0	0	0	0	0
9:101594777:G:C	0	0	0	0	0	0	0	0
9:101623429:CA:TG	0	0	0	0	0	0	0	0
9:101670591:T:G	0	0	0	0	0	0	0	0
9:101670752:A:G	0	0	0	0	0	0	0	0
9:101670953:C:T	0	0	0	0	0	0	0	0
9:101686816:C:T	0	0	0	0	0	0	0	0
9:102643133:G:A	0	0	0	0	0	0	0	0
9:104134528:G:A	2	0	2	2	0	1.0	1.0	0.0
9:104504493:C:G	0	0	0	0	0	0	0	0
9:104504563:A:G	0	0	0	0	0	0	0	0
9:104504662:G:A	0	0	0	0	0	0	0	0
9:104505023:C:T	0	0	0	0	0	0	0	0
9:104569223:C:A	0	0	0	0	0	0	0	0
9:104598570:T:C	0	0	0	0	0	0	0	0
9:104598641:A:G	0	0	0	0	0	0	0	0
9:104598848:C:T	0	0	0	0	0	0	0	0
9:104599158:G:C	0	0	0	0	0	0	0	0
9:104599179:G:A	0	0	0	0	0	0	0	0
9:104604727:T:C	0	0	0	0	0	0	0	0
9:104605331:C:T	0	0	0	0	0	0	0	0
9:104617934:T:A	0	0	0	0	0	0	0	0
9:104618133:C:A	0	0	0	0	0	0	0	0
9:104694652:C:T	0	0	0	0	0	0	0	0
9:104722575:A:G	0	0	0	0	0	0	0	0
9:104770894:C:G	1	1	1	0	1	1	0	1
9:104816248:T:C	5	4	6	1	5	1	0	1
9:104858586:C:T	3	2	4	2	2	1	0	1
9:104861748:C:T	11	5	27	9	18	1	1	0
9:104903697:C:G	75	27	86	56	30	1	1	0
9:105520574:A:G	0	0	0	0	0	0	0	0
9:105521784:A:G	0	0	0	0	0	0	0	0
9:105522418:G:A	1	0	1	1	0	1	1	0
9:105525779:T:G	1	1	1	0	1	1	0	1
9:105604453:G:A	4	4	6	0	6	1.0	0.0	1.0
9:105618074:C:A	2	0	11	11	0	5.5	5.5	0.0
9:105710577:A:T	2	1	8	6	2	4.0	3.0	1.0
9:106924539:C:T	0	0	0	0	0	0	0	0
9:106927578:T:C	0	0	0	0	0	0	0	0
9:106929395:A:G	0	0	0	0	0	0	0	0
9:108891294:C:G	6	3	6	3	3	1.0	0.5	0.5
9:108901474:G:A	1	0	1	1	0	1	1	0
9:108901513:C:T	1	0	1	1	0	1	1	0
9:108916228:C:T	8	3	13	9	4	1.0	1.0	0.0
9:108917660:T:C	4	1	5	4	1	1.0	1.0	0.0
9:108929883:G:A	9	4	22	9	13	2	1	0
9:108934515:C:T	19	8	25	13	12	1	1	0
9:108992728:C:T	9	0	22	22	0	2	2	0
9:109119576:T:C	20	9	23	14	9	1.0	1.0	0.0
9:109457194:C:G	0	0	0	0	0	0	0	0
9:109533503:T:C	0	0	0	0	0	0	0	0
9:110137919:T:C	33	19	100	35	65	2	0	1
9:110201129:C:T	0	0	0	0	0	0	0	0
9:110256475:T:C	327	141	354	208	146	1	1	0
9:110787888:T:C	0	0	0	0	0	0	0	0
9:110875574:G:A	0	0	0	0	0	0	0	0
9:111327999:A:G	0	0	0	0	0	0	0	0
9:111412135:T:C	1	1	1	0	1	1	0	1
9:111597344:C:A	2	0	2	2	0	1.0	1.0	0.0
9:111603814:G:C	0	0	0	0	0	0	0	0
9:111609213:C:T	0	0	0	0	0	0	0	0
9:111609310:G:A	0	0	0	0	0	0	0	0
9:111609344:A:C	0	0	0	0	0	0	0	0
9:112486443:G:A	16	5	35	28	7	2.0	1.0	0.0
9:113056669:A:T	5	0	5	5	0	1	1	0
9:113162824:C:T	1	1	1	0	1	1	0	1
9:113169412:A:G	7	3	7	4	3	1	1	0
9:113169423:G:A	7	4	10	3	7	1	0	1
9:113188426:A:C	5	1	6	4	2	1	1	0
9:113206517:C:T	52	23	76	40	36	1.0	1.0	0.0
9:113373918:C:T	6	5	6	1	5	1.0	0.0	1.0
9:113424264:A:G	0	0	0	0	0	0	0	0
9:113517600:T:C	1	0	4	4	0	4	4	0
9:113583838:G:A	2	0	2	2	0	1.0	1.0	0.0
9:113583956:G:A	3	0	3	3	0	1	1	0
9:113594093:G:C	0	0	0	0	0	0	0	0
9:113594496:C:T	2	0	11	11	0	5.5	5.5	0.0
9:114047924:G:A	0	0	0	0	0	0	0	0
9:114049804:C:T	0	0	0	0	0	0	0	0
9:114168819:G:A	0	0	0	0	0	0	0	0
9:114209485:A:G	0	0	0	0	0	0	0	0
9:114210993:C:T	0	0	0	0	0	0	0	0
9:114217772:C:T	0	0	0	0	0	0	0	0
9:114217809:T:C	0	0	0	0	0	0	0	0
9:114240237:C:T	0	0	0	0	0	0	0	0
9:114270742:T:C	0	0	0	0	0	0	0	0
9:114359560:A:C	6	3	7	4	3	1.0	0.5	0.5
9:114359922:C:T	20	7	34	19	15	1.0	1.0	0.0
9:114362451:G:A	20	10	32	12	20	1.0	0.5	0.5
9:114403926:G:T	1	1	1	0	1	1	0	1
9:114407961:G:C	3	1	6	5	1	1	1	0
9:114424432:C:T	0	0	0	0	0	0	0	0
9:115030304:C:G	0	0	0	0	0	0	0	0
9:115046506:T:A	0	0	0	0	0	0	0	0
9:116425560:C:T	0	0	0	0	0	0	0	0
9:116728998:C:T	0	0	0	0	0	0	0	0
9:116976736:G:A	0	0	0	0	0	0	0	0
9:117008201:C:T	0	0	0	0	0	0	0	0
9:119167297:T:C	0	0	0	0	0	0	0	0
9:119238722:G:A	0	0	0	0	0	0	0	0
9:120787863:T:C	4	2	13	11	2	1.5	1.0	0.5
9:120869767:A:G	2	1	2	1	1	1.0	0.5	0.5
9:121006922:C:T	0	0	0	0	0	0	0	0
9:121017727:G:A	1	0	2	2	0	2	2	0
9:121020021:G:A	1	0	1	1	0	1	1	0
9:121021656:T:C	1	1	1	0	1	1	0	1
9:121281589:C:T	0	0	0	0	0	0	0	0
9:121519974:C:G	0	0	0	0	0	0	0	0
9:122526754:A:G	0	0	0	0	0	0	0	0
9:122615455:A:G	0	0	0	0	0	0	0	0
9:122628848:C:T	0	0	0	0	0	0	0	0
9:122628962:G:A	0	0	0	0	0	0	0	0
9:122629090:A:G	0	0	0	0	0	0	0	0
9:122629130:A:G	0	0	0	0	0	0	0	0
9:122838747:A:T	0	0	0	0	0	0	0	0
9:122855801:T:G	9	6	16	5	11	1	0	1
9:122890478:G:A	11	5	18	8	10	1	1	0
9:123029544:C:G	1	0	1	1	0	1	1	0
9:123158097:G:A	28	16	53	25	28	1.5	0.0	1.0
9:123370319:C:T	0	0	0	0	0	0	0	0
9:123757789:T:C	69	39	102	42	60	1	0	1
9:124854258:A:G	0	0	0	0	0	0	0	0
9:124881177:T:C	4	0	9	9	0	1.0	1.0	0.0
9:124899366:G:A	0	0	0	0	0	0	0	0
9:125055997:C:T	140	72	244	127	117	1.0	1.0	1.0
9:125200693:G:A	18	8	32	19	13	1.0	1.0	0.0
9:125484507:G:A	15	8	18	10	8	1	0	1
9:126340561:G:A	14	7	22	14	8	1.0	0.5	0.5
9:126395723:G:A	0	0	0	0	0	0	0	0
9:127435135:A:G	2	1	3	1	2	1.5	0.5	1.0
9:127444483:C:T	0	0	0	0	0	0	0	0
9:127457390:C:T	4	2	4	2	2	1.0	0.5	0.5
9:127479887:A:G	5	3	9	3	6	1	0	1
9:127578974:A:G	0	0	0	0	0	0	0	0
9:127712732:T:C	0	0	0	0	0	0	0	0
9:127715489:G:A	13	1	34	29	5	2	2	0
9:127731234:A:G	0	0	0	0	0	0	0	0
9:127733354:C:G	1	1	1	0	1	1	0	1
9:127741791:G:A	27	17	36	17	19	1	0	1
9:128122474:C:T	6	4	7	2	5	1.0	0.0	1.0
9:128176382:C:T	19	8	25	16	9	1	1	0
9:128434416:C:T	0	0	0	0	0	0	0	0
9:128434425:G:A	0	0	0	0	0	0	0	0
9:128523676:A:G	4	1	4	3	1	1.0	1.0	0.0
9:128598471:C:T	13	7	19	9	10	1	0	1
9:128617688:C:T	32	14	37	21	16	1.0	1.0	0.0
9:128626364:C:T	0	0	0	0	0	0	0	0
9:128635200:G:A	7	4	7	3	4	1	0	1
9:128636357:C:T	17	9	20	8	12	1	0	1
9:128640817:A:G	567	271	773	429	344	1	1	0
9:128753268:G:T	4	2	6	4	2	1.0	0.5	0.5
9:128908178:T:C	1	0	1	1	0	1	1	0
9:129084678:T:C	14	8	14	6	8	1.0	0.0	1.0
9:129110977:A:C	0	0	0	0	0	0	0	0
9:129822779:G:A	242	121	309	156	153	1.0	1.0	0.5
9:130286222:G:A	0	0	0	0	0	0	0	0
9:130307462:C:A	0	0	0	0	0	0	0	0
9:130678606:C:T	0	0	0	0	0	0	0	0
9:130911838:A:G	0	0	0	0	0	0	0	0
9:131036319:C:T	0	0	0	0	0	0	0	0
9:131039183:G:A	0	0	0	0	0	0	0	0
9:131308116:T:C	0	0	0	0	0	0	0	0
9:131474936:C:G	9	2	13	11	2	1	1	0
9:131475071:C:T	6	3	7	4	3	1.0	0.5	0.5
9:131476383:G:A	2	2	3	0	3	1.5	0.0	1.5
9:131510230:G:T	0	0	0	0	0	0	0	0
9:131530684:C:G	5	2	5	3	2	1	1	0
9:131626226:C:T	11	8	18	5	13	1	0	1
9:131629161:C:T	19	10	27	13	14	1	0	1
9:132198490:C:T	0	0	0	0	0	0	0	0
9:132264633:A:G	25	10	25	15	10	1	1	0
9:132398220:C:G	18	12	21	7	14	1.0	0.0	1.0
9:132401620:C:T	19	11	19	8	11	1	0	1
9:132499511:T:C	0	0	0	0	0	0	0	0
9:132888429:C:T	1	1	1	0	1	1	0	1
9:132900647:C:T	1	0	1	1	0	1	1	0
9:133086400:A:G	0	0	0	0	0	0	0	0
9:133086409:C:T	0	0	0	0	0	0	0	0
9:133087190:A:T	0	0	0	0	0	0	0	0
9:133087198:T:C	0	0	0	0	0	0	0	0
9:133098713:G:A	15	12	69	13	56	5	0	3
9:133104364:C:G	1	0	6	6	0	6	6	0
9:133106701:A:C	8	4	23	16	7	2.0	1.0	0.5
9:133108117:T:C	4	2	6	4	2	1.0	0.5	0.5
9:133110409:C:T	30	12	82	57	25	2.0	1.0	0.0
9:133225178:G:A	0	0	0	0	0	0	0	0
9:133255902:C:T	0	0	0	0	0	0	0	0
9:133255929:C:T	0	0	0	0	0	0	0	0
9:133255960:G:A	0	0	0	0	0	0	0	0
9:133256042:C:T	0	0	0	0	0	0	0	0
9:133256050:C:T	0	0	0	0	0	0	0	0
9:133256085:A:T	0	0	0	0	0	0	0	0
9:133259833:GC:AT	0	0	0	0	0	0	0	0
9:133261367:C:A	0	0	0	0	0	0	0	0
9:133262144:C:A	0	0	0	0	0	0	0	0
9:133348787:T:C	4	1	10	9	1	2.0	2.0	0.0
9:133350027:G:A	3159	2753	17627	9070	8557	5	2	2
9:133361130:G:A	2	2	2	0	2	1.0	0.0	1.0
9:133402909:T:C	1	1	2	0	2	2	0	2
9:133412362:T:C	16	9	22	8	14	1.0	0.5	1.0
9:133414815:C:T	25	11	27	16	11	1	1	0
9:133422462:C:T	0	0	0	0	0	0	0	0
9:133426241:C:T	0	0	0	0	0	0	0	0
9:133430112:C:T	0	0	0	0	0	0	0	0
9:133436862:C:G	0	0	0	0	0	0	0	0
9:133439376:G:A	0	0	0	0	0	0	0	0
9:133440409:C:G	0	0	0	0	0	0	0	0
9:133442704:C:T	0	0	0	0	0	0	0	0
9:133454478:G:A	0	0	0	0	0	0	0	0
9:133514768:A:G	0	0	0	0	0	0	0	0
9:133568420:C:T	0	0	0	0	0	0	0	0
9:133570351:C:T	0	0	0	0	0	0	0	0
9:133570435:C:T	0	0	0	0	0	0	0	0
9:133573863:G:A	0	0	0	0	0	0	0	0
9:133639992:A:G	0	0	0	0	0	0	0	0
9:133642351:G:A	0	0	0	0	0	0	0	0
9:133694338:C:T	0	0	0	0	0	0	0	0
9:133696245:G:A	0	0	0	0	0	0	0	0
9:133734024:C:T	0	0	0	0	0	0	0	0
9:133778786:G:A	5	3	5	2	3	1	0	1
9:133778872:T:C	10	7	10	3	7	1.0	0.0	1.0
9:133797806:A:G	1	1	1	0	1	1	0	1
9:134139901:C:T	161	76	179	94	85	1	1	0
9:134701276:C:G	0	0	0	0	0	0	0	0
9:134708857:C:T	0	0	0	0	0	0	0	0
9:134820151:G:C	0	0	0	0	0	0	0	0
9:134822102:C:T	0	0	0	0	0	0	0	0
9:134880818:A:G	0	0	0	0	0	0	0	0
9:134887180:C:T	0	0	0	0	0	0	0	0
9:134917839:C:A	6	2	6	4	2	1.0	1.0	0.0
9:135077105:G:A	0	0	0	0	0	0	0	0
9:135086706:A:G	0	0	0	0	0	0	0	0
9:135344185:A:G	0	0	0	0	0	0	0	0
9:135485126:A:G	1	1	1	0	1	1	0	1
9:135485587:G:A	5	3	7	2	5	1	0	1
9:135485811:T:C	0	0	0	0	0	0	0	0
9:135486007:A:G	0	0	0	0	0	0	0	0
9:135501043:C:A	212	98	229	125	104	1.0	1.0	0.0
9:135548708:G:C	0	0	0	0	0	0	0	0
9:135548716:C:T	0	0	0	0	0	0	0	0
9:135548778:G:C	0	0	0	0	0	0	0	0
9:135548795:T:C	0	0	0	0	0	0	0	0
9:135694451:C:T	0	0	0	0	0	0	0	0
9:135777415:G:A	0	0	0	0	0	0	0	0
9:135939721:T:C	4	1	20	19	1	1.0	1.0	0.0
9:136200552:C:T	1	1	1	0	1	1	0	1
9:136226827:T:C	11	6	13	7	6	1	0	1
9:136358043:G:A	0	0	0	0	0	0	0	0
9:136372044:C:T	1	0	1	1	0	1	1	0
9:136378950:C:T	3	0	3	3	0	1	1	0
9:136380842:G:C	2	1	2	1	1	1.0	0.5	0.5
9:136404141:A:G	23	9	28	18	10	1	1	0
9:136417019:C:T	7	6	7	1	6	1	0	1
9:136430285:C:A	5	2	6	4	2	1	1	0
9:136432582:A:G	2	1	4	1	3	2.0	0.5	1.5
9:136432987:A:G	2	1	4	1	3	2.0	0.5	1.5
9:136468425:G:A	4	3	8	1	7	1.5	0.0	1.5
9:136474501:G:A	1	1	1	0	1	1	0	1
9:136476890:G:A	10	5	36	8	28	2.5	0.5	0.5
9:136476953:G:C	12	7	30	9	21	1.0	0.0	1.0
9:136477334:A:C	7	2	8	6	2	1	1	0
9:136740043:G:A	141	9	442	430	12	2	2	0
9:136740978:C:T	1	0	1	1	0	1	1	0
9:136756167:A:G	0	0	0	0	0	0	0	0
9:136762254:A:C	0	0	0	0	0	0	0	0
9:136796388:G:A	0	0	0	0	0	0	0	0
9:136799144:T:C	8	4	9	4	5	1.0	0.5	0.5
9:136800069:T:G	0	0	0	0	0	0	0	0
9:136800117:A:C	0	0	0	0	0	0	0	0
9:136800370:C:T	1	0	3	3	0	3	3	0
9:136942242:C:T	8	5	9	3	6	1.0	0.0	1.0
9:136969389:C:T	0	0	0	0	0	0	0	0
9:136969457:C:T	0	0	0	0	0	0	0	0
9:137009585:A:G	0	0	0	0	0	0	0	0
9:137050911:G:A	0	0	0	0	0	0	0	0
9:137088416:C:T	1	0	2	2	0	2	2	0
9:137096361:C:T	4	3	4	1	3	1.0	0.0	1.0
9:137108537:T:C	5	2	5	3	2	1	1	0
9:137108975:A:G	6	4	6	2	4	1.0	0.0	1.0
9:137111750:G:A	42	23	69	39	30	1.0	0.0	1.0
9:137111926:G:A	35	18	36	18	18	1	0	1
9:137111973:C:G	36	17	38	19	19	1.0	1.0	0.0
9:137272145:G:A	19	11	25	9	16	1	0	1
9:137367972:C:T	5	4	7	1	6	1	0	1
9:137367974:C:T	5	1	7	6	1	1	1	0
9:137461970:G:C	16	8	16	8	8	1.0	0.5	0.5
9:137498164:G:A	5	3	14	11	3	1	0	1
9:137519958:C:T	8	5	20	5	15	1.0	0.0	1.0
9:137614850:G:T	18	13	18	5	13	1.0	0.0	1.0
9:137744009:T:C	19	10	45	19	26	1	0	1
9:137754290:C:T	8	5	11	3	8	1.0	0.0	1.0
9:137971537:A:T	0	0	0	0	0	0	0	0
9:138114424:C:T	0	0	0	0	0	0	0	0
9:138121810:T:G	0	0	0	0	0	0	0	0
9:138175069:T:C	0	0	0	0	0	0	0	0
9:138175673:C:T	1	0	1	1	0	1	1	0
9:138175831:T:C	1	0	13	13	0	13	13	0
9:138175883:T:G	1	0	12	12	0	12	12	0
9:138177023:C:G	0	0	0	0	0	0	0	0
9:138177100:C:T	0	0	0	0	0	0	0	0
10:86195:C:T	0	0	0	0	0	0	0	0
10:972645:T:G	0	0	0	0	0	0	0	0
10:1035942:T:C	0	0	0	0	0	0	0	0
10:1048966:C:T	45	19	87	48	39	1	1	0
10:1737155:G:A	1	0	1	1	0	1	1	0
10:3138934:C:T	10	5	13	8	5	1.0	0.5	0.5
10:3147188:C:T	9	5	11	4	7	1	0	1
10:3147974:C:A	3	1	3	2	1	1	1	0
10:3148073:A:G	1	1	1	0	1	1	0	1
10:3148106:C:T	1	0	1	1	0	1	1	0
10:3165440:A:G	6	3	6	3	3	1.0	0.5	0.5
10:3779135:A:T	116	57	166	84	82	1.0	1.0	0.0
10:4830695:C:A	0	0	0	0	0	0	0	0
10:4830719:C:T	0	0	0	0	0	0	0	0
10:4830738:G:A	0	0	0	0	0	0	0	0
10:4833399:A:G	0	0	0	0	0	0	0	0
10:4839743:A:G	0	0	0	0	0	0	0	0
10:4842450:T:C	0	0	0	0	0	0	0	0
10:4847540:C:T	0	0	0	0	0	0	0	0
10:4982932:G:A	0	0	0	0	0	0	0	0
10:4995526:A:G	0	0	0	0	0	0	0	0
10:5000472:C:T	0	0	0	0	0	0	0	0
10:5094459:C:G	0	0	0	0	0	0	0	0
10:5132721:C:T	0	0	0	0	0	0	0	0
10:5157733:C:G	0	0	0	0	0	0	0	0
10:5158663:C:A	0	0	0	0	0	0	0	0
10:5161901:C:T	0	0	0	0	0	0	0	0
10:5162965:C:T	0	0	0	0	0	0	0	0
10:5393955:G:A	0	0	0	0	0	0	0	0
10:5394297:A:G	0	0	0	0	0	0	0	0
10:5525403:G:A	0	0	0	0	0	0	0	0
10:5960405:T:G	35	19	61	31	30	1	0	1
10:7559808:G:C	0	0	0	0	0	0	0	0
10:7563105:C:T	0	0	0	0	0	0	0	0
10:7579808:A:G	0	0	0	0	0	0	0	0
10:7717716:G:A	0	0	0	0	0	0	0	0
10:7766123:T:C	0	0	0	0	0	0	0	0
10:7965596:GT:CC	27	9	29	20	9	1	1	0
10:8514189:A:G	0	0	0	0	0	0	0	0
10:8514192:G:A	0	0	0	0	0	0	0	0
10:12089082:T:G	13	6	14	8	6	1	1	0
10:12101106:C:G	14	9	25	13	12	1.0	0.0	1.0
10:12149934:C:T	1	0	1	1	0	1	1	0
10:12167753:T:C	26	16	43	17	26	1.0	0.0	1.0
10:13197651:A:G	0	0	0	0	0	0	0	0
10:13333906:T:C	15	4	19	15	4	1	1	0
10:13591835:A:G	18	1	30	29	1	1.0	1.0	0.0
10:13651883:C:T	0	0	0	0	0	0	0	0
10:14849525:A:G	1	0	1	1	0	1	1	0
10:14899234:C:T	3	2	3	1	2	1	0	1
10:14899655:C:T	4	2	10	3	7	2.0	0.5	1.0
10:14932906:T:C	7	3	14	11	3	1	1	0
10:14966494:A:C	3	1	10	2	8	1	1	0
10:14966555:A:G	3	1	6	3	3	2	1	0
10:14987098:A:C	0	0	0	0	0	0	0	0
10:14999909:C:A	0	0	0	0	0	0	0	0
10:15008689:G:A	0	0	0	0	0	0	0	0
10:15015375:G:A	0	0	0	0	0	0	0	0
10:15071877:G:C	0	0	0	0	0	0	0	0
10:16505059:A:G	2	1	7	6	1	3.5	3.0	0.5
10:16890385:G:A	0	0	0	0	0	0	0	0
10:16925587:C:G	0	0	0	0	0	0	0	0
10:17046007:T:C	0	0	0	0	0	0	0	0
10:17088200:G:A	2	2	2	0	2	1.0	0.0	1.0
10:17105522:G:T	0	0	0	0	0	0	0	0
10:17114152:A:G	1	1	1	0	1	1	0	1
10:17115573:G:A	0	0	0	0	0	0	0	0
10:17123546:G:A	0	0	0	0	0	0	0	0
10:17123553:T:G	1	1	1	0	1	1	0	1
10:17644235:G:A	11	5	12	7	5	1	1	0
10:17644335:C:T	84	51	100	42	58	1.0	0.0	1.0
10:17809387:C:T	0	0	0	0	0	0	0	0
10:17833763:G:A	0	0	0	0	0	0	0	0
10:17833817:T:A	0	0	0	0	0	0	0	0
10:17849701:G:A	0	0	0	0	0	0	0	0
10:18539706:T:G	6	3	23	13	10	2.0	0.5	1.0
10:18539734:G:T	6	3	20	11	9	2.0	0.5	1.0
10:19205064:G:C	0	0	0	0	0	0	0	0
10:19331478:A:C	0	0	0	0	0	0	0	0
10:19331510:A:G	0	0	0	0	0	0	0	0
10:19347940:G:T	0	0	0	0	0	0	0	0
10:19352106:T:C	0	0	0	0	0	0	0	0
10:19389568:G:A	0	0	0	0	0	0	0	0
10:19491622:A:G	0	0	0	0	0	0	0	0
10:19817054:T:G	0	0	0	0	0	0	0	0
10:20819448:C:T	0	0	0	0	0	0	0	0
10:22209280:A:G	0	0	0	0	0	0	0	0
10:22209539:C:T	0	0	0	0	0	0	0	0
10:22318640:T:A	24	12	79	38	41	3.0	0.5	0.5
10:22550699:T:C	11	4	19	12	7	1	1	0
10:23193921:G:A	0	0	0	0	0	0	0	0
10:24275724:C:T	0	0	0	0	0	0	0	0
10:24501464:A:G	0	0	0	0	0	0	0	0
10:24619757:T:C	3	1	6	5	1	2	2	0
10:24670306:G:C	4	0	4	4	0	1.0	1.0	0.0
10:26021541:C:T	0	0	0	0	0	0	0	0
10:26021577:C:T	0	0	0	0	0	0	0	0
10:26021668:G:A	0	0	0	0	0	0	0	0
10:26145526:G:T	0	0	0	0	0	0	0	0
10:26173861:G:A	0	0	0	0	0	0	0	0
10:26270642:G:C	0	0	0	0	0	0	0	0
10:27033377:C:T	0	0	0	0	0	0	0	0
10:27111932:G:A	36	20	38	18	20	1.0	0.0	1.0
10:27170741:C:T	3	2	3	1	2	1	0	1
10:27186515:T:C	5	3	7	4	3	1	0	1
10:27186565:T:C	3	2	3	1	2	1	0	1
10:27219829:T:C	7	3	13	9	4	2	1	0
10:27240620:C:A	17	8	31	17	14	1	1	0
10:27246671:T:C	0	0	0	0	0	0	0	0
10:27250013:T:C	0	0	0	0	0	0	0	0
10:27250578:C:T	0	0	0	0	0	0	0	0
10:27250999:A:G	1	0	1	1	0	1	1	0
10:27251532:C:T	0	0	0	0	0	0	0	0
10:27251654:G:A	0	0	0	0	0	0	0	0
10:27251667:C:T	0	0	0	0	0	0	0	0
10:27675541:G:A	0	0	0	0	0	0	0	0
10:28436788:C:T	0	0	0	0	0	0	0	0
10:29421708:A:T	0	0	0	0	0	0	0	0
10:29458292:G:A	0	0	0	0	0	0	0	0
10:29465680:T:C	0	0	0	0	0	0	0	0
10:29470296:A:G	0	0	0	0	0	0	0	0
10:29480718:G:A	0	0	0	0	0	0	0	0
10:29481622:A:G	1	0	1	1	0	1	1	0
10:29491007:G:A	0	0	0	0	0	0	0	0
10:29545069:A:G	0	0	0	0	0	0	0	0
10:29545074:G:A	0	0	0	0	0	0	0	0
10:29550858:A:G	0	0	0	0	0	0	0	0
10:29551109:A:G	0	0	0	0	0	0	0	0
10:30340207:G:A	1	1	1	0	1	1	0	1
10:30340297:G:A	8	4	17	4	13	1.0	0.5	0.5
10:30364390:T:G	0	0	0	0	0	0	0	0
10:30364473:A:G	0	0	0	0	0	0	0	0
10:30380438:G:A	0	0	0	0	0	0	0	0
10:30380501:G:A	0	0	0	0	0	0	0	0
10:30439172:T:C	100	49	120	68	52	1.0	1.0	0.0
10:30517904:G:C	0	0	0	0	0	0	0	0
10:30612827:G:A	0	0	0	0	0	0	0	0
10:30689448:G:C	0	0	0	0	0	0	0	0
10:30689459:C:T	0	0	0	0	0	0	0	0
10:30697419:G:A	1	0	3	3	0	3	3	0
10:30697435:G:A	1	1	3	0	3	3	0	3
10:30704475:G:A	1	1	1	0	1	1	0	1
10:30845285:A:G	1	1	1	0	1	1	0	1
10:31831750:C:T	4	2	19	12	7	4.5	1.5	0.5
10:31839683:A:G	2	1	9	1	8	4.5	0.5	4.0
10:31852532:T:C	3	1	3	2	1	1	1	0
10:32102577:T:C	5	5	5	0	5	1	0	1
10:32102783:G:A	0	0	0	0	0	0	0	0
10:32102851:T:A	0	0	0	0	0	0	0	0
10:32110329:T:C	0	0	0	0	0	0	0	0
10:32567818:A:C	8	3	8	5	3	1.0	1.0	0.0
10:32911540:G:A	7	6	9	1	8	1	0	1
10:32944725:G:A	0	0	0	0	0	0	0	0
10:33180253:A:G	0	0	0	0	0	0	0	0
10:33206339:C:T	0	0	0	0	0	0	0	0
10:33213312:C:T	0	0	0	0	0	0	0	0
10:33221735:G:A	0	0	0	0	0	0	0	0
10:34331292:C:T	0	0	0	0	0	0	0	0
10:35608197:G:C	0	0	0	0	0	0	0	0
10:36995344:A:G	4	4	4	0	4	1.0	0.0	1.0
10:37216213:G:A	0	0	0	0	0	0	0	0
10:37216264:C:T	0	0	0	0	0	0	0	0
10:37219522:A:C	0	0	0	0	0	0	0	0
10:37602027:G:A	0	0	0	0	0	0	0	0
10:37819248:C:T	1	1	2	0	2	2	0	2
10:37819551:A:G	1	1	2	0	2	2	0	2
10:37820470:G:T	0	0	0	0	0	0	0	0
10:37820645:G:A	0	0	0	0	0	0	0	0
10:37831714:C:T	0	0	0	0	0	0	0	0
10:37831792:C:T	0	0	0	0	0	0	0	0
10:37832017:A:G	0	0	0	0	0	0	0	0
10:37832703:T:C	1	0	1	1	0	1	1	0
10:38055772:C:G	30	15	62	45	17	1.0	0.5	0.5
10:38118591:A:G	1	0	1	1	0	1	1	0
10:38186693:G:A	0	0	0	0	0	0	0	0
10:38356475:T:C	59	2	108	104	4	1	1	0
10:38451425:T:C	0	0	0	0	0	0	0	0
10:38451454:T:C	0	0	0	0	0	0	0	0
10:38696864:A:G	0	0	0	0	0	0	0	0
10:42566985:G:A	0	0	0	0	0	0	0	0
10:42583077:A:G	5	1	6	4	2	1	1	0
10:42593708:C:T	1	0	1	1	0	1	1	0
10:42707867:A:G	0	0	0	0	0	0	0	0
10:42711252:G:T	0	0	0	0	0	0	0	0
10:42714495:G:A	0	0	0	0	0	0	0	0
10:43100520:A:G	0	0	0	0	0	0	0	0
10:43111239:A:G	0	0	0	0	0	0	0	0
10:43118395:G:T	0	0	0	0	0	0	0	0
10:43481535:T:C	11	9	11	2	9	1	0	1
10:43605396:C:A	0	0	0	0	0	0	0	0
10:43605419:T:G	0	0	0	0	0	0	0	0
10:43605716:A:G	0	0	0	0	0	0	0	0
10:43845417:G:A	0	0	0	0	0	0	0	0
10:44414922:A:C	0	0	0	0	0	0	0	0
10:44935014:C:T	0	0	0	0	0	0	0	0
10:44984944:A:G	1	1	2	0	2	2	0	2
10:45000672:A:T	5	2	5	3	2	1	1	0
10:45107052:G:A	0	0	0	0	0	0	0	0
10:45127437:C:T	0	0	0	0	0	0	0	0
10:45140349:T:C	0	0	0	0	0	0	0	0
10:45156803:T:C	0	0	0	0	0	0	0	0
10:45156999:A:G	0	0	0	0	0	0	0	0
10:45157056:T:G	0	0	0	0	0	0	0	0
10:45458319:A:G	3	1	3	2	1	1	1	0
10:45463433:A:G	2	1	5	4	1	2.5	2.0	0.5
10:45463937:G:A	5	4	10	2	8	2	0	1
10:45678880:G:A	0	0	0	0	0	0	0	0
10:45699873:T:G	0	0	0	0	0	0	0	0
10:45962816:C:T	23	11	44	25	19	2	1	0
10:46063455:T:C	0	0	0	0	0	0	0	0
10:46250638:T:G	0	0	0	0	0	0	0	0
10:46549695:C:A	0	0	0	0	0	0	0	0
10:47349321:G:A	0	0	0	0	0	0	0	0
10:47368085:G:A	0	0	0	0	0	0	0	0
10:47368615:G:A	0	0	0	0	0	0	0	0
10:47726888:A:G	0	0	0	0	0	0	0	0
10:48010528:C:T	0	0	0	0	0	0	0	0
10:48010536:C:G	0	0	0	0	0	0	0	0
10:48175933:T:C	0	0	0	0	0	0	0	0
10:48734005:A:T	4	3	8	1	7	2.0	0.0	2.0
10:48817351:G:A	3	2	3	1	2	1	0	1
10:48830755:A:G	11	2	17	14	3	1	1	0
10:48890695:T:A	28	17	29	11	18	1.0	0.0	1.0
10:48901850:A:C	41	23	59	28	31	1	0	1
10:48914064:C:T	0	0	0	0	0	0	0	0
10:49323886:G:A	0	0	0	0	0	0	0	0
10:49616071:G:A	0	0	0	0	0	0	0	0
10:49616573:G:A	0	0	0	0	0	0	0	0
10:49655101:T:C	0	0	0	0	0	0	0	0
10:49708496:C:T	0	0	0	0	0	0	0	0
10:49736483:G:A	0	0	0	0	0	0	0	0
10:49742930:G:A	0	0	0	0	0	0	0	0
10:49752163:G:A	0	0	0	0	0	0	0	0
10:50061509:C:A	0	0	0	0	0	0	0	0
10:50063324:C:G	0	0	0	0	0	0	0	0
10:50068174:G:A	184	98	425	185	240	1.0	0.0	1.0
10:50099998:A:G	11	4	18	10	8	1	1	0
10:50129923:C:A	12	7	16	5	11	1.0	0.0	1.0
10:50265407:A:G	0	0	0	0	0	0	0	0
10:50265722:G:C	0	0	0	0	0	0	0	0
10:50266227:T:C	0	0	0	0	0	0	0	0
10:50266280:A:G	1	1	1	0	1	1	0	1
10:50266295:C:T	2	0	2	2	0	1.0	1.0	0.0
10:50266401:A:G	1	1	1	0	1	1	0	1
10:50266682:C:T	0	0	0	0	0	0	0	0
10:50343947:A:G	0	0	0	0	0	0	0	0
10:50629899:G:A	0	0	0	0	0	0	0	0
10:50659185:A:G	0	0	0	0	0	0	0	0
10:50660246:C:T	0	0	0	0	0	0	0	0
10:50679255:C:T	0	0	0	0	0	0	0	0
10:50684882:C:A	0	0	0	0	0	0	0	0
10:50844114:T:C	0	0	0	0	0	0	0	0
10:51299646:T:C	0	0	0	0	0	0	0	0
10:51698287:A:G	16	5	28	20	8	1.0	1.0	0.0
10:51698407:C:T	14	8	27	19	8	1.0	0.0	1.0
10:51699238:A:G	64	28	65	36	29	1.0	1.0	0.0
10:52411553:C:T	0	0	0	0	0	0	0	0
10:52411946:G:T	0	0	0	0	0	0	0	0
10:53806646:T:G	0	0	0	0	0	0	0	0
10:54195684:T:G	0	0	0	0	0	0	0	0
10:54600066:C:T	0	0	0	0	0	0	0	0
10:56358869:T:C	0	0	0	0	0	0	0	0
10:58813993:G:T	0	0	0	0	0	0	0	0
10:58817633:T:C	0	0	0	0	0	0	0	0
10:58828793:T:C	0	0	0	0	0	0	0	0
10:59283484:G:A	0	0	0	0	0	0	0	0
10:59654253:G:T	0	0	0	0	0	0	0	0
10:60042792:A:T	0	0	0	0	0	0	0	0
10:60205867:A:G	0	0	0	0	0	0	0	0
10:60300370:A:G	0	0	0	0	0	0	0	0
10:62399574:G:T	0	0	0	0	0	0	0	0
10:62479950:A:G	0	0	0	0	0	0	0	0
10:63185604:G:A	34	17	88	44	44	1.0	0.5	0.5
10:63214620:G:C	7	3	7	4	3	1	1	0
10:63634690:GAAA:AAAG	0	0	0	0	0	0	0	0
10:64169784:C:T	0	0	0	0	0	0	0	0
10:64826548:A:G	0	0	0	0	0	0	0	0
10:67874608:A:C	12	1	12	11	1	1.0	1.0	0.0
10:68014084:G:A	7	3	18	15	3	1	1	0
10:68166562:C:A	0	0	0	0	0	0	0	0
10:68166568:C:T	0	0	0	0	0	0	0	0
10:68166577:C:G	0	0	0	0	0	0	0	0
10:68174164:G:A	0	0	0	0	0	0	0	0
10:68174212:G:A	0	0	0	0	0	0	0	0
10:68174501:C:G	0	0	0	0	0	0	0	0
10:68174502:G:A	0	0	0	0	0	0	0	0
10:68211460:G:A	0	0	0	0	0	0	0	0
10:68470579:A:C	0	0	0	0	0	0	0	0
10:68544512:G:A	8	0	8	8	0	1.0	1.0	0.0
10:68572823:A:G	0	0	0	0	0	0	0	0
10:68632380:A:G	1	0	1	1	0	1	1	0
10:68632618:G:A	99	99	140	0	140	1	0	1
10:68882104:T:C	0	0	0	0	0	0	0	0
10:68884316:G:A	0	0	0	0	0	0	0	0
10:68941188:A:G	15	10	16	6	10	1	0	1
10:69023494:G:T	0	0	0	0	0	0	0	0
10:69023568:T:C	0	0	0	0	0	0	0	0
10:69338620:T:G	1	0	1	1	0	1	1	0
10:69485189:G:A	0	0	0	0	0	0	0	0
10:69630636:C:T	0	0	0	0	0	0	0	0
10:69630637:A:G	0	0	0	0	0	0	0	0
10:69631782:T:C	4	3	5	1	4	1.0	0.0	1.0
10:69802681:G:A	0	0	0	0	0	0	0	0
10:70283704:T:G	0	0	0	0	0	0	0	0
10:70435683:T:C	0	0	0	0	0	0	0	0
10:70566644:G:A	0	0	0	0	0	0	0	0
10:70598899:G:A	1	1	1	0	1	1	0	1
10:70753879:C:A	0	0	0	0	0	0	0	0
10:70753926:C:T	0	0	0	0	0	0	0	0
10:70760503:C:T	0	0	0	0	0	0	0	0
10:70772281:C:T	0	0	0	0	0	0	0	0
10:70854767:A:G	1	0	2	2	0	2	2	0
10:70883914:C:T	125	53	142	82	60	1	1	0
10:71322806:A:G	19	12	21	7	14	1	0	1
10:71511149:T:C	0	0	0	0	0	0	0	0
10:71675131:G:C	0	0	0	0	0	0	0	0
10:71675149:G:A	0	0	0	0	0	0	0	0
10:71713111:C:G	0	0	0	0	0	0	0	0
10:71713125:C:T	0	0	0	0	0	0	0	0
10:71751283:G:A	6	2	6	4	2	1.0	1.0	0.0
10:71773420:A:G	194	112	370	140	230	1.0	0.0	1.0
10:71790360:C:G	0	0	0	0	0	0	0	0
10:71809992:C:T	2	0	5	5	0	2.5	2.5	0.0
10:72097226:A:G	10	6	13	4	9	1.0	0.0	1.0
10:72190054:T:G	0	0	0	0	0	0	0	0
10:72533034:T:G	2	2	3	0	3	1.5	0.0	1.5
10:73713294:G:A	2	1	7	2	5	3.5	1.0	2.5
10:73799109:G:A	9	4	9	5	4	1	1	0
10:73873002:C:T	364	193	541	288	253	1.0	1.0	1.0
10:73913343:T:C	0	0	0	0	0	0	0	0
10:75089299:G:C	0	0	0	0	0	0	0	0
10:75094806:C:T	0	0	0	0	0	0	0	0
10:75095654:G:A	0	0	0	0	0	0	0	0
10:75101922:T:C	0	0	0	0	0	0	0	0
10:75108141:T:C	0	0	0	0	0	0	0	0
10:75407668:T:C	0	0	0	0	0	0	0	0
10:76889641:C:T	0	0	0	0	0	0	0	0
10:77184832:G:A	1	1	1	0	1	1	0	1
10:77733339:G:T	0	0	0	0	0	0	0	0
10:77817014:G:A	0	0	0	0	0	0	0	0
10:77867019:C:A	0	0	0	0	0	0	0	0
10:79285523:T:C	0	0	0	0	0	0	0	0
10:79296446:C:G	0	0	0	0	0	0	0	0
10:79557180:T:C	0	0	0	0	0	0	0	0
10:79557289:G:T	0	0	0	0	0	0	0	0
10:79611942:C:T	0	0	0	0	0	0	0	0
10:79892510:G:A	0	0	0	0	0	0	0	0
10:79892613:C:T	0	0	0	0	0	0	0	0
10:79892964:A:C	1	1	1	0	1	1	0	1
10:79893047:A:G	0	0	0	0	0	0	0	0
10:79946525:A:G	0	0	0	0	0	0	0	0
10:80081936:G:T	202	108	268	127	141	1.0	0.0	1.0
10:80166946:G:A	69	43	100	40	60	1	0	1
10:80251516:G:A	0	0	0	0	0	0	0	0
10:80252843:T:C	0	0	0	0	0	0	0	0
10:80252992:G:A	0	0	0	0	0	0	0	0
10:80253198:A:G	0	0	0	0	0	0	0	0
10:80253211:G:T	0	0	0	0	0	0	0	0
10:80253363:G:A	0	0	0	0	0	0	0	0
10:80253390:T:C	0	0	0	0	0	0	0	0
10:80275086:A:G	0	0	0	0	0	0	0	0
10:80275098:T:C	0	0	0	0	0	0	0	0
10:80280296:A:G	0	0	0	0	0	0	0	0
10:82985170:C:A	0	0	0	0	0	0	0	0
10:82985284:A:G	0	0	0	0	0	0	0	0
10:82985500:C:T	0	0	0	0	0	0	0	0
10:84245109:C:T	0	0	0	0	0	0	0	0
10:84245117:T:C	0	0	0	0	0	0	0	0
10:84252957:C:T	0	0	0	0	0	0	0	0
10:84258704:A:G	0	0	0	0	0	0	0	0
10:84371303:A:G	10	7	10	3	7	1.0	0.0	1.0
10:84389279:G:A	0	0	0	0	0	0	0	0
10:84391304:T:G	1	0	6	6	0	6	6	0
10:84391385:C:G	2	2	14	0	14	7.0	0.0	7.0
10:84391508:A:G	2	0	8	8	0	4.0	4.0	0.0
10:84560656:C:T	25	0	26	26	0	1	1	0
10:86138972:G:A	0	0	0	0	0	0	0	0
10:86631345:T:C	0	0	0	0	0	0	0	0
10:86631548:C:T	0	0	0	0	0	0	0	0
10:86665798:C:A	0	0	0	0	0	0	0	0
10:86876022:C:A	1	1	6	0	6	6	0	6
10:86942593:G:C	0	0	0	0	0	0	0	0
10:86942633:G:A	0	0	0	0	0	0	0	0
10:86945549:T:G	0	0	0	0	0	0	0	0
10:86957383:T:A	0	0	0	0	0	0	0	0
10:86960032:C:G	0	0	0	0	0	0	0	0
10:86962641:A:T	0	0	0	0	0	0	0	0
10:86962716:T:G	0	0	0	0	0	0	0	0
10:87008496:A:G	1	0	1	1	0	1	1	0
10:87008900:C:T	0	0	0	0	0	0	0	0
10:87152084:A:G	3	0	3	3	0	1	1	0
10:87367434:T:C	0	0	0	0	0	0	0	0
10:87961150:T:G	4	3	4	1	3	1.0	0.0	1.0
10:88913267:G:A	18	8	19	11	8	1.0	1.0	0.0
10:89206789:C:T	0	0	0	0	0	0	0	0
10:89207239:C:G	0	0	0	0	0	0	0	0
10:89247603:T:G	203	109	249	111	138	1	0	1
10:89306192:A:C	126	72	147	67	80	1.0	0.0	1.0
10:89306318:A:G	14	6	14	8	6	1.0	1.0	0.0
10:89306703:T:A	3	3	3	0	3	1	0	1
10:89307012:C:A	3	1	4	3	1	1	1	0
10:89339873:T:C	11	4	13	9	4	1	1	0
10:89418243:C:T	4	1	4	3	1	1.0	1.0	0.0
10:89644691:C:G	6	2	14	11	3	1.5	1.0	0.0
10:89737874:T:A	2	1	2	1	1	1.0	0.5	0.5
10:89738370:T:C	9	3	11	8	3	1	1	0
10:89738497:A:G	15	10	16	6	10	1	0	1
10:89738561:A:G	20	15	25	6	19	1.0	0.0	1.0
10:90872021:G:A	37	17	45	23	22	1	1	0
10:90912807:T:C	0	0	0	0	0	0	0	0
10:92240093:A:G	6	5	6	1	5	1.0	0.0	1.0
10:92669710:C:T	13	10	25	3	22	2	0	2
10:92899698:A:G	3	1	3	2	1	1	1	0
10:93284361:C:T	2	0	2	2	0	1.0	1.0	0.0
10:93323125:G:A	0	0	0	0	0	0	0	0
10:93323137:G:A	0	0	0	0	0	0	0	0
10:93336035:A:G	0	0	0	0	0	0	0	0
10:93351248:T:C	0	0	0	0	0	0	0	0
10:93408877:A:G	0	0	0	0	0	0	0	0
10:93500222:C:G	0	0	0	0	0	0	0	0
10:93519749:A:T	0	0	0	0	0	0	0	0
10:93566919:C:T	0	0	0	0	0	0	0	0
10:93567188:A:G	0	0	0	0	0	0	0	0
10:93622016:T:A	0	0	0	0	0	0	0	0
10:93635607:C:G	0	0	0	0	0	0	0	0
10:93673367:A:G	0	0	0	0	0	0	0	0
10:93681515:G:A	43	22	50	25	25	1	0	1
10:93700060:C:T	233	75	361	251	110	1	1	0
10:94298541:C:T	1	1	5	0	5	5	0	5
10:94306584:A:G	0	0	0	0	0	0	0	0
10:95067421:T:C	0	0	0	0	0	0	0	0
10:95184087:C:T	4	2	12	7	5	3.0	1.5	1.0
10:95194541:A:G	0	0	0	0	0	0	0	0
10:95194603:T:A	0	0	0	0	0	0	0	0
10:95595034:G:A	0	0	0	0	0	0	0	0
10:95595157:C:T	0	0	0	0	0	0	0	0
10:95626740:G:T	5	4	5	1	4	1	0	1
10:95685600:C:A	3	1	3	2	1	1	1	0
10:95938613:C:T	1	0	1	1	0	1	1	0
10:96012601:A:G	0	0	0	0	0	0	0	0
10:96158086:C:T	3	2	3	1	2	1	0	1
10:96159793:T:G	1	0	1	1	0	1	1	0
10:96160082:A:T	3	0	6	6	0	1	1	0
10:96373726:G:A	0	0	0	0	0	0	0	0
10:96397249:G:A	2	1	4	1	3	2.0	0.5	1.5
10:96432835:G:A	0	0	0	0	0	0	0	0
10:96527504:G:C	0	0	0	0	0	0	0	0
10:96560684:T:C	0	0	0	0	0	0	0	0
10:96609779:A:G	20	10	42	30	12	1.0	0.5	0.5
10:96620380:T:C	27	15	36	13	23	1	0	1
10:96620520:C:T	26	13	57	30	27	1.0	0.5	0.5
10:96983480:A:G	9	3	30	26	4	2	2	0
10:97002294:T:G	0	0	0	0	0	0	0	0
10:97057254:G:T	0	0	0	0	0	0	0	0
10:97059560:A:G	0	0	0	0	0	0	0	0
10:97246326:G:A	8	6	30	7	23	3.5	0.0	1.5
10:97309736:G:T	0	0	0	0	0	0	0	0
10:97357146:C:T	6	3	10	7	3	1.0	0.5	0.5
10:97358625:T:C	0	0	0	0	0	0	0	0
10:97366192:C:T	5	1	5	4	1	1	1	0
10:97366492:G:A	6	4	8	2	6	1.0	0.0	1.0
10:97381448:A:G	2	1	2	1	1	1.0	0.5	0.5
10:97381727:C:T	2	1	2	1	1	1.0	0.5	0.5
10:97388218:T:C	0	0	0	0	0	0	0	0
10:97396227:G:A	2	2	2	0	2	1.0	0.0	1.0
10:97400395:A:G	14	6	16	9	7	1.0	1.0	0.0
10:97590260:G:C	0	0	0	0	0	0	0	0
10:97590371:A:G	0	0	0	0	0	0	0	0
10:97599649:C:T	0	0	0	0	0	0	0	0
10:97611587:C:A	1	0	1	1	0	1	1	0
10:97633477:G:A	1	0	1	1	0	1	1	0
10:97651033:T:C	3	1	5	2	3	1	1	0
10:97679784:G:C	3	1	6	5	1	2	2	0
10:97679799:A:C	4	2	7	2	5	1.5	0.5	1.0
10:97738477:G:A	222	88	293	185	108	1.0	1.0	0.0
10:97743140:G:A	26	11	52	26	26	1.0	1.0	0.0
10:97750311:G:T	0	0	0	0	0	0	0	0
10:97936246:G:A	0	0	0	0	0	0	0	0
10:98385025:C:T	3	2	7	1	6	1	0	1
10:98407600:G:A	7	6	7	1	6	1	0	1
10:98407639:G:A	10	1	14	13	1	1.0	1.0	0.0
10:98420094:T:C	23	12	47	28	19	1	1	1
10:98423813:G:C	16	11	34	7	27	1.5	0.0	1.0
10:98429485:G:A	10	8	11	2	9	1.0	0.0	1.0
10:98429495:G:A	9	7	10	2	8	1	0	1
10:98431163:G:A	14	8	24	8	16	1.0	0.0	1.0
10:98435373:G:A	21	11	24	13	11	1	0	1
10:98459557:G:A	0	0	0	0	0	0	0	0
10:98459617:T:A	0	0	0	0	0	0	0	0
10:99535094:G:A	0	0	0	0	0	0	0	0
10:99880039:G:A	1	1	1	0	1	1	0	1
10:99880120:A:C	1	0	1	1	0	1	1	0
10:99885741:T:C	1	0	6	6	0	6	6	0
10:99898123:G:A	2	2	3	0	3	1.5	0.0	1.5
10:99930293:C:T	0	0	0	0	0	0	0	0
10:99930622:A:G	0	0	0	0	0	0	0	0
10:99955398:G:A	1	1	3	0	3	3	0	3
10:99956142:G:A	2	1	2	1	1	1.0	0.5	0.5
10:100152307:T:C	2	0	7	7	0	3.5	3.5	0.0
10:100193948:A:C	0	0	0	0	0	0	0	0
10:100218126:C:T	0	0	0	0	0	0	0	0
10:100296988:C:T	0	0	0	0	0	0	0	0
10:100347494:C:G	4	4	4	0	4	1.0	0.0	1.0
10:100356554:A:C	0	0	0	0	0	0	0	0
10:100924623:C:A	4	1	7	6	1	1.0	1.0	0.0
10:100975021:C:G	0	0	0	0	0	0	0	0
10:100984574:A:T	0	0	0	0	0	0	0	0
10:100986746:C:T	19	8	23	11	12	1	1	0
10:101064592:G:C	0	0	0	0	0	0	0	0
10:102065990:G:A	1	1	1	0	1	1	0	1
10:102139902:A:G	2	2	2	0	2	1.0	0.0	1.0
10:102231624:G:A	0	0	0	0	0	0	0	0
10:102424324:G:A	133	73	166	68	98	1	0	1
10:102425196:C:G	277	159	398	185	213	1	0	1
10:102470028:C:T	4	3	4	1	3	1.0	0.0	1.0
10:102472959:G:A	0	0	0	0	0	0	0	0
10:103458495:A:G	0	0	0	0	0	0	0	0
10:103458602:T:C	0	0	0	0	0	0	0	0
10:103494333:G:T	0	0	0	0	0	0	0	0
10:103602422:G:A	3	2	3	1	2	1	0	1
10:103602530:C:G	1	1	1	0	1	1	0	1
10:104050642:T:C	0	0	0	0	0	0	0	0
10:104060198:G:A	0	0	0	0	0	0	0	0
10:104064575:G:A	0	0	0	0	0	0	0	0
10:104167702:C:T	0	0	0	0	0	0	0	0
10:104263031:C:A	89	46	95	46	49	1	0	1
10:104279427:A:G	1	0	3	3	0	3	3	0
10:104400855:G:A	0	0	0	0	0	0	0	0
10:105147682:C:T	0	0	0	0	0	0	0	0
10:105685692:T:C	0	0	0	0	0	0	0	0
10:109662014:A:G	0	0	0	0	0	0	0	0
10:109680847:A:G	0	0	0	0	0	0	0	0
10:109680961:T:A	0	0	0	0	0	0	0	0
10:110507013:C:T	66	37	100	51	49	1.0	0.0	1.0
10:113610495:A:G	0	0	0	0	0	0	0	0
10:113610515:T:C	0	0	0	0	0	0	0	0
10:113612397:G:A	0	0	0	0	0	0	0	0
10:113615769:C:A	0	0	0	0	0	0	0	0
10:113633160:T:A	0	0	0	0	0	0	0	0
10:113634170:G:A	0	0	0	0	0	0	0	0
10:113634189:C:T	0	0	0	0	0	0	0	0
10:113645856:T:C	0	0	0	0	0	0	0	0
10:113645905:C:T	0	0	0	0	0	0	0	0
10:113650081:C:T	0	0	0	0	0	0	0	0
10:113650475:T:C	0	0	0	0	0	0	0	0
10:113651839:C:A	0	0	0	0	0	0	0	0
10:113651905:C:T	0	0	0	0	0	0	0	0
10:113653034:A:G	0	0	0	0	0	0	0	0
10:113692022:C:T	7	4	7	3	4	1	0	1
10:113780652:T:C	0	0	0	0	0	0	0	0
10:113884281:G:A	4	1	7	4	3	1.5	1.0	0.0
10:114575487:G:A	0	0	0	0	0	0	0	0
10:114855286:T:C	3	1	3	2	1	1	1	0
10:114899494:A:G	0	0	0	0	0	0	0	0
10:114901253:G:A	0	0	0	0	0	0	0	0
10:114959784:G:A	1	0	1	1	0	1	1	0
10:115597659:G:A	0	0	0	0	0	0	0	0
10:116089842:T:C	0	0	0	0	0	0	0	0
10:116664061:G:A	0	0	0	0	0	0	0	0
10:117374695:T:C	2	0	3	3	0	1.5	1.5	0.0
10:118643924:C:T	0	0	0	0	0	0	0	0
10:118872536:A:G	0	0	0	0	0	0	0	0
10:119827315:A:G	9	4	9	5	4	1	1	0
10:119827370:A:G	7	5	7	2	5	1	0	1
10:119836986:C:T	14	5	17	9	8	1.0	1.0	0.0
10:119902823:G:T	7	3	16	13	3	1	1	0
10:119919501:A:G	18	9	27	13	14	1.0	0.5	0.5
10:120865167:G:A	13	8	32	13	19	2	0	1
10:120885864:A:T	11	4	13	8	5	1	1	0
10:120889970:A:G	16	5	17	11	6	1.0	1.0	0.0
10:120899978:C:T	4	4	5	0	5	1.0	0.0	1.0
10:120908784:G:A	41	22	42	20	22	1	0	1
10:121790176:T:G	2	0	14	14	0	7.0	7.0	0.0
10:122083008:G:A	0	0	0	0	0	0	0	0
10:122086382:G:C	0	0	0	0	0	0	0	0
10:122086773:G:A	0	0	0	0	0	0	0	0
10:122086970:A:G	0	0	0	0	0	0	0	0
10:122087345:C:T	0	0	0	0	0	0	0	0
10:122143618:G:A	0	0	0	0	0	0	0	0
10:122216876:C:A	0	0	0	0	0	0	0	0
10:122237461:G:A	0	0	0	0	0	0	0	0
10:122643161:A:G	0	0	0	0	0	0	0	0
10:122697936:C:T	0	0	0	0	0	0	0	0
10:122698390:C:T	0	0	0	0	0	0	0	0
10:122850511:G:A	99	46	180	96	84	1	1	0
10:122983379:G:C	8	3	9	5	4	1.0	1.0	0.0
10:123027536:A:G	1	1	14	0	14	14	0	14
10:123041337:C:T	23	12	43	24	19	1	0	1
10:123762074:G:A	0	0	0	0	0	0	0	0
10:123914031:T:G	0	0	0	0	0	0	0	0
10:124400865:G:A	4	3	6	1	5	1.0	0.0	1.0
10:124448113:G:C	0	0	0	0	0	0	0	0
10:124449776:C:T	0	0	0	0	0	0	0	0
10:124791812:C:T	41	18	44	24	20	1	1	0
10:125026867:C:T	0	0	0	0	0	0	0	0
10:125795004:G:A	2	1	4	3	1	2.0	1.5	0.5
10:126042159:C:T	0	0	0	0	0	0	0	0
10:126064909:G:A	0	0	0	0	0	0	0	0
10:127127749:A:G	0	0	0	0	0	0	0	0
10:127175956:G:A	0	0	0	0	0	0	0	0
10:127418394:T:C	0	0	0	0	0	0	0	0
10:127447420:G:A	0	0	0	0	0	0	0	0
10:127552592:G:C	0	0	0	0	0	0	0	0
10:128047639:C:T	23	13	28	12	16	1	0	1
10:128101314:T:C	0	0	0	0	0	0	0	0
10:128101514:G:C	0	0	0	0	0	0	0	0
10:128103129:T:C	0	0	0	0	0	0	0	0
10:128103306:C:T	0	0	0	0	0	0	0	0
10:128103458:GGCAC:AGCAT	0	0	0	0	0	0	0	0
10:128103561:T:C	0	0	0	0	0	0	0	0
10:128103682:T:G	0	0	0	0	0	0	0	0
10:128103894:C:T	0	0	0	0	0	0	0	0
10:128104017:G:A	1	1	1	0	1	1	0	1
10:128104752:T:C	0	0	0	0	0	0	0	0
10:128104830:G:T	0	0	0	0	0	0	0	0
10:128105538:A:G	0	0	0	0	0	0	0	0
10:128106296:C:T	1	0	3	3	0	3	3	0
10:128108204:C:T	0	0	0	0	0	0	0	0
10:128109280:G:C	0	0	0	0	0	0	0	0
10:128113592:C:G	0	0	0	0	0	0	0	0
10:128115696:A:T	0	0	0	0	0	0	0	0
10:128119296:T:C	2	2	4	0	4	2.0	0.0	2.0
10:131775611:T:G	0	0	0	0	0	0	0	0
10:131775835:G:A	0	0	0	0	0	0	0	0
10:131775874:A:G	0	0	0	0	0	0	0	0
10:131973082:T:C	58	36	70	28	42	1.0	0.0	1.0
10:132104868:G:A	0	0	0	0	0	0	0	0
10:132147990:C:T	0	0	0	0	0	0	0	0
10:132222689:A:G	0	0	0	0	0	0	0	0
10:132249070:G:A	0	0	0	0	0	0	0	0
10:132333668:G:A	54	29	58	25	33	1.0	0.0	1.0
10:132366849:C:T	5	3	11	6	5	2	0	1
10:132366850:G:A	5	2	11	5	6	2	1	0
10:132811000:C:T	0	0	0	0	0	0	0	0
10:132846122:A:G	0	0	0	0	0	0	0	0
10:133071012:G:A	0	0	0	0	0	0	0	0
10:133071042:A:G	0	0	0	0	0	0	0	0
10:133128662:A:G	0	0	0	0	0	0	0	0
10:133626718:C:T	0	0	0	0	0	0	0	0
11:197337:G:A	0	0	0	0	0	0	0	0
11:293188:T:C	23	10	34	14	20	1	1	0
11:309127:A:G	1866	1501	3996	988	3008	2.0	0.0	1.0
11:404317:C:T	0	0	0	0	0	0	0	0
11:433867:G:A	118	68	146	67	79	1.0	0.0	1.0
11:490036:G:A	5	1	5	4	1	1	1	0
11:494942:G:C	25	9	32	17	15	1	1	0
11:499059:C:T	18	9	22	12	10	1.0	0.5	0.5
11:499583:G:A	0	0	0	0	0	0	0	0
11:554047:G:A	4	3	4	1	3	1.0	0.0	1.0
11:558165:T:G	3	2	4	2	2	1	0	1
11:562421:G:A	25	8	25	17	8	1	1	0
11:562437:G:A	19	11	20	9	11	1	0	1
11:563649:C:T	10	7	12	3	9	1.0	0.0	1.0
11:587425:C:A	6	3	6	3	3	1.0	0.5	0.5
11:607175:G:A	2	0	4	4	0	2.0	2.0	0.0
11:608593:G:A	6	4	7	3	4	1.0	0.0	1.0
11:609353:G:A	5	3	5	2	3	1	0	1
11:617519:A:G	0	0	0	0	0	0	0	0
11:618013:C:T	0	0	0	0	0	0	0	0
11:618675:G:A	0	0	0	0	0	0	0	0
11:619789:T:G	0	0	0	0	0	0	0	0
11:621634:G:A	0	0	0	0	0	0	0	0
11:624400:C:T	0	0	0	0	0	0	0	0
11:653968:T:C	7	3	11	5	6	2	1	0
11:674499:G:A	2	0	3	3	0	1.5	1.5	0.0
11:704583:A:G	0	0	0	0	0	0	0	0
11:709401:A:G	0	0	0	0	0	0	0	0
11:720197:C:T	0	0	0	0	0	0	0	0
11:722709:C:T	3	2	8	3	5	3	0	1
11:771034:A:G	2	2	9	0	9	4.5	0.0	4.5
11:772490:G:A	24	8	28	19	9	1.0	1.0	0.0
11:792692:G:C	3	3	3	0	3	1	0	1
11:836043:C:T	0	0	0	0	0	0	0	0
11:1010694:C:T	11	9	11	2	9	1	0	1
11:1026048:G:A	0	0	0	0	0	0	0	0
11:1026084:G:A	0	0	0	0	0	0	0	0
11:1027811:C:T	0	0	0	0	0	0	0	0
11:1029320:C:T	0	0	0	0	0	0	0	0
11:1082580:G:A	0	0	0	0	0	0	0	0
11:1083078:T:C	0	0	0	0	0	0	0	0
11:1083116:G:C	0	0	0	0	0	0	0	0
11:1086825:C:T	0	0	0	0	0	0	0	0
11:1090036:T:C	0	0	0	0	0	0	0	0
11:1092405:T:C	0	0	0	0	0	0	0	0
11:1094761:G:A	0	0	0	0	0	0	0	0
11:1095064:C:G	0	0	0	0	0	0	0	0
11:1095070:G:A	0	0	0	0	0	0	0	0
11:1096322:C:A	0	0	0	0	0	0	0	0
11:1096339:G:T	0	0	0	0	0	0	0	0
11:1099604:C:A	0	0	0	0	0	0	0	0
11:1107741:T:C	0	0	0	0	0	0	0	0
11:1158068:T:C	0	0	0	0	0	0	0	0
11:1185300:C:A	0	0	0	0	0	0	0	0
11:1186303:C:T	0	0	0	0	0	0	0	0
11:1186317:A:T	0	0	0	0	0	0	0	0
11:1186818:T:C	0	0	0	0	0	0	0	0
11:1195214:G:C	0	0	0	0	0	0	0	0
11:1196002:T:C	0	0	0	0	0	0	0	0
11:1196902:G:A	0	0	0	0	0	0	0	0
11:1199741:C:T	0	0	0	0	0	0	0	0
11:1200591:G:C	0	0	0	0	0	0	0	0
11:1225711:A:G	0	0	0	0	0	0	0	0
11:1229258:C:T	0	0	0	0	0	0	0	0
11:1234543:C:T	0	0	0	0	0	0	0	0
11:1242004:A:G	0	0	0	0	0	0	0	0
11:1246095:T:C	0	0	0	0	0	0	0	0
11:1246332:C:T	0	0	0	0	0	0	0	0
11:1246834:C:T	0	0	0	0	0	0	0	0
11:1247431:G:A	0	0	0	0	0	0	0	0
11:1248605:G:A	0	0	0	0	0	0	0	0
11:1249735:G:A	0	0	0	0	0	0	0	0
11:1250091:C:G	0	0	0	0	0	0	0	0
11:1250199:C:T	0	0	0	0	0	0	0	0
11:1250278:G:A	0	0	0	0	0	0	0	0
11:1251628:C:T	0	0	0	0	0	0	0	0
11:1259008:G:A	0	0	0	0	0	0	0	0
11:1469866:G:A	7	4	8	4	4	1	0	1
11:1470111:C:G	4	2	4	2	2	1.0	0.5	0.5
11:1607735:G:A	0	0	0	0	0	0	0	0
11:1607762:G:A	0	0	0	0	0	0	0	0
11:1629890:G:T	0	0	0	0	0	0	0	0
11:1630310:C:G	0	0	0	0	0	0	0	0
11:1630320:C:T	0	0	0	0	0	0	0	0
11:1630383:T:C	0	0	0	0	0	0	0	0
11:1835114:C:A	0	0	0	0	0	0	0	0
11:1836517:TCTGC:CCTGG	0	0	0	0	0	0	0	0
11:2146313:T:G	0	0	0	0	0	0	0	0
11:2159843:G:A	0	0	0	0	0	0	0	0
11:2301792:C:T	27	23	48	7	41	1	0	1
11:2903380:G:A	82	32	110	63	47	1.0	1.0	0.0
11:2908322:A:G	9	3	9	6	3	1	1	0
11:3006910:G:A	14	4	17	12	5	1.0	1.0	0.0
11:3027866:G:A	0	0	0	0	0	0	0	0
11:3040550:C:T	1	0	7	7	0	7	7	0
11:3120514:C:T	0	0	0	0	0	0	0	0
11:3406599:C:T	0	0	0	0	0	0	0	0
11:3413884:T:C	0	0	0	0	0	0	0	0
11:3413899:A:G	0	0	0	0	0	0	0	0
11:3413910:G:A	0	0	0	0	0	0	0	0
11:3414981:G:A	0	0	0	0	0	0	0	0
11:3469381:C:T	1	1	3	0	3	3	0	3
11:3580976:C:T	0	0	0	0	0	0	0	0
11:3702711:C:T	4	3	7	1	6	1.0	0.0	1.0
11:4082294:A:G	5	0	8	8	0	1	1	0
11:4083515:C:G	0	0	0	0	0	0	0	0
11:4119902:C:A	11	8	12	3	9	1	0	1
11:4138227:A:G	6	5	9	1	8	1.0	0.0	1.0
11:4211663:T:C	0	0	0	0	0	0	0	0
11:4330354:C:A	0	0	0	0	0	0	0	0
11:4489055:A:G	0	0	0	0	0	0	0	0
11:4489357:C:T	0	0	0	0	0	0	0	0
11:4545481:C:T	0	0	0	0	0	0	0	0
11:4587312:C:T	0	0	0	0	0	0	0	0
11:4594004:A:G	0	0	0	0	0	0	0	0
11:4640055:A:G	0	0	0	0	0	0	0	0
11:4681935:C:A	0	0	0	0	0	0	0	0
11:4690849:A:G	0	0	0	0	0	0	0	0
11:4691123:T:C	0	0	0	0	0	0	0	0
11:4709712:G:T	0	0	0	0	0	0	0	0
11:4709950:G:A	0	0	0	0	0	0	0	0
11:4710238:G:A	0	0	0	0	0	0	0	0
11:4710353:C:T	0	0	0	0	0	0	0	0
11:4769881:T:C	0	0	0	0	0	0	0	0
11:4848419:G:A	0	0	0	0	0	0	0	0
11:4848676:A:C	0	0	0	0	0	0	0	0
11:4848909:G:A	0	0	0	0	0	0	0	0
11:4849031:G:C	0	0	0	0	0	0	0	0
11:4849068:T:G	0	0	0	0	0	0	0	0
11:4907636:C:T	0	0	0	0	0	0	0	0
11:4999279:C:T	0	0	0	0	0	0	0	0
11:4999569:C:T	0	0	0	0	0	0	0	0
11:4999602:C:T	0	0	0	0	0	0	0	0
11:5047067:G:A	0	0	0	0	0	0	0	0
11:5047201:G:A	0	0	0	0	0	0	0	0
11:5059004:T:C	0	0	0	0	0	0	0	0
11:5121040:T:G	0	0	0	0	0	0	0	0
11:5121319:T:C	0	0	0	0	0	0	0	0
11:5132031:A:G	0	0	0	0	0	0	0	0
11:5343046:G:A	0	0	0	0	0	0	0	0
11:5343220:A:G	0	0	0	0	0	0	0	0
11:5351626:A:G	0	0	0	0	0	0	0	0
11:5351633:T:A	0	0	0	0	0	0	0	0
11:5351776:T:C	0	0	0	0	0	0	0	0
11:5351874:A:G	0	0	0	0	0	0	0	0
11:5351899:C:T	0	0	0	0	0	0	0	0
11:5351940:C:G	0	0	0	0	0	0	0	0
11:5352012:T:G	0	0	0	0	0	0	0	0
11:5352021:C:T	0	0	0	0	0	0	0	0
11:5352081:T:C	0	0	0	0	0	0	0	0
11:5352104:A:G	0	0	0	0	0	0	0	0
11:5352332:C:A	0	0	0	0	0	0	0	0
11:5403200:A:G	0	0	0	0	0	0	0	0
11:5403471:T:C	0	0	0	0	0	0	0	0
11:5440855:G:A	0	0	0	0	0	0	0	0
11:5441025:C:G	0	0	0	0	0	0	0	0
11:5453608:G:T	0	0	0	0	0	0	0	0
11:5453940:G:C	0	0	0	0	0	0	0	0
11:5454276:G:A	0	0	0	0	0	0	0	0
11:5489111:C:T	0	0	0	0	0	0	0	0
11:5507909:T:C	0	0	0	0	0	0	0	0
11:5507922:A:G	0	0	0	0	0	0	0	0
11:5544800:A:G	0	0	0	0	0	0	0	0
11:5544821:C:A	0	0	0	0	0	0	0	0
11:5544882:C:T	0	0	0	0	0	0	0	0
11:5545135:T:C	0	0	0	0	0	0	0	0
11:5545259:C:T	0	0	0	0	0	0	0	0
11:5571807:T:A	0	0	0	0	0	0	0	0
11:5581045:A:G	0	0	0	0	0	0	0	0
11:5581208:T:A	0	0	0	0	0	0	0	0
11:5581375:G:A	0	0	0	0	0	0	0	0
11:5581385:A:G	0	0	0	0	0	0	0	0
11:5581449:T:C	0	0	0	0	0	0	0	0
11:5581560:A:G	0	0	0	0	0	0	0	0
11:5581698:G:C	0	0	0	0	0	0	0	0
11:5581738:G:A	0	0	0	0	0	0	0	0
11:5608377:G:A	0	0	0	0	0	0	0	0
11:5610982:G:A	1	0	1	1	0	1	1	0
11:5643601:C:A	26	12	119	76	43	3.5	1.0	0.0
11:5679110:T:C	2	1	4	2	2	2.0	1.0	1.0
11:5679169:C:G	2	0	3	3	0	1.5	1.5	0.0
11:5680051:G:A	62	23	68	44	24	1.0	1.0	0.0
11:5696532:T:C	115	62	147	75	72	1	0	1
11:5698437:T:C	58	37	82	27	55	1.0	0.0	1.0
11:5755254:A:T	0	0	0	0	0	0	0	0
11:5788247:A:G	0	0	0	0	0	0	0	0
11:5788318:G:A	0	0	0	0	0	0	0	0
11:5788443:C:T	0	0	0	0	0	0	0	0
11:5788516:C:T	0	0	0	0	0	0	0	0
11:5821080:T:G	1	0	1	1	0	1	1	0
11:5821126:A:G	1	0	1	1	0	1	1	0
11:5841302:A:C	0	0	0	0	0	0	0	0
11:5841423:T:C	0	0	0	0	0	0	0	0
11:5841550:T:C	0	0	0	0	0	0	0	0
11:5841615:A:G	0	0	0	0	0	0	0	0
11:5841707:C:A	0	0	0	0	0	0	0	0
11:5841754:G:C	0	0	0	0	0	0	0	0
11:5841783:T:C	0	0	0	0	0	0	0	0
11:5841883:G:A	0	0	0	0	0	0	0	0
11:5884913:T:C	0	0	0	0	0	0	0	0
11:5884973:T:G	0	0	0	0	0	0	0	0
11:5884975:G:A	0	0	0	0	0	0	0	0
11:5885061:T:C	0	0	0	0	0	0	0	0
11:5967993:G:A	0	0	0	0	0	0	0	0
11:5968063:G:A	0	0	0	0	0	0	0	0
11:5968185:C:T	0	0	0	0	0	0	0	0
11:5986042:G:A	0	0	0	0	0	0	0	0
11:5986383:G:T	0	0	0	0	0	0	0	0
11:5986450:G:A	0	0	0	0	0	0	0	0
11:5986513:G:A	0	0	0	0	0	0	0	0
11:6199939:A:G	0	0	0	0	0	0	0	0
11:6199984:T:A	0	0	0	0	0	0	0	0
11:6218114:G:A	5	1	5	4	1	1	1	0
11:6222574:A:G	4	1	8	7	1	2.0	2.0	0.0
11:6270835:C:A	0	0	0	0	0	0	0	0
11:6394233:G:A	1	0	1	1	0	1	1	0
11:6394460:G:A	3	2	3	1	2	1	0	1
11:6456601:C:T	3	1	3	2	1	1	1	0
11:6457389:G:A	1	1	1	0	1	1	0	1
11:6465715:C:T	8	3	8	5	3	1.0	1.0	0.0
11:6557876:C:A	0	0	0	0	0	0	0	0
11:6566998:G:A	1	1	1	0	1	1	0	1
11:6616356:A:G	31	16	36	18	18	1	0	1
11:6616707:C:G	24	10	25	15	10	1.0	1.0	0.0
11:6617275:A:T	10	6	10	4	6	1.0	0.0	1.0
11:6622745:C:T	0	0	0	0	0	0	0	0
11:6623369:C:T	0	0	0	0	0	0	0	0
11:6631387:C:T	0	0	0	0	0	0	0	0
11:6921245:C:A	0	0	0	0	0	0	0	0
11:6921397:A:C	0	0	0	0	0	0	0	0
11:7089132:G:A	0	0	0	0	0	0	0	0
11:7314193:C:G	0	0	0	0	0	0	0	0
11:7488335:A:T	0	0	0	0	0	0	0	0
11:7672771:G:A	295	163	342	167	175	1	0	1
11:7701455:A:G	0	0	0	0	0	0	0	0
11:7706325:T:C	0	0	0	0	0	0	0	0
11:7706339:C:T	0	0	0	0	0	0	0	0
11:7773039:G:T	0	0	0	0	0	0	0	0
11:7773103:G:C	0	0	0	0	0	0	0	0
11:7773177:T:C	0	0	0	0	0	0	0	0
11:7783869:A:G	0	0	0	0	0	0	0	0
11:7784168:C:T	0	0	0	0	0	0	0	0
11:7784181:G:A	0	0	0	0	0	0	0	0
11:7784314:A:C	0	0	0	0	0	0	0	0
11:7825661:T:C	0	0	0	0	0	0	0	0
11:7849464:A:G	0	0	0	0	0	0	0	0
11:7928313:G:A	0	0	0	0	0	0	0	0
11:7928477:A:G	0	0	0	0	0	0	0	0
11:8094152:T:C	5	5	19	0	19	2	0	2
11:8153419:G:A	367	366	545	6	539	1	0	1
11:8224634:A:G	0	0	0	0	0	0	0	0
11:8413530:CA:TC	2	1	2	1	1	1.0	0.5	0.5
11:8640969:T:C	0	0	0	0	0	0	0	0
11:8671858:G:A	1	0	1	1	0	1	1	0
11:8683981:C:G	14	13	16	2	14	1.0	0.0	1.0
11:8685536:G:A	7	1	13	10	3	2	1	0
11:8685686:C:T	2517	1840	6235	3043	3192	2	1	1
11:8730093:G:C	0	0	0	0	0	0	0	0
11:8917387:C:T	1	0	1	1	0	1	1	0
11:8921395:C:T	0	0	0	0	0	0	0	0
11:8925632:G:A	0	0	0	0	0	0	0	0
11:8925736:G:C	0	0	0	0	0	0	0	0
11:8927133:A:T	0	0	0	0	0	0	0	0
11:8937823:G:A	0	0	0	0	0	0	0	0
11:8937998:C:A	0	0	0	0	0	0	0	0
11:9029928:G:C	0	0	0	0	0	0	0	0
11:9203939:C:G	1	0	1	1	0	1	1	0
11:9428830:T:G	0	0	0	0	0	0	0	0
11:9660854:C:T	1	0	1	1	0	1	1	0
11:9726936:T:C	1	1	3	0	3	3	0	3
11:9728098:A:C	73	33	112	61	51	1	1	0
11:9748015:C:G	84	45	110	48	62	1.0	0.0	1.0
11:9832230:G:C	0	0	0	0	0	0	0	0
11:9839462:G:A	0	0	0	0	0	0	0	0
11:10500217:T:C	10	6	14	5	9	1.0	0.0	1.0
11:10508275:A:G	2	1	6	1	5	3.0	0.5	2.5
11:10531947:G:C	0	0	0	0	0	0	0	0
11:10534042:A:G	758	470	1000	430	570	1.0	0.0	1.0
11:10626359:G:A	0	0	0	0	0	0	0	0
11:10626430:T:C	0	0	0	0	0	0	0	0
11:10652192:T:C	0	0	0	0	0	0	0	0
11:10801532:T:C	1	0	1	1	0	1	1	0
11:10806814:C:A	7	3	7	4	3	1	1	0
11:11352722:A:G	3	0	6	6	0	1	1	0
11:11964514:T:C	0	0	0	0	0	0	0	0
11:12358402:C:T	0	0	0	0	0	0	0	0
11:12864993:C:T	0	0	0	0	0	0	0	0
11:14243370:A:G	0	0	0	0	0	0	0	0
11:14364395:G:A	1	0	1	1	0	1	1	0
11:14610961:C:T	0	0	0	0	0	0	0	0
11:15246051:C:A	0	0	0	0	0	0	0	0
11:16484260:T:C	0	0	0	0	0	0	0	0
11:16790850:G:A	0	0	0	0	0	0	0	0
11:17097140:T:C	2	2	2	0	2	1.0	0.0	1.0
11:17097183:A:G	2	0	2	2	0	1.0	1.0	0.0
11:17169472:A:G	6	4	9	3	6	1.0	0.0	1.0
11:17228472:G:T	1	0	1	1	0	1	1	0
11:17387083:C:T	1	0	1	1	0	1	1	0
11:17387284:G:C	1	0	1	1	0	1	1	0
11:17387522:G:A	1	0	1	1	0	1	1	0
11:17388025:T:C	2	1	3	2	1	1.5	1.0	0.5
11:17396930:C:A	0	0	0	0	0	0	0	0
11:17430945:G:A	0	0	0	0	0	0	0	0
11:17474969:A:G	0	0	0	0	0	0	0	0
11:17494423:G:A	0	0	0	0	0	0	0	0
11:17498195:C:G	0	0	0	0	0	0	0	0
11:17610759:C:T	0	0	0	0	0	0	0	0
11:17611104:C:T	0	0	0	0	0	0	0	0
11:17641869:G:A	0	0	0	0	0	0	0	0
11:17641897:C:T	0	0	0	0	0	0	0	0
11:17642195:G:C	0	0	0	0	0	0	0	0
11:17645892:G:C	0	0	0	0	0	0	0	0
11:17926764:T:C	1	1	7	0	7	7	0	7
11:17959500:C:T	7	4	18	11	7	1	0	1
11:18086965:T:C	2	2	2	0	2	1.0	0.0	1.0
11:18137446:T:C	0	0	0	0	0	0	0	0
11:18137908:T:C	0	0	0	0	0	0	0	0
11:18173331:T:G	6	4	31	9	22	6.5	0.0	3.0
11:18173417:A:G	7	3	28	19	9	3	3	0
11:18173901:C:T	0	0	0	0	0	0	0	0
11:18210368:T:C	0	0	0	0	0	0	0	0
11:18262842:T:G	0	0	0	0	0	0	0	0
11:18269774:T:C	33	7	47	34	13	1	1	0
11:18311889:A:T	2	1	4	3	1	2.0	1.5	0.5
11:18407903:A:G	0	0	0	0	0	0	0	0
11:18407920:T:C	0	0	0	0	0	0	0	0
11:18408001:C:G	0	0	0	0	0	0	0	0
11:18609980:T:C	0	0	0	0	0	0	0	0
11:18612424:G:A	1	1	1	0	1	1	0	1
11:18614957:T:C	1	1	1	0	1	1	0	1
11:18665369:C:T	1	0	1	1	0	1	1	0
11:18665478:G:A	2	0	2	2	0	1.0	1.0	0.0
11:18707103:T:C	0	0	0	0	0	0	0	0
11:18729494:C:T	0	0	0	0	0	0	0	0
11:18742479:G:C	0	0	0	0	0	0	0	0
11:18863876:G:A	0	0	0	0	0	0	0	0
11:18910769:C:T	0	0	0	0	0	0	0	0
11:19056218:T:C	0	0	0	0	0	0	0	0
11:19146303:A:G	20	11	24	13	11	1.0	0.0	1.0
11:19230279:G:A	0	0	0	0	0	0	0	0
11:19832542:G:A	0	0	0	0	0	0	0	0
11:20083123:G:A	0	0	0	0	0	0	0	0
11:20090946:G:A	0	0	0	0	0	0	0	0
11:20095686:T:C	0	0	0	0	0	0	0	0
11:20574778:G:A	0	0	0	0	0	0	0	0
11:20599640:C:T	0	0	0	0	0	0	0	0
11:20601429:G:A	0	0	0	0	0	0	0	0
11:20601461:C:T	0	0	0	0	0	0	0	0
11:20601477:C:T	0	0	0	0	0	0	0	0
11:21560259:C:T	0	0	0	0	0	0	0	0
11:22221183:T:C	0	0	0	0	0	0	0	0
11:22250324:A:T	0	0	0	0	0	0	0	0
11:22343198:G:A	0	0	0	0	0	0	0	0
11:22343212:C:T	0	0	0	0	0	0	0	0
11:26565586:T:C	0	0	0	0	0	0	0	0
11:26635016:C:T	0	0	0	0	0	0	0	0
11:26656400:C:T	0	0	0	0	0	0	0	0
11:26683763:A:G	0	0	0	0	0	0	0	0
11:27127300:G:A	0	0	0	0	0	0	0	0
11:30233638:C:T	0	0	0	0	0	0	0	0
11:31094116:T:C	0	0	0	0	0	0	0	0
11:31793331:G:A	0	0	0	0	0	0	0	0
11:32103432:T:C	5	2	17	11	6	4	1	0
11:32434752:G:A	0	0	0	0	0	0	0	0
11:32438681:C:T	0	0	0	0	0	0	0	0
11:32438918:G:A	0	0	0	0	0	0	0	0
11:32439078:G:C	0	0	0	0	0	0	0	0
11:32614810:G:A	0	0	0	0	0	0	0	0
11:32830621:C:T	0	0	0	0	0	0	0	0
11:33076330:C:T	0	0	0	0	0	0	0	0
11:33559760:G:A	0	0	0	0	0	0	0	0
11:33583414:C:T	0	0	0	0	0	0	0	0
11:33609877:G:A	0	0	0	0	0	0	0	0
11:33699576:G:A	0	0	0	0	0	0	0	0
11:34480798:T:C	0	0	0	0	0	0	0	0
11:34646596:C:T	0	0	0	0	0	0	0	0
11:35204608:A:G	2	2	2	0	2	1.0	0.0	1.0
11:35208126:T:C	2	2	9	0	9	4.5	0.0	4.5
11:35286822:T:C	0	0	0	0	0	0	0	0
11:35306201:C:T	0	0	0	0	0	0	0	0
11:35861236:C:T	0	0	0	0	0	0	0	0
11:36081678:A:G	0	0	0	0	0	0	0	0
11:36271498:G:A	0	0	0	0	0	0	0	0
11:36401151:C:T	0	0	0	0	0	0	0	0
11:40115993:T:C	0	0	0	0	0	0	0	0
11:42187742:T:G	0	0	0	0	0	0	0	0
11:43919052:C:G	6	4	6	2	4	1.0	0.0	1.0
11:43919094:G:T	6	2	6	4	2	1.0	1.0	0.0
11:43925417:A:G	0	0	0	0	0	0	0	0
11:44058660:T:C	0	0	0	0	0	0	0	0
11:44079568:C:T	1	0	1	1	0	1	1	0
11:44083431:C:T	6	0	6	6	0	1.0	1.0	0.0
11:44265016:G:A	0	0	0	0	0	0	0	0
11:44275396:C:T	0	0	0	0	0	0	0	0
11:44619090:C:G	107	54	179	104	75	1	1	1
11:45771667:G:C	0	0	0	0	0	0	0	0
11:45917010:T:C	18	11	21	10	11	1.0	0.0	1.0
11:46385217:G:A	0	0	0	0	0	0	0	0
11:46723375:G:C	0	0	0	0	0	0	0	0
11:46728098:G:A	0	0	0	0	0	0	0	0
11:46763147:A:C	3	2	5	1	4	1	0	1
11:46868614:C:T	0	0	0	0	0	0	0	0
11:46871557:T:C	0	0	0	0	0	0	0	0
11:46877220:T:C	0	0	0	0	0	0	0	0
11:46895950:G:A	0	0	0	0	0	0	0	0
11:46936748:G:T	2	0	2	2	0	1.0	1.0	0.0
11:47171816:T:G	0	0	0	0	0	0	0	0
11:47622737:C:A	10	0	16	16	0	1.0	1.0	0.0
11:48123695:T:C	11	5	11	6	5	1	1	0
11:48123823:A:C	10	2	10	8	2	1.0	1.0	0.0
11:48125070:G:A	11	4	12	8	4	1	1	0
11:48144715:G:C	4	1	4	3	1	1.0	1.0	0.0
11:48216997:G:A	0	0	0	0	0	0	0	0
11:48217630:C:A	0	0	0	0	0	0	0	0
11:48264304:C:T	0	0	0	0	0	0	0	0
11:48264679:T:A	0	0	0	0	0	0	0	0
11:48264704:C:T	0	0	0	0	0	0	0	0
11:48307092:C:T	0	0	0	0	0	0	0	0
11:48325588:T:C	0	0	0	0	0	0	0	0
11:48365634:A:G	0	0	0	0	0	0	0	0
11:48420322:G:C	0	0	0	0	0	0	0	0
11:48489102:A:C	0	0	0	0	0	0	0	0
11:48489225:G:A	0	0	0	0	0	0	0	0
11:48945872:G:A	0	0	0	0	0	0	0	0
11:48975555:G:A	0	0	0	0	0	0	0	0
11:48975782:T:G	0	0	0	0	0	0	0	0
11:48978970:C:T	0	0	0	0	0	0	0	0
11:48979006:G:A	0	0	0	0	0	0	0	0
11:48986146:A:T	0	0	0	0	0	0	0	0
11:48991502:C:T	0	0	0	0	0	0	0	0
11:48991609:T:C	0	0	0	0	0	0	0	0
11:49034199:T:C	0	0	0	0	0	0	0	0
11:49037810:C:A	0	0	0	0	0	0	0	0
11:49054053:G:A	0	0	0	0	0	0	0	0
11:49059064:T:C	0	0	0	0	0	0	0	0
11:49082138:G:T	0	0	0	0	0	0	0	0
11:49120550:T:A	0	0	0	0	0	0	0	0
11:49836699:T:G	0	0	0	0	0	0	0	0
11:49876482:T:C	0	0	0	0	0	0	0	0
11:55265608:T:G	0	0	0	0	0	0	0	0
11:56318671:T:G	0	0	0	0	0	0	0	0
11:56346117:C:A	0	0	0	0	0	0	0	0
11:56360605:A:G	0	0	0	0	0	0	0	0
11:56375958:C:G	0	0	0	0	0	0	0	0
11:56417412:G:A	0	0	0	0	0	0	0	0
11:56417748:A:G	0	0	0	0	0	0	0	0
11:56417869:A:G	0	0	0	0	0	0	0	0
11:56469934:A:G	0	0	0	0	0	0	0	0
11:56612658:C:G	0	0	0	0	0	0	0	0
11:56740362:A:G	0	0	0	0	0	0	0	0
11:56740376:A:G	0	0	0	0	0	0	0	0
11:56741049:A:G	0	0	0	0	0	0	0	0
11:57389932:A:G	0	0	0	0	0	0	0	0
11:57426180:A:G	21	9	23	14	9	1	1	0
11:57542834:A:G	0	0	0	0	0	0	0	0
11:57567035:G:A	7	3	7	4	3	1	1	0
11:57576388:G:C	0	0	0	0	0	0	0	0
11:57611697:A:G	0	0	0	0	0	0	0	0
11:57696028:T:C	3	0	4	4	0	1	1	0
11:57796519:C:T	3	2	6	1	5	2	0	2
11:58031711:C:T	0	0	0	0	0	0	0	0
11:58191025:T:C	0	0	0	0	0	0	0	0
11:58215163:G:A	0	0	0	0	0	0	0	0
11:58292485:T:C	0	0	0	0	0	0	0	0
11:58422639:A:G	0	0	0	0	0	0	0	0
11:58422663:A:G	0	0	0	0	0	0	0	0
11:58551146:C:G	66	30	80	43	37	1.0	1.0	0.0
11:58610951:A:G	23	16	72	15	57	2	0	1
11:58618704:G:A	4	1	4	3	1	1.0	1.0	0.0
11:59152340:A:G	18	13	61	11	50	2.5	0.0	1.5
11:59211211:G:A	30	15	55	30	25	1.0	0.5	0.5
11:59212375:G:A	9	5	18	10	8	1	0	1
11:59422439:G:A	0	0	0	0	0	0	0	0
11:59443288:C:G	0	0	0	0	0	0	0	0
11:59443715:G:A	0	0	0	0	0	0	0	0
11:59443792:T:C	0	0	0	0	0	0	0	0
11:59443948:C:T	0	0	0	0	0	0	0	0
11:59457135:A:G	0	0	0	0	0	0	0	0
11:59457412:G:C	0	0	0	0	0	0	0	0
11:59457748:T:C	0	0	0	0	0	0	0	0
11:59492164:A:C	0	0	0	0	0	0	0	0
11:59492358:T:C	0	0	0	0	0	0	0	0
11:59504164:T:C	0	0	0	0	0	0	0	0
11:59515388:A:G	0	0	0	0	0	0	0	0
11:59841299:A:G	0	0	0	0	0	0	0	0
11:59855905:C:A	0	0	0	0	0	0	0	0
11:59855960:G:A	0	0	0	0	0	0	0	0
11:60385090:T:A	143	4	170	165	5	1	1	0
11:60385111:G:A	132	5	162	156	6	1.0	1.0	0.0
11:60389634:T:G	2	1	2	1	1	1.0	0.5	0.5
11:60430855:C:T	0	0	0	0	0	0	0	0
11:60497474:C:T	0	0	0	0	0	0	0	0
11:60497529:C:T	0	0	0	0	0	0	0	0
11:60542610:A:T	0	0	0	0	0	0	0	0
11:60794032:G:A	0	0	0	0	0	0	0	0
11:60842592:G:A	5	2	16	14	2	1	1	0
11:60853219:C:A	0	0	0	0	0	0	0	0
11:60870988:C:T	0	0	0	0	0	0	0	0
11:60921973:T:C	20	12	21	9	12	1.0	0.0	1.0
11:60927829:C:A	0	0	0	0	0	0	0	0
11:60928927:G:A	0	0	0	0	0	0	0	0
11:60982768:G:A	0	0	0	0	0	0	0	0
11:61017991:C:T	3	2	4	1	3	1	0	1
11:61017992:G:A	3	1	4	3	1	1	1	0
11:61291395:T:C	0	0	0	0	0	0	0	0
11:61398269:G:C	6	6	6	0	6	1.0	0.0	1.0
11:61436889:A:C	27	7	30	23	7	1	1	0
11:61489883:G:C	0	0	0	0	0	0	0	0
11:61637294:C:T	0	0	0	0	0	0	0	0
11:61737696:G:A	0	0	0	0	0	0	0	0
11:61744026:C:T	0	0	0	0	0	0	0	0
11:61757502:G:A	0	0	0	0	0	0	0	0
11:61783884:T:C	0	0	0	0	0	0	0	0
11:61792609:G:A	13	9	18	5	13	1	0	1
11:61802358:C:T	0	0	0	0	0	0	0	0
11:61826344:C:T	0	0	0	0	0	0	0	0
11:61904763:T:C	0	0	0	0	0	0	0	0
11:61904793:T:C	0	0	0	0	0	0	0	0
11:61906646:C:T	0	0	0	0	0	0	0	0
11:61962564:G:A	0	0	0	0	0	0	0	0
11:61967562:A:G	2143	8	4111	4103	8	1	1	0
11:62128269:A:G	51	22	65	36	29	1	1	0
11:62129887:C:T	3	2	3	1	2	1	0	1
11:62138902:T:C	3	1	10	8	2	2	2	0
11:62140968:T:C	2	2	3	0	3	1.5	0.0	1.5
11:62145724:G:T	2	1	6	5	1	3.0	2.5	0.5
11:62146788:G:A	3	2	4	1	3	1	0	1
11:62567436:G:C	885	503	4107	2103	2004	3	1	1
11:62598147:A:G	1	0	3	3	0	3	3	0
11:62607053:T:C	8	1	8	7	1	1.0	1.0	0.0
11:62614336:G:C	1	0	1	1	0	1	1	0
11:62663187:T:A	66	28	116	73	43	1.0	1.0	0.0
11:62666701:G:A	0	0	0	0	0	0	0	0
11:62671278:T:C	5	3	9	2	7	1	0	1
11:62672097:G:A	366	212	436	199	237	1.0	0.0	1.0
11:62690803:T:C	18	8	48	19	29	2.5	1.0	0.0
11:62729047:T:C	63	42	68	23	45	1	0	1
11:62738292:C:T	19	8	27	17	10	1	1	0
11:62754003:T:C	17	5	17	12	5	1	1	0
11:62831199:A:G	522	277	737	350	387	1.0	1.0	1.0
11:62885307:C:T	14	12	17	2	15	1.0	0.0	1.0
11:63183749:C:G	0	0	0	0	0	0	0	0
11:63217396:T:C	0	0	0	0	0	0	0	0
11:63217616:G:A	0	0	0	0	0	0	0	0
11:64117089:G:A	0	0	0	0	0	0	0	0
11:64117833:C:T	0	0	0	0	0	0	0	0
11:64220630:C:T	29	13	40	16	24	1	1	0
11:64224329:T:C	15	6	15	9	6	1	1	0
11:64245312:G:A	2	0	2	2	0	1.0	1.0	0.0
11:64256499:G:A	0	0	0	0	0	0	0	0
11:64258672:G:A	1	0	1	1	0	1	1	0
11:64288090:C:T	14	5	72	40	32	4.5	1.5	0.0
11:64300838:C:T	0	0	0	0	0	0	0	0
11:64313973:G:A	6	4	11	4	7	1.5	0.0	1.0
11:64315780:T:C	1	0	2	2	0	2	2	0
11:64371333:T:C	12	6	25	17	8	1.5	0.5	0.5
11:64449995:C:G	0	0	0	0	0	0	0	0
11:64591679:G:A	0	0	0	0	0	0	0	0
11:64804511:A:G	8	3	9	5	4	1.0	1.0	0.0
11:65088514:A:G	0	0	0	0	0	0	0	0
11:65088636:A:C	0	0	0	0	0	0	0	0
11:65115317:C:T	1	0	1	1	0	1	1	0
11:65393658:C:T	7	3	7	4	3	1	1	0
11:65444508:G:A	4	1	4	3	1	1.0	1.0	0.0
11:65455481:T:C	71	39	209	108	101	2	0	1
11:65571473:T:G	209	120	246	110	136	1	0	1
11:65583603:G:A	3	1	5	2	3	1	1	0
11:65618830:C:T	0	0	0	0	0	0	0	0
11:65856048:G:A	2971	2423	11074	5586	5488	3	2	1
11:65863696:C:T	12	6	17	6	11	1.0	0.5	0.5
11:65864502:G:A	19	10	39	17	22	1	0	1
11:65864791:G:T	26	17	44	14	30	1.0	0.0	1.0
11:65870513:C:G	0	0	0	0	0	0	0	0
11:65871248:G:A	2	1	2	1	1	1.0	0.5	0.5
11:65965922:C:T	8	2	11	6	5	1.0	1.0	0.0
11:66264189:C:T	4	1	6	4	2	1.5	1.0	0.0
11:66294552:G:A	0	0	0	0	0	0	0	0
11:66315658:T:C	0	0	0	0	0	0	0	0
11:66341562:T:C	485	237	622	337	285	1	1	0
11:66421290:G:T	0	0	0	0	0	0	0	0
11:66504671:A:G	4	2	4	2	2	1.0	0.5	0.5
11:66514624:G:A	46	22	96	40	56	2.0	1.0	0.0
11:66515786:C:T	2	1	2	1	1	1.0	0.5	0.5
11:66521262:G:C	5	3	5	2	3	1	0	1
11:66529892:C:T	4	3	27	17	10	4.0	0.0	2.5
11:66560624:C:T	0	0	0	0	0	0	0	0
11:66561270:A:C	0	0	0	0	0	0	0	0
11:66562168:G:A	0	0	0	0	0	0	0	0
11:66562261:A:G	0	0	0	0	0	0	0	0
11:66563987:A:G	0	0	0	0	0	0	0	0
11:66566127:C:T	10	6	11	5	6	1.0	0.0	1.0
11:66590655:C:T	0	0	0	0	0	0	0	0
11:66625409:C:T	10	4	10	6	4	1.0	1.0	0.0
11:67303595:G:A	0	0	0	0	0	0	0	0
11:67399634:T:C	187	95	210	104	106	1	1	1
11:67409427:A:G	69	30	87	52	35	1	1	0
11:67429073:C:G	1	1	3	0	3	3	0	3
11:67433341:C:T	18	10	30	20	10	1.0	0.0	1.0
11:67433348:C:T	18	10	30	19	11	1.0	0.0	1.0
11:67434685:C:T	22	14	24	8	16	1.0	0.0	1.0
11:67435971:C:T	2985	2404	19910	10310	9600	5	2	2
11:67455665:C:T	1	1	1	0	1	1	0	1
11:67489566:C:T	0	0	0	0	0	0	0	0
11:67521123:C:T	0	0	0	0	0	0	0	0
11:67584785:C:A	21	7	30	22	8	1	1	0
11:67585218:A:G	1342	736	2150	1154	996	1.0	1.0	1.0
11:67586499:T:C	92	32	103	67	36	1.0	1.0	0.0
11:67629780:G:C	48	17	57	35	22	1.0	1.0	0.0
11:67796691:A:G	8	4	38	15	23	4.0	1.0	2.0
11:68262547:C:T	23	11	32	15	17	1	1	0
11:68262705:C:A	11	5	13	6	7	1	1	0
11:68410042:C:T	1	0	1	1	0	1	1	0
11:68425222:G:A	1	1	1	0	1	1	0	1
11:68904009:T:C	50	30	60	22	38	1.0	0.0	1.0
11:68911494:T:C	4	2	12	10	2	2.5	2.0	0.5
11:68936491:A:G	3	2	3	1	2	1	0	1
11:68936796:C:T	3	2	3	1	2	1	0	1
11:69009855:T:C	0	0	0	0	0	0	0	0
11:69295669:C:T	0	0	0	0	0	0	0	0
11:69295926:T:C	0	0	0	0	0	0	0	0
11:69296043:G:A	0	0	0	0	0	0	0	0
11:69303648:C:T	0	0	0	0	0	0	0	0
11:69657849:G:C	0	0	0	0	0	0	0	0
11:69671823:T:G	0	0	0	0	0	0	0	0
11:70116536:A:G	0	0	0	0	0	0	0	0
11:70161205:A:G	0	0	0	0	0	0	0	0
11:70161286:A:G	0	0	0	0	0	0	0	0
11:70203417:A:G	21	11	21	10	11	1	0	1
11:70339219:C:T	1	0	1	1	0	1	1	0
11:70343830:C:T	6	2	6	4	2	1.0	1.0	0.0
11:70354423:C:T	3	1	5	2	3	1	1	0
11:70365468:A:G	0	0	0	0	0	0	0	0
11:70376567:T:C	9	5	12	6	6	1	0	1
11:70407369:C:T	2	0	2	2	0	1.0	1.0	0.0
11:71435531:G:A	1	0	1	1	0	1	1	0
11:71444125:C:T	5	1	6	5	1	1	1	0
11:71458501:G:C	431	218	659	354	305	1	1	1
11:71527407:G:C	0	0	0	0	0	0	0	0
11:71538137:T:C	0	0	0	0	0	0	0	0
11:71548795:C:T	1	1	1	0	1	1	0	1
11:71548951:G:T	0	0	0	0	0	0	0	0
11:71565586:T:C	0	0	0	0	0	0	0	0
11:71566037:C:T	0	0	0	0	0	0	0	0
11:71582521:C:T	0	0	0	0	0	0	0	0
11:71787555:G:T	0	0	0	0	0	0	0	0
11:71787602:A:G	5	2	6	4	2	1	1	0
11:71787625:G:C	13	6	18	12	6	1	1	0
11:71793418:C:T	7	0	9	9	0	1	1	0
11:71793429:T:C	7	7	9	0	9	1	0	1
11:71800823:C:T	0	0	0	0	0	0	0	0
11:71817052:C:T	0	0	0	0	0	0	0	0
11:71818844:A:T	0	0	0	0	0	0	0	0
11:71837419:A:G	0	0	0	0	0	0	0	0
11:71837446:C:T	0	0	0	0	0	0	0	0
11:71837474:A:T	0	0	0	0	0	0	0	0
11:71837498:A:G	0	0	0	0	0	0	0	0
11:71903269:G:A	0	0	0	0	0	0	0	0
11:71904023:G:A	2	0	4	4	0	2.0	2.0	0.0
11:71916113:C:A	3	2	7	2	5	2	0	2
11:71990717:G:A	11	3	22	17	5	1	1	0
11:71995498:A:G	4	3	6	1	5	1.0	0.0	1.0
11:72014588:C:T	26	15	26	11	15	1.0	0.0	1.0
11:72015122:G:C	18	9	22	13	9	1.0	0.5	0.5
11:72110190:A:G	161	76	196	109	87	1	1	0
11:72177898:G:A	0	0	0	0	0	0	0	0
11:72577555:G:A	0	0	0	0	0	0	0	0
11:72578247:T:C	0	0	0	0	0	0	0	0
11:72579585:G:A	0	0	0	0	0	0	0	0
11:72940660:G:A	17	8	92	60	32	5	4	0
11:73234975:C:T	0	0	0	0	0	0	0	0
11:73365486:G:A	0	0	0	0	0	0	0	0
11:73909492:C:G	4	3	4	1	3	1.0	0.0	1.0
11:73970045:C:T	2	1	6	1	5	3.0	0.5	2.5
11:74006209:A:G	2	0	7	7	0	3.5	3.5	0.0
11:74074281:T:C	1	0	1	1	0	1	1	0
11:74355123:G:A	2	0	8	8	0	4.0	4.0	0.0
11:74492263:T:A	1	0	1	1	0	1	1	0
11:74496984:C:T	0	0	0	0	0	0	0	0
11:74497547:G:T	3	2	8	3	5	3	0	1
11:74497833:G:A	1	0	1	1	0	1	1	0
11:74835860:G:A	5	4	14	1	13	1	0	1
11:74949586:G:A	155	80	712	338	374	4	1	1
11:75131572:T:G	0	0	0	0	0	0	0	0
11:75306622:A:C	0	0	0	0	0	0	0	0
11:75441198:C:T	5	2	8	5	3	1	1	0
11:75449530:G:A	3	0	3	3	0	1	1	0
11:75566712:C:G	1	0	1	1	0	1	1	0
11:75568801:C:T	1	1	1	0	1	1	0	1
11:75571837:G:A	0	0	0	0	0	0	0	0
11:75587752:A:G	0	0	0	0	0	0	0	0
11:76926607:G:A	36	18	42	18	24	1.0	0.5	0.5
11:76926636:G:A	32	16	39	16	23	1.0	0.5	0.5
11:76990562:G:A	3	2	9	6	3	2	0	1
11:77103064:G:A	0	0	0	0	0	0	0	0
11:77142737:T:C	0	0	0	0	0	0	0	0
11:77199721:C:T	0	0	0	0	0	0	0	0
11:77201591:A:T	0	0	0	0	0	0	0	0
11:77206175:A:G	0	0	0	0	0	0	0	0
11:77208820:T:A	0	0	0	0	0	0	0	0
11:77243767:T:C	0	0	0	0	0	0	0	0
11:77243788:G:A	0	0	0	0	0	0	0	0
11:78104013:A:G	10	7	10	3	7	1.0	0.0	1.0
11:78138807:C:T	4	1	8	7	1	1.5	1.5	0.0
11:78661491:G:A	0	0	0	0	0	0	0	0
11:78669154:C:T	0	0	0	0	0	0	0	0
11:78688076:G:A	0	0	0	0	0	0	0	0
11:78726137:G:A	0	0	0	0	0	0	0	0
11:78786977:C:T	0	0	0	0	0	0	0	0
11:79069792:G:A	0	0	0	0	0	0	0	0
11:79988465:C:T	0	0	0	0	0	0	0	0
11:79989102:A:G	0	0	0	0	0	0	0	0
11:79989622:G:A	0	0	0	0	0	0	0	0
11:82732979:T:G	0	0	0	0	0	0	0	0
11:82824921:C:T	15	8	24	10	14	1	0	1
11:83213316:T:C	1	1	1	0	1	1	0	1
11:85724687:C:T	0	0	0	0	0	0	0	0
11:85725309:G:A	0	0	0	0	0	0	0	0
11:85725351:T:C	0	0	0	0	0	0	0	0
11:85725457:T:C	0	0	0	0	0	0	0	0
11:85725825:G:C	0	0	0	0	0	0	0	0
11:85726853:A:G	0	0	0	0	0	0	0	0
11:85736568:T:C	0	0	0	0	0	0	0	0
11:85737636:G:A	0	0	0	0	0	0	0	0
11:85853335:G:C	0	0	0	0	0	0	0	0
11:86257581:C:T	10	8	16	3	13	1.0	0.0	1.0
11:86387638:T:C	0	0	0	0	0	0	0	0
11:88312415:A:G	16	12	22	8	14	1.0	0.0	1.0
11:88334884:G:T	10	6	10	4	6	1.0	0.0	1.0
11:88408990:G:A	0	0	0	0	0	0	0	0
11:89178528:C:A	0	0	0	0	0	0	0	0
11:89191297:C:A	0	0	0	0	0	0	0	0
11:90041068:C:G	0	0	0	0	0	0	0	0
11:90134704:C:T	0	0	0	0	0	0	0	0
11:90222704:A:G	8	4	8	4	4	1.0	0.5	0.5
11:90283610:G:A	0	0	0	0	0	0	0	0
11:91812046:C:G	0	0	0	0	0	0	0	0
11:92336167:A:G	0	0	0	0	0	0	0	0
11:92857282:A:G	0	0	0	0	0	0	0	0
11:92890711:G:A	0	0	0	0	0	0	0	0
11:93731009:A:C	21	8	21	13	8	1	1	0
11:93784708:C:G	117	52	290	168	122	1	1	0
11:93784720:G:C	112	48	270	160	110	2.0	1.0	0.0
11:93801824:G:A	0	0	0	0	0	0	0	0
11:94587071:T:C	0	0	0	0	0	0	0	0
11:94589186:AG:TA	1	1	1	0	1	1	0	1
11:94593599:G:C	1	1	3	0	3	3	0	3
11:95129124:G:A	2	1	2	1	1	1.0	0.5	0.5
11:96383280:T:C	27	14	28	13	15	1	0	1
11:98566433:A:G	0	0	0	0	0	0	0	0
11:99819697:T:G	0	0	0	0	0	0	0	0
11:99819719:T:C	0	0	0	0	0	0	0	0
11:99819730:A:G	0	0	0	0	0	0	0	0
11:100070551:C:T	0	0	0	0	0	0	0	0
11:100356152:T:A	0	0	0	0	0	0	0	0
11:100356231:C:T	0	0	0	0	0	0	0	0
11:100666676:A:T	0	0	0	0	0	0	0	0
11:100943839:A:G	2	2	3	0	3	1.5	0.0	1.5
11:100976205:A:G	1	0	2	2	0	2	2	0
11:100976319:A:G	2	1	2	1	1	1.0	0.5	0.5
11:100976338:G:A	2	1	2	1	1	1.0	0.5	0.5
11:100992365:A:G	1	1	1	0	1	1	0	1
11:100992623:C:A	5	1	5	4	1	1	1	0
11:101039078:A:G	0	0	0	0	0	0	0	0
11:101039260:T:C	0	0	0	0	0	0	0	0
11:101127892:G:A	0	0	0	0	0	0	0	0
11:117207662:C:T	4	0	4	4	0	1.0	1.0	0.0
11:117918627:TGGG:CGGC	1	0	1	1	0	1	1	0
11:119048494:T:C	7	4	9	3	6	1	0	1
11:119081463:A:G	18	6	18	12	6	1.0	1.0	0.0
11:119183779:C:T	0	0	0	0	0	0	0	0
11:119188695:G:A	0	0	0	0	0	0	0	0
11:119193198:C:T	1	1	2	0	2	2	0	2
11:119310460:T:C	0	0	0	0	0	0	0	0
11:119345569:G:A	0	0	0	0	0	0	0	0
11:119373385:C:T	0	0	0	0	0	0	0	0
11:119419324:G:C	0	0	0	0	0	0	0	0
11:120008716:T:C	0	0	0	0	0	0	0	0
11:120128483:A:G	0	0	0	0	0	0	0	0
11:120170402:T:A	0	0	0	0	0	0	0	0
11:120228970:G:A	0	0	0	0	0	0	0	0
11:120236702:G:A	0	0	0	0	0	0	0	0
11:120317262:G:A	0	0	0	0	0	0	0	0
11:120469351:A:T	0	0	0	0	0	0	0	0
11:120485082:G:T	1	1	2	0	2	2	0	2
11:120956900:A:G	0	0	0	0	0	0	0	0
11:121362102:A:G	0	0	0	0	0	0	0	0
11:121362570:T:C	0	0	0	0	0	0	0	0
11:121586253:C:T	5	3	5	2	3	1	0	1
11:121605213:T:A	3	0	3	3	0	1	1	0
11:122618887:G:A	0	0	0	0	0	0	0	0
11:122776259:G:A	41	10	48	33	15	1	1	0
11:122960914:G:C	0	0	0	0	0	0	0	0
11:123058699:T:G	102	55	118	53	65	1.0	0.0	1.0
11:123526136:C:T	0	0	0	0	0	0	0	0
11:123805680:G:A	0	0	0	0	0	0	0	0
11:123906595:T:G	0	0	0	0	0	0	0	0
11:123906705:A:G	0	0	0	0	0	0	0	0
11:123906790:G:A	0	0	0	0	0	0	0	0
11:123906829:G:A	0	0	0	0	0	0	0	0
11:124015974:A:G	0	0	0	0	0	0	0	0
11:124016158:T:A	0	0	0	0	0	0	0	0
11:124016277:A:G	0	0	0	0	0	0	0	0
11:124030298:C:G	0	0	0	0	0	0	0	0
11:124158834:A:G	0	0	0	0	0	0	0	0
11:124208002:T:C	0	0	0	0	0	0	0	0
11:124224820:T:C	0	0	0	0	0	0	0	0
11:124225179:G:A	0	0	0	0	0	0	0	0
11:124225417:G:A	0	0	0	0	0	0	0	0
11:124225570:CTA:TTG	0	0	0	0	0	0	0	0
11:124238663:T:C	0	0	0	0	0	0	0	0
11:124238749:G:A	0	0	0	0	0	0	0	0
11:124250074:T:C	0	0	0	0	0	0	0	0
11:124250452:C:G	0	0	0	0	0	0	0	0
11:124265542:G:A	0	0	0	0	0	0	0	0
11:124265585:C:T	0	0	0	0	0	0	0	0
11:124382526:G:A	0	0	0	0	0	0	0	0
11:124382996:A:G	0	0	0	0	0	0	0	0
11:124383251:A:G	0	0	0	0	0	0	0	0
11:124383285:T:C	0	0	0	0	0	0	0	0
11:124397010:C:T	0	0	0	0	0	0	0	0
11:124397016:A:G	0	0	0	0	0	0	0	0
11:124570721:C:T	0	0	0	0	0	0	0	0
11:124753596:T:C	0	0	0	0	0	0	0	0
11:124877941:G:A	1	1	1	0	1	1	0	1
11:124919859:T:C	0	0	0	0	0	0	0	0
11:124923786:T:C	0	0	0	0	0	0	0	0
11:124923820:G:A	0	0	0	0	0	0	0	0
11:125582418:A:G	3	2	8	1	7	1	0	1
11:125609468:G:A	12	4	15	11	4	1.0	1.0	0.0
11:125747422:A:G	0	0	0	0	0	0	0	0
11:125747711:G:A	0	0	0	0	0	0	0	0
11:125747715:A:G	0	0	0	0	0	0	0	0
11:125896149:C:A	86	46	87	40	47	1.0	0.0	1.0
11:126291479:C:T	3	1	3	2	1	1	1	0
11:126304269:C:T	494	274	569	275	294	1.0	1.0	1.0
11:126406065:T:C	0	0	0	0	0	0	0	0
11:126407321:C:T	1	0	1	1	0	1	1	0
11:126408180:C:T	1	1	1	0	1	1	0	1
11:126440261:G:A	0	0	0	0	0	0	0	0
11:128463608:T:C	37	19	51	26	25	1	0	1
11:128781998:A:G	27	8	46	35	11	1	1	0
11:128805397:T:A	22	6	28	22	6	1.0	1.0	0.0
11:128839446:G:T	0	0	0	0	0	0	0	0
11:128902557:C:T	0	0	0	0	0	0	0	0
11:128911444:T:C	0	0	0	0	0	0	0	0
11:128912083:T:G	0	0	0	0	0	0	0	0
11:128912107:T:C	0	0	0	0	0	0	0	0
11:128935653:G:A	0	0	0	0	0	0	0	0
11:128935662:T:C	0	0	0	0	0	0	0	0
11:128972978:T:C	0	0	0	0	0	0	0	0
11:130196440:C:T	25	16	34	11	23	1	0	1
11:130197869:G:T	18	9	24	9	15	1.0	0.5	0.5
11:130198596:G:C	23	9	26	15	11	1	1	0
11:130405854:T:C	0	0	0	0	0	0	0	0
11:130547322:C:T	0	0	0	0	0	0	0	0
11:130906661:T:C	9	4	24	18	6	2	1	0
11:132307739:A:C	0	0	0	0	0	0	0	0
11:133935690:C:T	0	0	0	0	0	0	0	0
11:134318648:T:C	0	0	0	0	0	0	0	0
11:134356384:C:T	0	0	0	0	0	0	0	0
11:134374229:C:G	0	0	0	0	0	0	0	0
12:165481:T:C	0	0	0	0	0	0	0	0
12:297126:G:A	31	12	40	27	13	1	1	0
12:318409:A:G	24	10	33	22	11	1.0	1.0	0.0
12:411781:A:C	64	38	97	37	60	1.0	0.0	1.0
12:438517:T:C	3	2	9	7	2	1	0	1
12:553282:T:C	0	0	0	0	0	0	0	0
12:561429:G:A	0	0	0	0	0	0	0	0
12:827302:C:G	0	0	0	0	0	0	0	0
12:830136:A:G	17	11	19	6	13	1	0	1
12:865238:T:C	3	2	6	1	5	2	0	2
12:878316:G:A	7	4	10	5	5	1	0	1
12:884764:C:T	7	4	7	3	4	1	0	1
12:889199:G:T	8	2	12	8	4	1.0	1.0	0.0
12:1371872:C:T	1	1	1	0	1	1	0	1
12:1757633:C:A	0	0	0	0	0	0	0	0
12:1950307:A:G	0	0	0	0	0	0	0	0
12:1952816:G:A	8	1	9	8	1	1.0	1.0	0.0
12:1952909:C:T	11	4	11	7	4	1	1	0
12:1952969:G:A	8	4	8	4	4	1.0	0.5	0.5
12:1955450:A:G	7	1	24	17	7	1	1	0
12:1955468:A:G	7	1	22	16	6	1	1	0
12:1993237:C:A	8	5	8	3	5	1.0	0.0	1.0
12:2834858:G:C	0	0	0	0	0	0	0	0
12:2888231:G:A	21	8	26	15	11	1	1	0
12:3072114:C:T	0	0	0	0	0	0	0	0
12:3381380:T:C	0	0	0	0	0	0	0	0
12:4352319:G:A	6	3	14	11	3	1.0	0.5	0.5
12:4444166:A:G	0	0	0	0	0	0	0	0
12:4444217:A:G	0	0	0	0	0	0	0	0
12:4445247:C:T	0	0	0	0	0	0	0	0
12:4445464:A:G	0	0	0	0	0	0	0	0
12:4599742:T:C	6	1	7	6	1	1.0	1.0	0.0
12:4912062:T:C	0	0	0	0	0	0	0	0
12:4912182:G:C	0	0	0	0	0	0	0	0
12:5494466:G:A	0	0	0	0	0	0	0	0
12:5921135:G:A	0	0	0	0	0	0	0	0
12:5981834:A:G	0	0	0	0	0	0	0	0
12:6019004:C:G	0	0	0	0	0	0	0	0
12:6044348:A:G	0	0	0	0	0	0	0	0
12:6044368:T:C	0	0	0	0	0	0	0	0
12:6057952:C:T	0	0	0	0	0	0	0	0
12:6058030:A:G	0	0	0	0	0	0	0	0
12:6063036:T:C	0	0	0	0	0	0	0	0
12:6064267:C:T	0	0	0	0	0	0	0	0
12:6065248:T:G	0	0	0	0	0	0	0	0
12:6065257:T:A	0	0	0	0	0	0	0	0
12:6330843:T:C	0	0	0	0	0	0	0	0
12:6334137:A:G	0	0	0	0	0	0	0	0
12:6341779:T:C	1	1	1	0	1	1	0	1
12:6375543:T:C	0	0	0	0	0	0	0	0
12:6534825:C:G	1432	801	2448	1300	1148	1.0	1.0	1.0
12:6777854:T:C	1	0	1	1	0	1	1	0
12:6817197:T:C	0	0	0	0	0	0	0	0
12:6818909:T:C	0	0	0	0	0	0	0	0
12:6831328:G:A	0	0	0	0	0	0	0	0
12:6831857:G:A	0	0	0	0	0	0	0	0
12:6837083:G:T	0	0	0	0	0	0	0	0
12:6839304:T:C	1	0	1	1	0	1	1	0
12:6937980:C:A	9	7	13	2	11	1	0	1
12:6946697:T:C	33	21	91	26	65	2	0	1
12:6975299:C:T	32	16	74	35	39	1.5	0.5	0.5
12:7089703:G:A	0	0	0	0	0	0	0	0
12:7128721:C:T	0	0	0	0	0	0	0	0
12:7156875:C:A	1	0	2	2	0	2	2	0
12:7375875:G:A	0	0	0	0	0	0	0	0
12:7432651:T:C	0	0	0	0	0	0	0	0
12:7439439:G:T	0	0	0	0	0	0	0	0
12:7439543:G:A	1	0	1	1	0	1	1	0
12:7439849:G:C	2	0	6	6	0	3.0	3.0	0.0
12:7439943:A:T	1	0	1	1	0	1	1	0
12:7651050:G:A	0	0	0	0	0	0	0	0
12:7690336:C:T	0	0	0	0	0	0	0	0
12:8044828:C:G	3	2	5	3	2	1	0	1
12:8125585:A:T	24	13	38	22	16	1.0	0.0	1.0
12:8177080:C:T	0	0	0	0	0	0	0	0
12:8177104:A:C	0	0	0	0	0	0	0	0
12:8234282:C:T	0	0	0	0	0	0	0	0
12:8234314:C:T	0	0	0	0	0	0	0	0
12:8235430:G:A	3	2	5	1	4	1	0	1
12:8235753:A:G	0	0	0	0	0	0	0	0
12:8390317:ACCG:GCCA	0	0	0	0	0	0	0	0
12:8390344:A:C	0	0	0	0	0	0	0	0
12:8460816:A:C	0	0	0	0	0	0	0	0
12:8604885:G:A	0	0	0	0	0	0	0	0
12:8637079:A:G	0	0	0	0	0	0	0	0
12:8773523:A:G	2	2	5	0	5	2.5	0.0	2.5
12:8823305:C:T	0	0	0	0	0	0	0	0
12:8845245:G:T	0	0	0	0	0	0	0	0
12:8851916:G:A	0	0	0	0	0	0	0	0
12:8857224:G:A	0	0	0	0	0	0	0	0
12:8867893:A:G	0	0	0	0	0	0	0	0
12:8867967:T:C	0	0	0	0	0	0	0	0
12:8934302:A:G	3	3	3	0	3	1	0	1
12:9009052:T:C	13	6	19	13	6	1	1	0
12:9027655:T:C	0	0	0	0	0	0	0	0
12:9027756:A:G	0	0	0	0	0	0	0	0
12:9079672:T:C	0	0	0	0	0	0	0	0
12:9115877:A:C	0	0	0	0	0	0	0	0
12:9150700:A:T	0	0	0	0	0	0	0	0
12:9152877:T:C	0	0	0	0	0	0	0	0
12:9162613:A:G	1	0	3	3	0	3	3	0
12:9164177:T:C	0	0	0	0	0	0	0	0
12:9194196:G:C	0	0	0	0	0	0	0	0
12:9310388:A:G	1	0	1	1	0	1	1	0
12:9311178:G:T	3	2	8	1	7	1	0	1
12:9311582:G:A	7	4	12	7	5	1	0	1
12:9420628:C:T	10	9	17	2	15	1.5	0.0	1.0
12:9984958:A:C	0	0	0	0	0	0	0	0
12:9995251:T:C	1	0	6	6	0	6	6	0
12:9998375:A:G	0	0	0	0	0	0	0	0
12:10010776:CCTAC:ACTAT	0	0	0	0	0	0	0	0
12:10054326:A:G	0	0	0	0	0	0	0	0
12:10098846:C:G	0	0	0	0	0	0	0	0
12:10118456:T:C	0	0	0	0	0	0	0	0
12:10434512:A:G	4	2	12	8	4	2.5	1.5	1.0
12:10806432:C:T	0	0	0	0	0	0	0	0
12:10809516:A:G	0	0	0	0	0	0	0	0
12:10847181:C:T	7	3	28	19	9	4	3	0
12:10908523:T:C	0	0	0	0	0	0	0	0
12:10939094:T:A	0	0	0	0	0	0	0	0
12:10965197:T:C	0	0	0	0	0	0	0	0
12:11308636:G:T	0	0	0	0	0	0	0	0
12:11308646:T:G	0	0	0	0	0	0	0	0
12:11353815:T:C	0	0	0	0	0	0	0	0
12:11393752:C:T	0	0	0	0	0	0	0	0
12:11393808:T:C	0	0	0	0	0	0	0	0
12:12465607:A:G	3	1	3	2	1	1	1	0
12:12851202:A:G	151	150	156	1	155	1	0	1
12:12908360:C:T	0	0	0	0	0	0	0	0
12:12949671:G:A	0	0	0	0	0	0	0	0
12:12983689:T:C	0	0	0	0	0	0	0	0
12:13001977:A:G	0	0	0	0	0	0	0	0
12:13563704:G:A	0	0	0	0	0	0	0	0
12:13564574:G:A	0	0	0	0	0	0	0	0
12:13611840:G:A	0	0	0	0	0	0	0	0
12:13865843:G:C	0	0	0	0	0	0	0	0
12:14496262:A:G	17	8	21	13	8	1	1	0
12:14806457:T:C	0	0	0	0	0	0	0	0
12:14823129:A:G	9	4	9	5	4	1	1	0
12:14823244:T:A	2	1	2	1	1	1.0	0.5	0.5
12:14840505:C:T	0	0	0	0	0	0	0	0
12:14840674:G:A	0	0	0	0	0	0	0	0
12:14840920:A:G	0	0	0	0	0	0	0	0
12:14882147:T:C	1	1	1	0	1	1	0	1
12:14885854:C:T	0	0	0	0	0	0	0	0
12:14942624:C:G	425	227	595	308	287	1	1	1
12:15109245:G:A	0	0	0	0	0	0	0	0
12:15956739:T:G	0	0	0	0	0	0	0	0
12:16399345:T:C	0	0	0	0	0	0	0	0
12:16399890:G:A	0	0	0	0	0	0	0	0
12:16400156:T:C	0	0	0	0	0	0	0	0
12:17400746:G:A	3	3	3	0	3	1	0	1
12:18282518:C:T	0	0	0	0	0	0	0	0
12:18496123:C:T	0	0	0	0	0	0	0	0
12:18692790:G:A	0	0	0	0	0	0	0	0
12:18693113:G:A	0	0	0	0	0	0	0	0
12:18693262:T:C	0	0	0	0	0	0	0	0
12:18693277:T:C	0	0	0	0	0	0	0	0
12:18693318:C:T	0	0	0	0	0	0	0	0
12:18693796:G:A	0	0	0	0	0	0	0	0
12:18693811:C:A	0	0	0	0	0	0	0	0
12:18693847:T:A	0	0	0	0	0	0	0	0
12:18694041:C:A	0	0	0	0	0	0	0	0
12:19456569:A:G	1	0	12	12	0	12	12	0
12:19941590:G:T	3	0	3	3	0	1	1	0
12:20552606:C:T	0	0	0	0	0	0	0	0
12:20711422:C:T	0	0	0	0	0	0	0	0
12:20750823:T:C	0	0	0	0	0	0	0	0
12:21176804:A:G	0	0	0	0	0	0	0	0
12:21178615:T:C	0	0	0	0	0	0	0	0
12:21178665:T:C	0	0	0	0	0	0	0	0
12:21178691:C:T	0	0	0	0	0	0	0	0
12:21470245:T:C	19	9	20	11	9	1	1	0
12:21471035:A:G	27	10	30	19	11	1	1	0
12:21501897:G:T	82	44	93	44	49	1.0	0.0	1.0
12:22008866:G:C	0	0	0	0	0	0	0	0
12:22325491:A:G	0	0	0	0	0	0	0	0
12:24994258:A:T	1	0	1	1	0	1	1	0
12:25089661:C:G	85	42	198	108	90	1	1	0
12:25195139:G:T	0	0	0	0	0	0	0	0
12:25804144:A:C	0	0	0	0	0	0	0	0
12:26495159:C:T	8	4	9	4	5	1.0	0.5	0.5
12:26654022:G:A	16	6	31	19	12	1.0	1.0	0.0
12:26656383:G:A	5	4	7	1	6	1	0	1
12:26657844:T:C	8	3	9	6	3	1.0	1.0	0.0
12:26715389:T:C	12	6	28	16	12	1.0	0.5	0.5
12:26911299:C:T	18	7	23	12	11	1.0	1.0	0.0
12:27022707:A:G	10	1	10	9	1	1.0	1.0	0.0
12:27400633:A:G	0	0	0	0	0	0	0	0
12:27714794:G:A	337	168	387	196	191	1	1	0
12:27763011:A:G	0	0	0	0	0	0	0	0
12:27763273:G:A	1	0	1	1	0	1	1	0
12:27763291:A:G	1	0	2	2	0	2	2	0
12:27969552:T:A	0	0	0	0	0	0	0	0
12:28452493:G:A	26	11	35	23	12	1.0	1.0	0.0
12:29270527:G:A	0	0	0	0	0	0	0	0
12:29389757:C:T	2	0	4	4	0	2.0	2.0	0.0
12:29445359:G:A	0	0	0	0	0	0	0	0
12:29461776:A:G	1	0	3	3	0	3	3	0
12:29464617:G:A	0	0	0	0	0	0	0	0
12:29477148:G:A	0	0	0	0	0	0	0	0
12:29486253:T:C	0	0	0	0	0	0	0	0
12:29495342:G:A	0	0	0	0	0	0	0	0
12:29583547:A:G	0	0	0	0	0	0	0	0
12:30455054:T:C	0	0	0	0	0	0	0	0
12:30991949:A:G	0	0	0	0	0	0	0	0
12:31102471:C:T	11	0	18	18	0	1	1	0
12:31130512:T:G	0	0	0	0	0	0	0	0
12:31136021:G:A	0	0	0	0	0	0	0	0
12:31252236:A:G	0	0	0	0	0	0	0	0
12:31495892:C:T	86	57	110	36	74	1.0	0.0	1.0
12:31948737:T:C	0	0	0	0	0	0	0	0
12:31981704:T:C	35	20	70	34	36	1	0	1
12:31981992:G:A	20	10	28	11	17	1.0	0.5	0.5
12:32328435:C:T	8	4	8	4	4	1.0	0.5	0.5
12:32399835:C:G	0	0	0	0	0	0	0	0
12:32706757:G:T	5	2	12	7	5	2	2	0
12:34165416:G:A	0	0	0	0	0	0	0	0
12:38316781:C:T	0	0	0	0	0	0	0	0
12:38320440:G:A	0	0	0	0	0	0	0	0
12:38323876:T:C	0	0	0	0	0	0	0	0
12:38693807:G:A	0	0	0	0	0	0	0	0
12:40320099:T:A	7	5	13	6	7	1	0	1
12:40348452:G:A	6	2	10	8	2	1.0	1.0	0.0
12:40363528:A:G	10	2	11	9	2	1.0	1.0	0.0
12:40431685:G:A	0	0	0	0	0	0	0	0
12:40441116:C:T	0	0	0	0	0	0	0	0
12:40444096:G:A	0	0	0	0	0	0	0	0
12:40464141:A:C	0	0	0	0	0	0	0	0
12:40523614:T:C	0	0	0	0	0	0	0	0
12:40528100:C:T	0	0	0	0	0	0	0	0
12:40531306:A:C	0	0	0	0	0	0	0	0
12:40536482:C:G	0	0	0	0	0	0	0	0
12:42287706:A:G	0	0	0	0	0	0	0	0
12:42287866:C:T	0	0	0	0	0	0	0	0
12:42288413:A:G	0	0	0	0	0	0	0	0
12:42288549:C:T	0	0	0	0	0	0	0	0
12:42432085:C:G	0	0	0	0	0	0	0	0
12:42460403:AGAA:GGAG	5	4	5	1	4	1	0	1
12:42636994:G:A	3	0	3	3	0	1	1	0
12:42679031:A:G	0	0	0	0	0	0	0	0
12:43660428:A:G	0	0	0	0	0	0	0	0
12:43797822:G:A	17	10	54	28	26	2	0	1
12:44875920:A:T	0	0	0	0	0	0	0	0
12:45928666:C:T	43	25	71	33	38	1	0	1
12:46364711:A:G	4	2	9	5	4	2.0	1.0	1.0
12:46365234:T:A	5	3	13	5	8	1	0	1
12:46367344:G:A	2	1	4	3	1	2.0	1.5	0.5
12:47135581:C:T	5	2	11	7	4	2	1	0
12:47740912:T:C	0	0	0	0	0	0	0	0
12:47780492:C:T	1	1	1	0	1	1	0	1
12:47780858:T:C	10	6	30	14	16	1.5	0.0	1.0
12:47784730:A:G	5	1	10	9	1	1	1	0
12:47844974:A:G	1	1	2	0	2	2	0	2
12:48569238:T:C	0	0	0	0	0	0	0	0
12:48693180:G:A	2	2	2	0	2	1.0	0.0	1.0
12:48693542:T:C	4	1	23	17	6	3.5	1.0	0.0
12:48694116:C:T	8	1	13	12	1	1.0	1.0	0.0
12:49758410:G:A	152	149	174	4	170	1.0	0.0	1.0
12:49792286:G:T	0	0	0	0	0	0	0	0
12:49795819:A:G	11	9	11	2	9	1	0	1
12:49796870:C:T	1	1	9	0	9	9	0	9
12:49796884:A:T	1	1	10	0	10	10	0	10
12:49842999:G:C	41	30	46	12	34	1	0	1
12:49954295:T:C	0	0	0	0	0	0	0	0
12:49955628:C:A	0	0	0	0	0	0	0	0
12:50133031:G:A	4	3	15	1	14	3.5	0.0	3.5
12:50135531:C:T	3	1	9	8	1	4	4	0
12:50222563:A:G	4	0	4	4	0	1.0	1.0	0.0
12:50333923:G:C	0	0	0	0	0	0	0	0
12:50334028:C:T	0	0	0	0	0	0	0	0
12:50350388:T:C	1	0	1	1	0	1	1	0
12:50353134:A:G	0	0	0	0	0	0	0	0
12:50353222:T:C	0	0	0	0	0	0	0	0
12:50695951:T:A	59	34	319	148	171	5	0	3
12:50809588:C:T	33	19	61	26	35	1	0	1
12:51288119:T:C	33	17	42	23	19	1	1	1
12:51292047:T:C	33	19	39	18	21	1	0	1
12:51302716:G:A	829	477	1302	625	677	1	1	1
12:51313842:C:T	578	328	862	409	453	1.0	1.0	1.0
12:51328527:C:T	1	1	1	0	1	1	0	1
12:51329715:T:C	1	1	1	0	1	1	0	1
12:51339950:G:A	0	0	0	0	0	0	0	0
12:51343778:T:C	0	0	0	0	0	0	0	0
12:51343823:G:A	0	0	0	0	0	0	0	0
12:51345864:C:G	0	0	0	0	0	0	0	0
12:51890663:C:T	0	0	0	0	0	0	0	0
12:51912437:C:T	0	0	0	0	0	0	0	0
12:51919160:T:C	0	0	0	0	0	0	0	0
12:51919180:A:G	0	0	0	0	0	0	0	0
12:52172263:G:A	0	0	0	0	0	0	0	0
12:52229302:C:G	0	0	0	0	0	0	0	0
12:52256092:C:A	0	0	0	0	0	0	0	0
12:52256103:T:C	0	0	0	0	0	0	0	0
12:52258459:A:T	0	0	0	0	0	0	0	0
12:52267028:G:A	0	0	0	0	0	0	0	0
12:52267425:T:C	0	0	0	0	0	0	0	0
12:52286224:T:C	0	0	0	0	0	0	0	0
12:52287632:T:C	0	0	0	0	0	0	0	0
12:52288141:A:C	0	0	0	0	0	0	0	0
12:52301970:C:T	0	0	0	0	0	0	0	0
12:52302003:C:T	0	0	0	0	0	0	0	0
12:52305764:T:C	0	0	0	0	0	0	0	0
12:52316096:AGCT:GGCC	0	0	0	0	0	0	0	0
12:52316525:G:A	0	0	0	0	0	0	0	0
12:52316931:G:A	0	0	0	0	0	0	0	0
12:52316937:G:C	0	0	0	0	0	0	0	0
12:52317765:G:A	0	0	0	0	0	0	0	0
12:52319191:G:A	0	0	0	0	0	0	0	0
12:52319304:G:A	0	0	0	0	0	0	0	0
12:52430567:C:T	0	0	0	0	0	0	0	0
12:52544536:C:T	0	0	0	0	0	0	0	0
12:52544580:T:C	0	0	0	0	0	0	0	0
12:52544713:A:C	0	0	0	0	0	0	0	0
12:52568383:T:C	0	0	0	0	0	0	0	0
12:52571389:T:G	0	0	0	0	0	0	0	0
12:52571977:C:T	0	0	0	0	0	0	0	0
12:52571998:T:C	0	0	0	0	0	0	0	0
12:52572465:T:A	0	0	0	0	0	0	0	0
12:52573652:G:A	0	0	0	0	0	0	0	0
12:52650483:C:T	0	0	0	0	0	0	0	0
12:52675230:T:C	0	0	0	0	0	0	0	0
12:52680274:G:A	0	0	0	0	0	0	0	0
12:52692842:G:A	0	0	0	0	0	0	0	0
12:52697892:C:T	0	0	0	0	0	0	0	0
12:52771064:G:A	0	0	0	0	0	0	0	0
12:52773611:C:T	0	0	0	0	0	0	0	0
12:52777217:G:A	0	0	0	0	0	0	0	0
12:52792304:G:C	0	0	0	0	0	0	0	0
12:52795912:C:G	0	0	0	0	0	0	0	0
12:52810830:C:T	0	0	0	0	0	0	0	0
12:52823166:T:C	0	0	0	0	0	0	0	0
12:52839305:G:A	0	0	0	0	0	0	0	0
12:52848631:G:A	0	0	0	0	0	0	0	0
12:52898859:C:T	0	0	0	0	0	0	0	0
12:53063436:C:G	1	0	2	2	0	2	2	0
12:53103504:A:G	0	0	0	0	0	0	0	0
12:53103618:A:G	0	0	0	0	0	0	0	0
12:53253589:T:C	6	3	14	11	3	1.0	0.5	0.5
12:53289202:C:T	0	0	0	0	0	0	0	0
12:54102382:G:T	11	2	11	9	2	1	1	0
12:54102435:A:G	8	1	8	7	1	1.0	1.0	0.0
12:54340505:A:G	0	0	0	0	0	0	0	0
12:55122841:A:G	0	0	0	0	0	0	0	0
12:55123908:C:T	1	0	1	1	0	1	1	0
12:55124038:TG:CA	1	0	1	1	0	1	1	0
12:55129901:C:T	0	0	0	0	0	0	0	0
12:55130076:A:C	0	0	0	0	0	0	0	0
12:55130388:G:A	0	0	0	0	0	0	0	0
12:55130530:T:C	0	0	0	0	0	0	0	0
12:55294483:G:A	0	0	0	0	0	0	0	0
12:55411863:A:G	0	0	0	0	0	0	0	0
12:55412350:T:C	0	0	0	0	0	0	0	0
12:55412454:A:G	0	0	0	0	0	0	0	0
12:55426337:C:T	0	0	0	0	0	0	0	0
12:55469440:C:G	0	0	0	0	0	0	0	0
12:55469597:A:G	0	0	0	0	0	0	0	0
12:55492510:G:A	0	0	0	0	0	0	0	0
12:55575165:G:A	0	0	0	0	0	0	0	0
12:55637154:C:T	0	0	0	0	0	0	0	0
12:55637489:G:A	0	0	0	0	0	0	0	0
12:55698884:C:T	0	0	0	0	0	0	0	0
12:55698898:C:T	0	0	0	0	0	0	0	0
12:55957562:G:A	0	0	0	0	0	0	0	0
12:55967092:G:A	49	24	51	26	25	1	1	0
12:55980534:C:T	0	0	0	0	0	0	0	0
12:55981019:G:A	10	4	24	15	9	2.5	1.0	0.0
12:56004670:G:C	0	0	0	0	0	0	0	0
12:56042136:C:G	60	32	61	29	32	1.0	0.0	1.0
12:56042145:C:G	395	51	435	383	52	1	1	0
12:56101207:G:A	0	0	0	0	0	0	0	0
12:56712876:A:T	523	272	679	354	325	1	1	1
12:56714419:A:G	3258	3152	34259	17327	16932	9.0	4.0	4.0
12:56716147:A:T	0	0	0	0	0	0	0	0
12:56720316:A:G	0	0	0	0	0	0	0	0
12:56720523:A:T	0	0	0	0	0	0	0	0
12:56738452:C:T	4	2	5	2	3	1.0	0.5	0.5
12:56752285:T:G	35	18	36	17	19	1	0	1
12:57141483:C:T	0	0	0	0	0	0	0	0
12:57243810:G:A	5	3	5	2	3	1	0	1
12:57256057:C:T	13	7	28	8	20	2	0	1
12:57454925:C:G	0	0	0	0	0	0	0	0
12:57732451:C:A	5	4	12	8	4	1	0	1
12:57751373:C:T	1	1	1	0	1	1	0	1
12:57816005:G:A	0	0	0	0	0	0	0	0
12:57967187:A:G	0	0	0	0	0	0	0	0
12:57984226:G:T	0	0	0	0	0	0	0	0
12:58919467:G:A	0	0	0	0	0	0	0	0
12:58920155:T:G	0	0	0	0	0	0	0	0
12:59720129:A:G	0	0	0	0	0	0	0	0
12:59733809:A:T	0	0	0	0	0	0	0	0
12:59733831:G:A	0	0	0	0	0	0	0	0
12:59779625:C:T	5	5	5	0	5	1	0	1
12:62021593:C:G	1	1	1	0	1	1	0	1
12:62021792:A:T	1	1	3	0	3	3	0	3
12:62500856:T:A	4	3	15	2	13	3.5	0.0	3.5
12:62585436:G:A	11	6	18	10	8	1	0	1
12:62965388:G:A	280	2	300	298	2	1.0	1.0	0.0
12:62965629:C:A	1596	316	2493	2156	337	1.0	1.0	0.0
12:63002763:T:G	1	0	1	1	0	1	1	0
12:63003902:A:G	0	0	0	0	0	0	0	0
12:64032534:T:C	0	0	0	0	0	0	0	0
12:64222146:T:C	43	19	43	24	19	1	1	0
12:64410018:A:C	20	12	25	8	17	1.0	0.0	1.0
12:64455936:T:C	251	125	920	461	459	2	1	0
12:65646199:G:C	0	0	0	0	0	0	0	0
12:66152320:A:G	1707	1002	12349	6537	5812	6	3	2
12:66211448:A:G	2	1	2	1	1	1.0	0.5	0.5
12:66331380:C:T	4	3	4	1	3	1.0	0.0	1.0
12:66338084:C:A	1	0	1	1	0	1	1	0
12:67312686:G:A	12	8	16	5	11	1.0	0.0	1.0
12:67651623:G:A	0	0	0	0	0	0	0	0
12:68326847:G:A	26	14	32	12	20	1.0	0.0	1.0
12:68331171:G:T	73	39	83	41	42	1	0	1
12:68642831:C:A	10	1	25	24	1	2.0	2.0	0.0
12:68808384:A:G	235	120	365	192	173	1	1	1
12:69350234:C:A	143	73	164	81	83	1	1	1
12:69350324:C:T	0	0	0	0	0	0	0	0
12:69643740:G:A	0	0	0	0	0	0	0	0
12:70590115:A:C	0	0	0	0	0	0	0	0
12:70594507:A:G	0	0	0	0	0	0	0	0
12:71115872:T:A	0	0	0	0	0	0	0	0
12:71129354:A:C	0	0	0	0	0	0	0	0
12:71139754:C:G	0	0	0	0	0	0	0	0
12:71584007:T:C	0	0	0	0	0	0	0	0
12:71614641:T:C	12	8	21	12	9	1.0	0.0	1.0
12:75207609:G:A	0	0	0	0	0	0	0	0
12:75207663:G:A	0	0	0	0	0	0	0	0
12:75321550:C:A	0	0	0	0	0	0	0	0
12:76822501:G:A	2	2	9	0	9	4.5	0.0	4.5
12:78148919:T:C	0	0	0	0	0	0	0	0
12:78168838:A:G	0	0	0	0	0	0	0	0
12:78205111:G:A	0	0	0	0	0	0	0	0
12:80102904:C:G	6	6	6	0	6	1.0	0.0	1.0
12:80103045:T:C	17	17	17	0	17	1	0	1
12:80103148:G:A	0	0	0	0	0	0	0	0
12:80472169:A:G	0	0	0	0	0	0	0	0
12:80506122:C:A	0	0	0	0	0	0	0	0
12:80506618:C:G	0	0	0	0	0	0	0	0
12:80542247:A:G	0	0	0	0	0	0	0	0
12:80542303:C:T	0	0	0	0	0	0	0	0
12:81233459:C:T	0	0	0	0	0	0	0	0
12:81375802:C:T	0	0	0	0	0	0	0	0
12:81439966:G:T	0	0	0	0	0	0	0	0
12:84883829:C:T	0	0	0	0	0	0	0	0
12:85055687:T:A	0	0	0	0	0	0	0	0
12:87986011:C:T	0	0	0	0	0	0	0	0
12:87986317:T:C	0	0	0	0	0	0	0	0
12:92168708:T:C	0	0	0	0	0	0	0	0
12:92754131:A:T	4	1	6	5	1	1.0	1.0	0.0
12:92756326:T:C	5	4	15	1	14	2	0	2
12:92761759:G:A	31	17	87	41	46	2	0	1
12:92802646:T:G	8	3	8	5	3	1.0	1.0	0.0
12:92858715:G:T	0	0	0	0	0	0	0	0
12:92858751:A:G	0	0	0	0	0	0	0	0
12:92884284:C:T	0	0	0	0	0	0	0	0
12:92884647:A:G	2	0	7	7	0	3.5	3.5	0.0
12:94548447:T:C	12	12	12	0	12	1.0	0.0	1.0
12:94548534:T:C	42	0	42	42	0	1.0	1.0	0.0
12:94549280:C:A	1	1	1	0	1	1	0	1
12:94578514:C:T	5	2	10	8	2	1	1	0
12:94582308:T:C	15	6	15	9	6	1	1	0
12:95286821:G:A	1	0	6	6	0	6	6	0
12:95672386:C:T	0	0	0	0	0	0	0	0
12:95952816:T:C	16	9	36	13	23	2.0	0.0	1.0
12:95987197:A:G	0	0	0	0	0	0	0	0
12:95990344:T:C	0	0	0	0	0	0	0	0
12:95990361:T:C	0	0	0	0	0	0	0	0
12:95990471:T:C	1	1	1	0	1	1	0	1
12:95993987:T:A	0	0	0	0	0	0	0	0
12:96630159:A:C	0	0	0	0	0	0	0	0
12:96644276:G:A	0	0	0	0	0	0	0	0
12:98454918:C:T	0	0	0	0	0	0	0	0
12:98626347:T:C	2	0	2	2	0	1.0	1.0	0.0
12:98773027:G:T	0	0	0	0	0	0	0	0
12:99648262:C:G	0	0	0	0	0	0	0	0
12:99648385:A:G	0	0	0	0	0	0	0	0
12:100058249:T:C	4	2	12	10	2	1.0	0.5	0.5
12:100157218:G:A	5	2	15	5	10	2	1	0
12:100263686:T:C	3	2	3	1	2	1	0	1
12:100420198:A:C	0	0	0	0	0	0	0	0
12:100578871:A:T	0	0	0	0	0	0	0	0
12:100623667:T:C	0	0	0	0	0	0	0	0
12:100624236:T:C	0	0	0	0	0	0	0	0
12:100942423:G:C	0	0	0	0	0	0	0	0
12:101068778:C:T	1	0	1	1	0	1	1	0
12:101157295:T:G	0	0	0	0	0	0	0	0
12:101158297:G:A	0	0	0	0	0	0	0	0
12:101299756:C:G	0	0	0	0	0	0	0	0
12:101338877:C:T	2	1	8	7	1	4.0	3.5	0.5
12:101642527:C:T	0	0	0	0	0	0	0	0
12:101653237:C:T	0	0	0	0	0	0	0	0
12:102123975:T:C	25	17	40	14	26	1	0	1
12:102843690:G:C	0	0	0	0	0	0	0	0
12:102855146:C:T	0	0	0	0	0	0	0	0
12:102877415:G:A	0	0	0	0	0	0	0	0
12:102913805:A:G	0	0	0	0	0	0	0	0
12:102917201:T:G	0	0	0	0	0	0	0	0
12:103478394:T:G	0	0	0	0	0	0	0	0
12:103674034:C:T	0	0	0	0	0	0	0	0
12:103706839:C:T	0	0	0	0	0	0	0	0
12:103730240:A:C	0	0	0	0	0	0	0	0
12:103759226:C:G	0	0	0	0	0	0	0	0
12:103861154:G:A	1	0	1	1	0	1	1	0
12:103915650:G:C	0	0	0	0	0	0	0	0
12:103931681:G:C	16	9	17	7	10	1.0	0.0	1.0
12:104315781:C:T	37	18	42	21	21	1	1	0
12:106016643:A:T	2	0	2	2	0	1.0	1.0	0.0
12:106067078:A:G	0	0	0	0	0	0	0	0
12:106067160:G:C	0	0	0	0	0	0	0	0
12:106172396:A:C	0	0	0	0	0	0	0	0
12:106239791:C:T	22	16	22	6	16	1.0	0.0	1.0
12:106254087:C:T	23	0	77	77	0	3	3	0
12:106329412:A:G	5	0	13	13	0	1	1	0
12:106500085:G:T	0	0	0	0	0	0	0	0
12:106500152:A:T	0	0	0	0	0	0	0	0
12:106696423:T:C	0	0	0	0	0	0	0	0
12:107001328:A:G	0	0	0	0	0	0	0	0
12:108224853:C:T	1	1	1	0	1	1	0	1
12:108523384:G:T	12	7	16	9	7	1.0	0.0	1.0
12:108524369:C:T	13	5	13	8	5	1	1	0
12:108525613:T:C	1	1	4	0	4	4	0	4
12:108530173:A:G	16	9	16	7	9	1.0	0.0	1.0
12:108539140:C:T	0	0	0	0	0	0	0	0
12:108561047:C:T	70	37	75	34	41	1.0	0.0	1.0
12:109139930:C:T	0	0	0	0	0	0	0	0
12:109191652:C:T	0	0	0	0	0	0	0	0
12:109237224:T:C	0	0	0	0	0	0	0	0
12:109803033:T:G	0	0	0	0	0	0	0	0
12:109915367:T:C	0	0	0	0	0	0	0	0
12:110342302:G:A	3	1	3	2	1	1	1	0
12:110501616:T:C	27	10	39	24	15	1	1	0
12:110537085:T:C	1	1	1	0	1	1	0	1
12:110915752:A:G	0	0	0	0	0	0	0	0
12:112881795:C:T	0	0	0	0	0	0	0	0
12:112887824:T:C	0	0	0	0	0	0	0	0
12:112919432:G:C	44	19	66	29	37	1.0	1.0	0.0
12:112919637:G:A	52	24	58	34	24	1.0	1.0	0.0
12:112931954:G:C	16	16	33	0	33	1.0	0.0	1.0
12:112938583:G:A	14	13	15	1	14	1.0	0.0	1.0
12:112948974:C:G	0	0	0	0	0	0	0	0
12:112949145:T:C	0	0	0	0	0	0	0	0
12:112965879:C:T	0	0	0	0	0	0	0	0
12:112997645:A:T	14	9	25	6	19	1.0	0.0	1.0
12:113302637:A:G	0	0	0	0	0	0	0	0
12:113302662:G:A	1	1	3	0	3	3	0	3
12:113823248:G:A	1	1	1	0	1	1	0	1
12:114355435:C:T	0	0	0	0	0	0	0	0
12:114588579:G:A	0	0	0	0	0	0	0	0
12:117028052:T:C	2	2	2	0	2	1.0	0.0	1.0
12:117555259:C:T	0	0	0	0	0	0	0	0
12:117582310:G:A	0	0	0	0	0	0	0	0
12:118071386:G:A	0	0	0	0	0	0	0	0
12:118082365:G:A	0	0	0	0	0	0	0	0
12:119151157:G:A	0	0	0	0	0	0	0	0
12:119428728:A:G	0	0	0	0	0	0	0	0
12:119629756:T:C	0	0	0	0	0	0	0	0
12:119710558:C:T	0	0	0	0	0	0	0	0
12:119713688:T:C	0	0	0	0	0	0	0	0
12:120151356:A:G	3	2	4	1	3	1	0	1
12:120199396:G:A	3265	3240	55213	27547	27666	14	7	7
12:120282443:T:C	60	0	61	61	0	1.0	1.0	0.0
12:120324962:C:T	0	0	0	0	0	0	0	0
12:120325034:A:G	2	2	2	0	2	1.0	0.0	1.0
12:120353350:C:T	0	0	0	0	0	0	0	0
12:120575949:T:C	32	15	39	20	19	1.0	1.0	0.0
12:121162450:T:C	10	5	21	7	14	1.5	0.5	0.5
12:121167552:G:A	4	2	12	3	9	3.0	0.5	2.0
12:121175426:G:A	8	6	33	4	29	4.0	0.0	3.5
12:121184501:A:C	4	1	4	3	1	1.0	1.0	0.0
12:121222984:T:C	10	6	14	7	7	1.0	0.0	1.0
12:121228843:A:G	5	1	5	4	1	1	1	0
12:121253293:G:A	3	1	10	3	7	2	1	0
12:121641283:C:T	22	4	27	23	4	1.0	1.0	0.0
12:121641535:T:C	7	2	7	5	2	1	1	0
12:121915890:A:G	25	13	33	14	19	1	0	1
12:121931856:C:T	0	0	0	0	0	0	0	0
12:121958489:C:T	0	0	0	0	0	0	0	0
12:122191466:A:C	0	0	0	0	0	0	0	0
12:122204614:C:G	0	0	0	0	0	0	0	0
12:122204634:C:G	0	0	0	0	0	0	0	0
12:122327956:G:C	11	7	13	4	9	1	0	1
12:122333033:A:G	9	4	12	6	6	1	1	0
12:122715700:G:C	0	0	0	0	0	0	0	0
12:122716146:A:G	0	0	0	0	0	0	0	0
12:122716221:T:G	0	0	0	0	0	0	0	0
12:122716390:T:G	0	0	0	0	0	0	0	0
12:122848518:C:T	174	70	247	144	103	1.0	1.0	0.0
12:122861189:C:G	12	3	13	10	3	1.0	1.0	0.0
12:123161256:G:A	6	6	9	0	9	1.0	0.0	1.0
12:123253718:G:A	227	101	267	156	111	1	1	0
12:123253947:C:T	80	37	86	44	42	1.0	1.0	0.0
12:123309557:G:T	10	4	13	7	6	1.0	1.0	0.0
12:123315391:C:T	6	4	11	4	7	1.0	0.0	1.0
12:123633862:G:A	10	5	13	6	7	1.0	0.5	0.5
12:123813530:C:T	0	0	0	0	0	0	0	0
12:123841430:T:G	0	0	0	0	0	0	0	0
12:123903027:G:A	0	0	0	0	0	0	0	0
12:123903039:A:G	0	0	0	0	0	0	0	0
12:123937715:G:A	14	8	15	7	8	1.0	0.0	1.0
12:123942759:T:A	13	7	14	6	8	1	0	1
12:124314255:C:T	0	0	0	0	0	0	0	0
12:124341916:C:T	8	4	15	5	10	1.0	0.5	0.5
12:124355399:T:C	0	0	0	0	0	0	0	0
12:124800202:A:G	0	0	0	0	0	0	0	0
12:124912818:A:G	194	90	233	132	101	1.0	1.0	0.0
12:124913493:G:C	2527	1597	6226	3699	2527	2	1	1
12:124950170:G:A	13	4	22	16	6	1	1	0
12:124966941:C:T	0	0	0	0	0	0	0	0
12:125349549:C:A	0	0	0	0	0	0	0	0
12:128705396:G:A	0	0	0	0	0	0	0	0
12:128705929:G:A	0	0	0	0	0	0	0	0
12:128706172:C:T	0	0	0	0	0	0	0	0
12:130812335:G:T	0	0	0	0	0	0	0	0
12:130812363:C:G	0	0	0	0	0	0	0	0
12:130821769:C:G	20	11	21	9	12	1.0	0.0	1.0
12:131105859:G:A	0	0	0	0	0	0	0	0
12:131753205:C:T	12	6	14	6	8	1.0	0.5	0.5
12:131838705:C:G	3	0	3	3	0	1	1	0
12:131841753:G:A	1	0	1	1	0	1	1	0
12:132029743:C:G	9	5	16	7	9	1	0	1
12:132032111:C:T	4	1	6	5	1	1.0	1.0	0.0
12:132062617:G:A	2	2	2	0	2	1.0	0.0	1.0
12:132064817:G:A	9	7	18	2	16	1	0	1
12:132076412:C:T	0	0	0	0	0	0	0	0
12:132104188:G:A	9	6	32	15	17	3	0	1
12:132108686:C:T	11	5	16	8	8	1	1	0
12:132604813:T:C	0	0	0	0	0	0	0	0
12:132606232:G:A	0	0	0	0	0	0	0	0
12:132620010:T:C	0	0	0	0	0	0	0	0
12:132625361:T:C	0	0	0	0	0	0	0	0
12:132626154:C:T	1	0	1	1	0	1	1	0
12:132632393:T:C	2	2	2	0	2	1.0	0.0	1.0
12:132635996:G:A	1	0	1	1	0	1	1	0
12:132643245:T:C	2	1	2	1	1	1.0	0.5	0.5
12:132659414:C:T	0	0	0	0	0	0	0	0
12:132730003:C:T	17	8	17	9	8	1	1	0
12:132735358:T:C	5	3	5	2	3	1	0	1
12:132754951:G:A	83	46	88	38	50	1	0	1
12:132780826:T:C	6	2	11	8	3	1.0	1.0	0.0
12:132801854:C:T	2	1	2	1	1	1.0	0.5	0.5
12:132847076:C:T	2	1	4	1	3	2.0	0.5	1.5
12:132851656:G:A	3	0	3	3	0	1	1	0
12:132862416:G:A	1	0	1	1	0	1	1	0
12:133058535:C:G	4	0	4	4	0	1.0	1.0	0.0
12:133156038:C:T	2	1	2	1	1	1.0	0.5	0.5
12:133203723:G:T	3	2	4	1	3	1	0	1
12:133219299:G:A	0	0	0	0	0	0	0	0
13:18176081:G:A	0	0	0	0	0	0	0	0
13:18178089:T:C	0	0	0	0	0	0	0	0
13:18219044:A:G	0	0	0	0	0	0	0	0
13:18334914:C:T	0	0	0	0	0	0	0	0
13:18727384:A:G	0	0	0	0	0	0	0	0
13:18837994:G:A	0	0	0	0	0	0	0	0
13:19304819:C:T	0	0	0	0	0	0	0	0
13:19369630:A:G	0	0	0	0	0	0	0	0
13:19375015:T:G	0	0	0	0	0	0	0	0
13:19375078:C:T	0	0	0	0	0	0	0	0
13:19375087:C:T	0	0	0	0	0	0	0	0
13:19376218:A:G	0	0	0	0	0	0	0	0
13:19376255:GAGCC:AAGCT	0	0	0	0	0	0	0	0
13:19378909:C:T	0	0	0	0	0	0	0	0
13:19378971:G:A	0	0	0	0	0	0	0	0
13:19382513:T:C	2	0	2	2	0	1.0	1.0	0.0
13:19382653:A:G	2	0	2	2	0	1.0	1.0	0.0
13:19382831:G:C	0	0	0	0	0	0	0	0
13:19382860:T:C	0	0	0	0	0	0	0	0
13:19703273:T:C	14	0	18	18	0	1.0	1.0	0.0
13:19772289:T:C	20	10	29	12	17	1.0	0.5	0.5
13:20512460:G:A	276	144	426	226	200	1.0	1.0	1.0
13:20631053:G:A	3	2	7	1	6	1	0	1
13:20663274:G:A	4	2	23	17	6	4.5	2.0	0.5
13:20855637:T:C	1	1	1	0	1	1	0	1
13:20961566:G:A	29	0	29	29	0	1	1	0
13:21045946:T:C	0	0	0	0	0	0	0	0
13:21103192:T:C	0	0	0	0	0	0	0	0
13:21140781:G:A	10	7	29	15	14	2.0	0.0	1.0
13:21168172:C:T	0	0	0	0	0	0	0	0
13:21628774:C:T	2	0	2	2	0	1.0	1.0	0.0
13:22916111:C:A	0	0	0	0	0	0	0	0
13:22916257:C:T	0	0	0	0	0	0	0	0
13:23234643:T:C	0	0	0	0	0	0	0	0
13:23250644:T:G	0	0	0	0	0	0	0	0
13:23331572:A:G	2	0	2	2	0	1.0	1.0	0.0
13:23333770:A:G	0	0	0	0	0	0	0	0
13:23333895:A:G	0	0	0	0	0	0	0	0
13:24122369:C:T	0	0	0	0	0	0	0	0
13:24122526:T:C	0	0	0	0	0	0	0	0
13:24122545:G:A	0	0	0	0	0	0	0	0
13:24122681:G:A	0	0	0	0	0	0	0	0
13:24122715:A:G	0	0	0	0	0	0	0	0
13:24449798:C:T	7	4	7	3	4	1	0	1
13:24455080:C:T	11	4	14	8	6	1	1	0
13:24459062:T:A	10	5	18	9	9	1.0	0.5	0.5
13:24494670:A:T	11	6	15	5	10	1	0	1
13:24500352:C:T	33	11	42	28	14	1	1	0
13:24698695:G:A	0	0	0	0	0	0	0	0
13:24698732:C:T	0	0	0	0	0	0	0	0
13:24793144:A:C	0	0	0	0	0	0	0	0
13:24793163:C:T	0	0	0	0	0	0	0	0
13:24988766:A:G	0	0	0	0	0	0	0	0
13:25017517:A:G	0	0	0	0	0	0	0	0
13:25096924:A:G	5	0	5	5	0	1	1	0
13:25301873:G:A	543	295	3323	1644	1679	5	1	1
13:25365934:T:C	2	0	2	2	0	1.0	1.0	0.0
13:25574828:C:T	0	0	0	0	0	0	0	0
13:27273413:C:G	0	0	0	0	0	0	0	0
13:27665701:T:C	598	323	713	347	366	1.0	1.0	1.0
13:27665803:G:C	370	178	423	237	186	1.0	1.0	0.0
13:27792924:A:G	0	0	0	0	0	0	0	0
13:28050157:G:A	0	0	0	0	0	0	0	0
13:28107758:C:G	0	0	0	0	0	0	0	0
13:28308924:G:A	3	2	4	1	3	1	0	1
13:28319505:A:G	1	0	2	2	0	2	2	0
13:28599212:G:A	0	0	0	0	0	0	0	0
13:28723622:G:A	0	0	0	0	0	0	0	0
13:29532930:G:C	1	0	1	1	0	1	1	0
13:30657669:T:C	11	7	12	4	8	1	0	1
13:30658926:G:A	7	1	11	10	1	1	1	0
13:31151123:A:G	2	2	2	0	2	1.0	0.0	1.0
13:31154529:G:A	1	0	1	1	0	1	1	0
13:31155592:A:G	20	4	22	18	4	1.0	1.0	0.0
13:31161622:G:A	85	42	91	45	46	1	1	0
13:31483515:G:A	0	0	0	0	0	0	0	0
13:31786410:A:G	0	0	0	0	0	0	0	0
13:32101977:A:G	0	0	0	0	0	0	0	0
13:32173517:C:A	0	0	0	0	0	0	0	0
13:32202016:T:C	0	0	0	0	0	0	0	0
13:32202466:T:C	0	0	0	0	0	0	0	0
13:32202479:T:A	0	0	0	0	0	0	0	0
13:32210949:G:A	0	0	0	0	0	0	0	0
13:32332592:A:C	3	0	4	4	0	1	1	0
13:32332722:A:G	2	0	2	2	0	1.0	1.0	0.0
13:33060846:C:T	0	0	0	0	0	0	0	0
13:33129519:T:C	0	0	0	0	0	0	0	0
13:33349177:T:C	0	0	0	0	0	0	0	0
13:33439710:G:C	0	0	0	0	0	0	0	0
13:35810894:G:T	0	0	0	0	0	0	0	0
13:36112001:T:C	0	0	0	0	0	0	0	0
13:37006002:G:A	212	104	290	149	141	1.0	1.0	0.0
13:37009694:G:A	19	10	22	9	13	1	0	1
13:37026147:G:A	0	0	0	0	0	0	0	0
13:37105131:G:T	0	0	0	0	0	0	0	0
13:37564552:C:T	0	0	0	0	0	0	0	0
13:37582401:C:T	0	0	0	0	0	0	0	0
13:37598730:G:A	0	0	0	0	0	0	0	0
13:38856177:C:T	0	0	0	0	0	0	0	0
13:38859469:A:G	0	0	0	0	0	0	0	0
13:39655754:G:A	11	6	11	5	6	1	0	1
13:39655820:T:A	56	23	67	38	29	1.0	1.0	0.0
13:39656157:T:C	1	0	1	1	0	1	1	0
13:41927347:T:G	0	0	0	0	0	0	0	0
13:42069058:G:A	0	0	0	0	0	0	0	0
13:42070444:A:T	0	0	0	0	0	0	0	0
13:42302154:A:C	6	2	6	4	2	1.0	1.0	0.0
13:42574429:T:C	0	0	0	0	0	0	0	0
13:42888286:A:T	16	8	16	8	8	1.0	0.5	0.5
13:42895021:G:A	29	16	37	20	17	1	0	1
13:42895075:G:A	30	16	51	32	19	1.0	0.0	1.0
13:43023729:A:G	830	415	1167	623	544	1.0	1.0	0.5
13:43837274:G:A	6	1	6	5	1	1.0	1.0	0.0
13:43883848:A:G	1	1	2	0	2	2	0	2
13:43969390:C:A	0	0	0	0	0	0	0	0
13:43969539:G:A	0	0	0	0	0	0	0	0
13:44575559:G:A	0	0	0	0	0	0	0	0
13:45493458:G:A	2	0	3	3	0	1.5	1.5	0.0
13:45985568:T:C	15	7	16	9	7	1	1	0
13:46372022:C:T	134	75	184	86	98	1.0	0.0	1.0
13:46779966:C:T	29	16	54	22	32	1	0	1
13:46895805:G:A	0	0	0	0	0	0	0	0
13:47763635:T:C	17	0	18	18	0	1	1	0
13:48707418:A:G	0	0	0	0	0	0	0	0
13:49187651:C:T	13	3	30	10	20	1	1	0
13:49201861:A:G	5	3	8	4	4	1	0	1
13:49220514:C:A	0	0	0	0	0	0	0	0
13:49292733:G:C	3	2	3	1	2	1	0	1
13:49552246:G:A	2	0	5	5	0	2.5	2.5	0.0
13:49567209:G:A	64	33	86	43	43	1.0	0.0	1.0
13:51020605:T:G	0	0	0	0	0	0	0	0
13:51908958:T:C	0	0	0	0	0	0	0	0
13:52135802:A:C	7	3	16	5	11	1	1	0
13:52156124:T:A	96	43	174	84	90	1.0	1.0	0.0
13:52642900:C:A	6	1	6	5	1	1.0	1.0	0.0
13:52643135:A:G	3	3	4	0	4	1	0	1
13:54440946:G:A	1	0	1	1	0	1	1	0
13:54441264:G:T	0	0	0	0	0	0	0	0
13:57173540:G:T	0	0	0	0	0	0	0	0
13:58528741:T:C	0	0	0	0	0	0	0	0
13:58530676:C:G	0	0	0	0	0	0	0	0
13:58530739:T:C	0	0	0	0	0	0	0	0
13:60274914:C:T	0	0	0	0	0	0	0	0
13:60637743:T:G	0	0	0	0	0	0	0	0
13:61412785:C:A	0	0	0	0	0	0	0	0
13:63811499:C:T	0	0	0	0	0	0	0	0
13:67226803:G:A	0	0	0	0	0	0	0	0
13:67832170:ATATA:GTATG	0	0	0	0	0	0	0	0
13:68985238:T:G	0	0	0	0	0	0	0	0
13:68985602:C:T	0	0	0	0	0	0	0	0
13:72775221:G:C	7	4	11	5	6	1	0	1
13:72775941:T:C	2	1	2	1	1	1.0	0.5	0.5
13:72795504:A:G	11	8	26	3	23	1	0	1
13:73764967:G:T	14	7	33	20	13	2.0	0.5	0.5
13:75302253:G:A	0	0	0	0	0	0	0	0
13:75760973:A:G	6	2	8	4	4	1.0	1.0	0.0
13:75807543:T:C	0	0	0	0	0	0	0	0
13:75821484:C:T	1	0	1	1	0	1	1	0
13:75853211:C:A	4	3	4	1	3	1.0	0.0	1.0
13:75853267:G:A	3	2	3	1	2	1	0	1
13:75853274:C:G	3	2	3	1	2	1	0	1
13:75871180:C:T	0	0	0	0	0	0	0	0
13:76991837:A:G	1	1	3	0	3	3	0	3
13:76991955:C:T	4	1	12	11	1	1.5	1.5	0.0
13:77051811:C:T	40	19	50	29	21	1.0	1.0	0.0
13:77058335:C:T	35	13	82	52	30	1	1	0
13:77166442:T:C	4	3	4	1	3	1.0	0.0	1.0
13:77599358:C:A	0	0	0	0	0	0	0	0
13:77662181:G:A	0	0	0	0	0	0	0	0
13:79090952:T:C	0	0	0	0	0	0	0	0
13:80336716:A:C	0	0	0	0	0	0	0	0
13:80337390:G:A	0	0	0	0	0	0	0	0
13:81690208:A:G	256	256	267	0	267	1.0	0.0	1.0
13:81690333:G:A	191	0	210	210	0	1	1	0
13:83907489:G:A	0	0	0	0	0	0	0	0
13:85794985:C:T	0	0	0	0	0	0	0	0
13:89361962:T:A	0	0	0	0	0	0	0	0
13:94621193:G:A	6	1	24	23	1	3.0	3.0	0.0
13:94758254:G:T	0	0	0	0	0	0	0	0
13:94758756:G:A	0	0	0	0	0	0	0	0
13:94759055:T:A	0	0	0	0	0	0	0	0
13:94759085:T:C	0	0	0	0	0	0	0	0
13:94759196:A:G	0	0	0	0	0	0	0	0
13:95854410:A:G	0	0	0	0	0	0	0	0
13:95887950:T:G	0	0	0	0	0	0	0	0
13:96987160:C:T	0	0	0	0	0	0	0	0
13:98244522:C:T	0	0	0	0	0	0	0	0
13:98437786:T:G	0	0	0	0	0	0	0	0
13:98448220:C:T	0	0	0	0	0	0	0	0
13:98448293:T:C	0	0	0	0	0	0	0	0
13:98453141:G:A	29	15	34	17	17	1	1	1
13:98456475:G:A	1	0	1	1	0	1	1	0
13:98640887:G:T	4	0	4	4	0	1.0	1.0	0.0
13:98723927:C:T	0	0	0	0	0	0	0	0
13:99866326:A:G	6	4	6	2	4	1.0	0.0	1.0
13:99983123:C:T	0	0	0	0	0	0	0	0
13:102739284:C:T	0	0	0	0	0	0	0	0
13:102741653:G:A	0	0	0	0	0	0	0	0
13:102742263:T:G	0	0	0	0	0	0	0	0
13:102742366:T:C	0	0	0	0	0	0	0	0
13:102744366:C:G	0	0	0	0	0	0	0	0
13:102745233:C:G	0	0	0	0	0	0	0	0
13:102745587:T:G	0	0	0	0	0	0	0	0
13:102747733:G:A	0	0	0	0	0	0	0	0
13:102748379:G:A	0	0	0	0	0	0	0	0
13:102750172:C:T	0	0	0	0	0	0	0	0
13:102758432:T:C	0	0	0	0	0	0	0	0
13:102758564:A:T	0	0	0	0	0	0	0	0
13:102796852:T:C	0	0	0	0	0	0	0	0
13:102852167:T:C	131	66	183	94	89	1	1	1
13:102875652:G:C	49	24	167	80	87	3	1	0
13:103065958:C:T	0	0	0	0	0	0	0	0
13:105467097:G:A	0	0	0	0	0	0	0	0
13:105489886:C:T	0	0	0	0	0	0	0	0
13:110161362:G:A	0	0	0	0	0	0	0	0
13:110166251:T:G	0	0	0	0	0	0	0	0
13:110175227:T:A	0	0	0	0	0	0	0	0
13:110175233:C:T	0	0	0	0	0	0	0	0
13:110181355:C:T	0	0	0	0	0	0	0	0
13:110198495:A:G	0	0	0	0	0	0	0	0
13:110209921:A:C	0	0	0	0	0	0	0	0
13:110209956:G:A	0	0	0	0	0	0	0	0
13:110687995:G:A	22	10	25	12	13	1.0	1.0	0.0
13:110705653:T:G	2	2	2	0	2	1.0	0.0	1.0
13:112376360:G:A	0	0	0	0	0	0	0	0
13:112398074:A:G	0	0	0	0	0	0	0	0
13:112399156:T:A	0	0	0	0	0	0	0	0
13:113090127:C:T	1	0	1	1	0	1	1	0
13:113091088:C:T	0	0	0	0	0	0	0	0
13:113158648:G:A	0	0	0	0	0	0	0	0
13:113768927:C:T	0	0	0	0	0	0	0	0
13:114015288:A:G	12	7	14	5	9	1.0	0.0	1.0
13:114017303:G:A	9	4	14	6	8	1	1	0
13:114236830:G:A	246	93	317	212	105	1.0	1.0	0.0
13:114265239:T:C	33	23	42	12	30	1	0	1
13:114281989:C:T	63	28	77	40	37	1	1	0
14:18636905:T:G	0	0	0	0	0	0	0	0
14:18645142:C:T	0	0	0	0	0	0	0	0
14:18699361:C:T	0	0	0	0	0	0	0	0
14:19668925:A:G	0	0	0	0	0	0	0	0
14:19669976:C:T	0	0	0	0	0	0	0	0
14:19747830:A:G	0	0	0	0	0	0	0	0
14:19780669:C:T	0	0	0	0	0	0	0	0
14:19781017:G:A	0	0	0	0	0	0	0	0
14:19935932:G:A	0	0	0	0	0	0	0	0
14:19936455:C:A	0	0	0	0	0	0	0	0
14:19976331:C:T	0	0	0	0	0	0	0	0
14:20117883:G:C	0	0	0	0	0	0	0	0
14:20118273:C:T	0	0	0	0	0	0	0	0
14:20197631:T:A	0	0	0	0	0	0	0	0
14:20197681:G:A	0	0	0	0	0	0	0	0
14:20243652:A:G	0	0	0	0	0	0	0	0
14:20296426:A:C	12	6	16	6	10	1.0	0.5	0.5
14:20369542:G:C	13	4	38	28	10	1	1	0
14:20373548:C:T	6	4	9	2	7	1.0	0.0	1.0
14:20383870:A:G	2	1	8	7	1	4.0	3.5	0.5
14:20384658:G:A	2	0	2	2	0	1.0	1.0	0.0
14:20408094:A:G	10	5	11	6	5	1.0	0.5	0.5
14:20428905:C:T	0	0	0	0	0	0	0	0
14:20429517:T:C	2	1	2	1	1	1.0	0.5	0.5
14:20456995:T:G	54	29	76	34	42	1.0	0.0	1.0
14:20556627:A:G	0	0	0	0	0	0	0	0
14:20558614:C:T	0	0	0	0	0	0	0	0
14:20584100:T:C	0	0	0	0	0	0	0	0
14:20640982:C:T	0	0	0	0	0	0	0	0
14:20641119:A:T	0	0	0	0	0	0	0	0
14:20641226:C:T	0	0	0	0	0	0	0	0
14:20641512:A:G	0	0	0	0	0	0	0	0
14:20641567:G:A	0	0	0	0	0	0	0	0
14:20721513:T:C	0	0	0	0	0	0	0	0
14:20722355:A:C	0	0	0	0	0	0	0	0
14:20747838:C:T	0	0	0	0	0	0	0	0
14:20999754:T:G	0	0	0	0	0	0	0	0
14:21032890:G:T	0	0	0	0	0	0	0	0
14:21032936:T:C	0	0	0	0	0	0	0	0
14:21034186:A:G	0	0	0	0	0	0	0	0
14:21082899:G:A	1	1	3	0	3	3	0	3
14:21162664:C:T	7	0	7	7	0	1	1	0
14:21163339:T:C	0	0	0	0	0	0	0	0
14:21163398:A:G	0	0	0	0	0	0	0	0
14:21321881:G:T	0	0	0	0	0	0	0	0
14:21324652:G:A	0	0	0	0	0	0	0	0
14:21328625:G:C	0	0	0	0	0	0	0	0
14:21477256:A:G	42	22	43	21	22	1.0	0.0	1.0
14:21499294:G:A	20	9	21	11	10	1.0	1.0	0.0
14:21525504:G:C	0	0	0	0	0	0	0	0
14:21570079:G:T	0	0	0	0	0	0	0	0
14:21570431:T:C	0	0	0	0	0	0	0	0
14:21570528:T:C	0	0	0	0	0	0	0	0
14:21586274:T:C	0	0	0	0	0	0	0	0
14:21602747:G:T	0	0	0	0	0	0	0	0
14:21602793:G:A	0	0	0	0	0	0	0	0
14:21665202:G:A	0	0	0	0	0	0	0	0
14:21918274:C:T	0	0	0	0	0	0	0	0
14:21924107:A:G	0	0	0	0	0	0	0	0
14:21924128:A:G	0	0	0	0	0	0	0	0
14:21924450:C:A	0	0	0	0	0	0	0	0
14:21924527:C:G	0	0	0	0	0	0	0	0
14:21941429:T:G	0	0	0	0	0	0	0	0
14:21941580:A:G	0	0	0	0	0	0	0	0
14:21978648:T:C	1	0	2	2	0	2	2	0
14:22008151:C:A	0	0	0	0	0	0	0	0
14:22112809:G:A	0	0	0	0	0	0	0	0
14:22168888:C:A	0	0	0	0	0	0	0	0
14:22271979:A:T	0	0	0	0	0	0	0	0
14:22272362:A:G	0	0	0	0	0	0	0	0
14:22272387:G:A	0	0	0	0	0	0	0	0
14:22422892:G:C	1	0	1	1	0	1	1	0
14:22456732:C:T	0	0	0	0	0	0	0	0
14:22492867:A:G	52	32	77	36	41	1.0	0.0	1.0
14:22525319:C:T	0	0	0	0	0	0	0	0
14:22528564:G:A	0	0	0	0	0	0	0	0
14:22531112:C:T	1	0	5	5	0	5	5	0
14:22551693:T:C	38	20	56	22	34	1.0	0.0	1.0
14:22552027:T:G	12	5	12	7	5	1.0	1.0	0.0
14:22557038:T:A	5	5	12	0	12	1	0	1
14:22598133:A:G	0	0	0	0	0	0	0	0
14:22633879:A:G	0	0	0	0	0	0	0	0
14:22633977:C:A	0	0	0	0	0	0	0	0
14:22633991:A:G	0	0	0	0	0	0	0	0
14:22634064:A:G	0	0	0	0	0	0	0	0
14:22634135:C:T	0	0	0	0	0	0	0	0
14:22634377:T:C	0	0	0	0	0	0	0	0
14:22634442:T:C	0	0	0	0	0	0	0	0
14:22634449:AC:GT	0	0	0	0	0	0	0	0
14:22766599:G:A	0	0	0	0	0	0	0	0
14:22771119:T:A	59	26	91	46	45	1	1	0
14:22829926:G:T	121	60	137	69	68	1	1	0
14:22843345:C:G	0	0	0	0	0	0	0	0
14:23061413:T:C	38	15	53	35	18	1.0	1.0	0.0
14:23080110:A:G	13	6	14	8	6	1	1	0
14:23080576:T:C	24	13	33	17	16	1.0	0.0	1.0
14:23276324:C:T	3	2	9	1	8	2	0	2
14:23277060:C:G	33	17	41	19	22	1	1	1
14:23360749:G:A	0	0	0	0	0	0	0	0
14:23375770:C:A	0	0	0	0	0	0	0	0
14:23392602:A:G	0	0	0	0	0	0	0	0
14:23415680:C:T	0	0	0	0	0	0	0	0
14:23433544:G:A	0	0	0	0	0	0	0	0
14:23478039:A:T	15	9	15	6	9	1	0	1
14:23525308:A:G	0	0	0	0	0	0	0	0
14:24064330:C:A	0	0	0	0	0	0	0	0
14:24118458:C:T	12	3	20	15	5	1.5	1.0	0.0
14:24146226:T:C	810	384	1058	620	438	1.0	1.0	0.0
14:24148029:C:T	20	6	22	16	6	1.0	1.0	0.0
14:24178608:T:C	5	5	5	0	5	1	0	1
14:24188201:T:G	0	0	0	0	0	0	0	0
14:24210671:C:T	230	110	582	303	279	2.0	1.0	0.0
14:24249309:G:A	0	0	0	0	0	0	0	0
14:25267247:G:A	0	0	0	0	0	0	0	0
14:25431406:C:T	0	0	0	0	0	0	0	0
14:28264637:AGGGG:CGGGA	1	1	1	0	1	1	0	1
14:28264750:G:A	0	0	0	0	0	0	0	0
14:30630532:A:G	260	115	403	240	163	1.0	1.0	0.0
14:30885890:C:G	1	0	1	1	0	1	1	0
14:30912145:T:C	11	6	12	5	7	1	0	1
14:30956231:T:C	10	10	10	0	10	1.0	0.0	1.0
14:31113320:T:C	8	3	19	14	5	1.0	1.0	0.0
14:31178035:G:A	7	5	12	2	10	1	0	1
14:31178233:T:C	105	60	120	49	71	1	0	1
14:31944939:C:A	5	3	14	9	5	1	0	1
14:31945005:C:T	6	1	6	5	1	1.0	1.0	0.0
14:31950125:C:T	2	1	3	1	2	1.5	0.5	1.0
14:32272289:G:A	1	0	4	4	0	4	4	0
14:32545343:C:T	0	0	0	0	0	0	0	0
14:32545808:G:A	0	0	0	0	0	0	0	0
14:32823537:A:C	0	0	0	0	0	0	0	0
14:32823916:A:G	1	0	1	1	0	1	1	0
14:32824325:T:A	0	0	0	0	0	0	0	0
14:33799961:G:C	0	0	0	0	0	0	0	0
14:34593106:C:T	61	35	79	31	48	1	0	1
14:34711183:T:A	1	1	1	0	1	1	0	1
14:34740685:G:A	12	0	18	18	0	1.0	1.0	0.0
14:35121968:T:C	30	25	31	5	26	1.0	0.0	1.0
14:35123332:C:G	34	23	71	24	47	1.0	0.0	1.0
14:35235349:G:A	0	0	0	0	0	0	0	0
14:35235461:C:T	1	0	7	7	0	7	7	0
14:35292469:C:G	353	191	381	183	198	1	0	1
14:35388508:C:A	0	0	0	0	0	0	0	0
14:36477876:C:T	0	0	0	0	0	0	0	0
14:36666547:C:T	0	0	0	0	0	0	0	0
14:37591441:C:T	0	0	0	0	0	0	0	0
14:39086981:G:C	2	1	9	3	6	4.5	1.5	3.0
14:39179425:C:T	90	46	210	110	100	1.0	1.0	1.0
14:39181030:A:T	112	47	132	81	51	1.0	1.0	0.0
14:39308472:G:C	27	17	61	18	43	1	0	1
14:39314781:T:G	15	5	19	12	7	1	1	0
14:41891430:T:C	0	0	0	0	0	0	0	0
14:44120231:A:G	0	0	0	0	0	0	0	0
14:45242113:C:T	62	21	142	99	43	1.0	1.0	0.0
14:45290370:G:T	5	0	6	6	0	1	1	0
14:46957434:C:A	0	0	0	0	0	0	0	0
14:46996974:T:A	0	0	0	0	0	0	0	0
14:47059267:T:C	0	0	0	0	0	0	0	0
14:47059348:T:A	0	0	0	0	0	0	0	0
14:49598641:C:G	21	10	32	19	13	1	1	0
14:49600078:T:A	0	0	0	0	0	0	0	0
14:49601581:C:G	2	1	3	2	1	1.5	1.0	0.5
14:49621035:T:C	205	114	388	186	202	1	0	1
14:49634652:G:A	20	12	51	35	16	1.0	0.0	1.0
14:49634964:C:G	17	8	19	10	9	1	1	0
14:50051192:G:A	0	0	0	0	0	0	0	0
14:50116365:G:T	316	150	350	195	155	1.0	1.0	0.0
14:50118530:C:T	5	4	6	1	5	1	0	1
14:50150160:G:A	3	2	4	1	3	1	0	1
14:50283859:A:G	0	0	0	0	0	0	0	0
14:50302999:G:A	3	2	6	1	5	1	0	1
14:50312098:A:C	24	15	41	16	25	1.0	0.0	1.0
14:50319286:A:G	6	1	16	15	1	3.0	3.0	0.0
14:50321495:C:T	132	70	241	110	131	1.0	1.0	1.0
14:50332408:G:C	3	0	3	3	0	1	1	0
14:50336009:A:C	0	0	0	0	0	0	0	0
14:50336122:A:G	0	0	0	0	0	0	0	0
14:50591009:G:A	1	1	1	0	1	1	0	1
14:50705204:G:A	0	0	0	0	0	0	0	0
14:50757656:T:G	0	0	0	0	0	0	0	0
14:50760282:A:G	11	5	20	14	6	1	1	0
14:50770983:A:G	16	10	24	12	12	1.0	0.0	1.0
14:50858166:A:G	0	0	0	0	0	0	0	0
14:50885890:T:C	0	0	0	0	0	0	0	0
14:50904134:C:G	0	0	0	0	0	0	0	0
14:50904363:A:C	0	0	0	0	0	0	0	0
14:50905520:T:A	0	0	0	0	0	0	0	0
14:50944311:A:G	0	0	0	0	0	0	0	0
14:51245374:T:C	3	2	3	1	2	1	0	1
14:51720248:G:A	0	0	0	0	0	0	0	0
14:51917375:G:C	3	0	11	11	0	4	4	0
14:51951937:G:A	2	1	2	1	1	1.0	0.5	0.5
14:52011597:A:G	1	1	2	0	2	2	0	2
14:52015199:C:T	0	0	0	0	0	0	0	0
14:52053650:C:T	0	0	0	0	0	0	0	0
14:52155848:T:C	0	0	0	0	0	0	0	0
14:52632184:G:A	0	0	0	0	0	0	0	0
14:52881822:T:G	0	0	0	0	0	0	0	0
14:53152826:G:A	72	36	126	62	64	1.0	0.5	0.5
14:54687335:C:T	0	0	0	0	0	0	0	0
14:54788955:C:T	6	2	7	5	2	1.0	1.0	0.0
14:55138217:C:A	36	21	40	17	23	1.0	0.0	1.0
14:55298684:T:C	2	0	3	3	0	1.5	1.5	0.0
14:55350990:T:C	6	5	9	1	8	1.0	0.0	1.0
14:55351384:G:A	4	2	5	2	3	1.0	0.5	0.5
14:55351799:T:A	6	4	7	3	4	1.0	0.0	1.0
14:55351988:T:C	6	2	6	4	2	1.0	1.0	0.0
14:55397412:A:G	280	150	565	272	293	1.0	0.0	1.0
14:55766252:T:C	0	0	0	0	0	0	0	0
14:55766351:G:T	0	0	0	0	0	0	0	0
14:55766542:C:T	0	0	0	0	0	0	0	0
14:55766589:C:T	0	0	0	0	0	0	0	0
14:57040997:G:A	0	0	0	0	0	0	0	0
14:57391476:C:G	3	2	3	1	2	1	0	1
14:57471406:C:T	0	0	0	0	0	0	0	0
14:58139072:G:A	0	0	0	0	0	0	0	0
14:58364424:A:G	16	9	20	10	10	1.0	0.0	1.0
14:58371950:A:G	12	6	18	9	9	1.0	0.5	0.5
14:58371983:C:T	13	6	16	9	7	1	1	0
14:58646014:C:T	0	0	0	0	0	0	0	0
14:58794933:G:A	57	0	59	59	0	1	1	0
14:59323009:G:A	11	5	11	6	5	1	1	0
14:59330517:A:G	4	1	5	4	1	1.0	1.0	0.0
14:59473009:T:C	10	4	11	6	5	1.0	1.0	0.0
14:59484560:T:C	19	9	23	10	13	1	1	0
14:59521606:C:T	0	0	0	0	0	0	0	0
14:59538126:C:T	0	0	0	0	0	0	0	0
14:59727486:C:A	0	0	0	0	0	0	0	0
14:60144930:C:T	16	8	16	8	8	1.0	0.5	0.5
14:60144957:G:A	17	9	20	8	12	1	0	1
14:60149324:C:T	0	0	0	0	0	0	0	0
14:60466034:G:A	0	0	0	0	0	0	0	0
14:60658222:A:G	0	0	0	0	0	0	0	0
14:60713939:T:G	0	0	0	0	0	0	0	0
14:60980944:A:C	2	0	2	2	0	1.0	1.0	0.0
14:61391251:A:G	1	0	7	7	0	7	7	0
14:61740895:A:T	460	222	1907	1036	871	3.0	1.0	0.0
14:62712615:C:T	0	0	0	0	0	0	0	0
14:63942134:G:C	17	10	22	8	14	1	0	1
14:64003110:C:T	10	1	10	9	1	1.0	1.0	0.0
14:64170429:C:A	5	4	5	1	4	1	0	1
14:64173947:C:G	0	0	0	0	0	0	0	0
14:64190137:T:C	5	2	5	3	2	1	1	0
14:64190966:C:A	1	1	1	0	1	1	0	1
14:64209380:A:G	0	0	0	0	0	0	0	0
14:64214475:C:T	1	1	5	0	5	5	0	5
14:64219407:G:T	34	19	51	20	31	1.0	0.0	1.0
14:65077732:C:T	2	2	2	0	2	1.0	0.0	1.0
14:65412089:C:T	7	1	7	6	1	1	1	0
14:65412191:C:T	19	11	21	9	12	1	0	1
14:65880224:A:G	0	0	0	0	0	0	0	0
14:66681169:G:T	0	0	0	0	0	0	0	0
14:67562669:G:A	0	0	0	0	0	0	0	0
14:67586432:A:G	0	0	0	0	0	0	0	0
14:67752483:C:T	2	1	2	1	1	1.0	0.5	0.5
14:67769805:G:A	1	1	1	0	1	1	0	1
14:67782782:C:T	1	0	1	1	0	1	1	0
14:67782869:C:T	0	0	0	0	0	0	0	0
14:67790768:C:T	1	1	1	0	1	1	0	1
14:67799027:C:T	0	0	0	0	0	0	0	0
14:68421817:G:A	0	0	0	0	0	0	0	0
14:68792945:C:A	1555	927	2519	1249	1270	1	1	1
14:68878930:C:T	0	0	0	0	0	0	0	0
14:68885513:G:A	0	0	0	0	0	0	0	0
14:68887840:C:G	0	0	0	0	0	0	0	0
14:68887943:T:G	1	0	1	1	0	1	1	0
14:69796931:C:T	0	0	0	0	0	0	0	0
14:69952164:G:A	0	0	0	0	0	0	0	0
14:70167829:C:T	0	0	0	0	0	0	0	0
14:70247376:C:G	0	0	0	0	0	0	0	0
14:70457532:A:G	2	0	2	2	0	1.0	1.0	0.0
14:70457733:C:T	0	0	0	0	0	0	0	0
14:70457745:A:G	0	0	0	0	0	0	0	0
14:70457784:C:G	0	0	0	0	0	0	0	0
14:70457885:T:G	0	0	0	0	0	0	0	0
14:70458784:G:C	0	0	0	0	0	0	0	0
14:70470720:C:T	1	1	2	0	2	2	0	2
14:70581413:C:T	1	0	1	1	0	1	1	0
14:70642436:C:G	27	16	32	15	17	1	0	1
14:71588751:A:C	6	3	9	5	4	1.5	1.0	0.5
14:71650439:T:C	2	2	4	0	4	2.0	0.0	2.0
14:72478304:T:C	0	0	0	0	0	0	0	0
14:72547353:T:C	0	0	0	0	0	0	0	0
14:72562470:G:A	0	0	0	0	0	0	0	0
14:72753312:A:G	7	2	8	5	3	1	1	0
14:72938044:G:C	76	38	100	55	45	1.0	0.5	0.5
14:72942975:C:G	1	0	1	1	0	1	1	0
14:72945927:A:C	2	1	3	1	2	1.5	0.5	1.0
14:72955551:C:G	3	1	4	2	2	1	1	0
14:72981875:G:A	4	2	12	10	2	1.5	1.0	0.5
14:73251012:G:A	0	0	0	0	0	0	0	0
14:73263987:A:G	0	0	0	0	0	0	0	0
14:73276750:C:T	5	3	10	2	8	1	0	1
14:73496679:T:C	0	0	0	0	0	0	0	0
14:73573432:G:A	53	31	61	24	37	1	0	1
14:73595264:T:C	0	0	0	0	0	0	0	0
14:73730141:T:C	0	0	0	0	0	0	0	0
14:73739778:T:C	11	6	26	10	16	1	0	1
14:74023032:G:A	2	2	3	0	3	1.5	0.0	1.5
14:74047971:A:T	0	0	0	0	0	0	0	0
14:74071182:T:G	0	0	0	0	0	0	0	0
14:74072003:A:G	0	0	0	0	0	0	0	0
14:74245180:C:T	0	0	0	0	0	0	0	0
14:74483098:T:C	0	0	0	0	0	0	0	0
14:74503338:A:G	0	0	0	0	0	0	0	0
14:74552299:C:T	0	0	0	0	0	0	0	0
14:74893363:C:T	9	6	10	3	7	1	0	1
14:75070678:C:T	1	1	1	0	1	1	0	1
14:75071514:G:T	0	0	0	0	0	0	0	0
14:75107384:C:T	6	3	13	8	5	2.0	0.5	0.5
14:75124119:G:A	36	21	81	43	38	1.0	0.0	1.0
14:75124143:A:T	44	22	79	33	46	1.0	0.5	0.5
14:75238892:G:A	0	0	0	0	0	0	0	0
14:75269156:G:A	0	0	0	0	0	0	0	0
14:75280555:T:C	1	0	1	1	0	1	1	0
14:75709251:G:A	0	0	0	0	0	0	0	0
14:75902201:T:C	1	1	1	0	1	1	0	1
14:75965793:T:C	0	0	0	0	0	0	0	0
14:76076661:G:A	4	1	4	3	1	1.0	1.0	0.0
14:76634802:C:A	0	0	0	0	0	0	0	0
14:76770037:C:T	0	0	0	0	0	0	0	0
14:76773224:A:G	0	0	0	0	0	0	0	0
14:76806649:C:G	3	2	3	1	2	1	0	1
14:76826649:C:T	0	0	0	0	0	0	0	0
14:76828607:C:T	0	0	0	0	0	0	0	0
14:76837949:T:C	0	0	0	0	0	0	0	0
14:77026548:G:A	7	3	7	4	3	1	1	0
14:77301039:A:G	0	0	0	0	0	0	0	0
14:77306256:G:A	0	0	0	0	0	0	0	0
14:77377471:T:C	2	1	2	1	1	1.0	0.5	0.5
14:77377942:C:G	0	0	0	0	0	0	0	0
14:77378526:A:G	0	0	0	0	0	0	0	0
14:77459668:C:T	624	316	823	424	399	1.0	1.0	1.0
14:77462182:A:G	133	65	155	77	78	1	1	0
14:77469177:G:A	19	8	21	13	8	1	1	0
14:77484781:C:T	0	0	0	0	0	0	0	0
14:77521615:C:A	3	2	10	4	6	4	0	1
14:77557176:C:G	0	0	0	0	0	0	0	0
14:77731022:C:T	50	24	67	32	35	1.0	1.0	0.0
14:77900624:A:G	0	0	0	0	0	0	0	0
14:78243701:G:A	0	0	0	0	0	0	0	0
14:78714883:C:T	0	0	0	0	0	0	0	0
14:80203237:T:C	0	0	0	0	0	0	0	0
14:80822645:G:C	0	0	0	0	0	0	0	0
14:80955834:C:A	0	0	0	0	0	0	0	0
14:81277732:C:T	0	0	0	0	0	0	0	0
14:81916397:G:A	0	0	0	0	0	0	0	0
14:88385822:G:A	10	5	10	5	5	1.0	0.5	0.5
14:88396185:G:A	1	1	1	0	1	1	0	1
14:88469581:A:G	0	0	0	0	0	0	0	0
14:88469910:A:G	0	0	0	0	0	0	0	0
14:88472308:A:G	0	0	0	0	0	0	0	0
14:88480278:G:A	0	0	0	0	0	0	0	0
14:88621922:C:T	0	0	0	0	0	0	0	0
14:88738921:T:C	0	0	0	0	0	0	0	0
14:89284475:A:G	4	2	26	16	10	5.0	2.0	2.5
14:89738147:A:G	0	0	0	0	0	0	0	0
14:89738204:A:G	0	0	0	0	0	0	0	0
14:89924604:A:G	1	0	1	1	0	1	1	0
14:89924624:T:A	1	0	1	1	0	1	1	0
14:89932563:G:A	55	38	69	21	48	1	0	1
14:90107708:C:A	0	0	0	0	0	0	0	0
14:90695518:C:T	0	0	0	0	0	0	0	0
14:91170051:C:T	9	6	9	3	6	1	0	1
14:91170188:C:T	4	0	4	4	0	1.0	1.0	0.0
14:91204780:G:A	16	9	23	9	14	1.0	0.0	1.0
14:91307150:G:A	4	2	4	2	2	1.0	0.5	0.5
14:91604878:T:C	0	0	0	0	0	0	0	0
14:91617660:C:G	0	0	0	0	0	0	0	0
14:91974722:C:T	10	5	19	8	11	1.5	0.5	0.5
14:91993901:T:C	7	3	14	11	3	1	1	0
14:92070879:G:T	6	4	6	2	4	1.0	0.0	1.0
14:92082441:C:T	5	2	5	3	2	1	1	0
14:92083242:G:A	35	18	55	22	33	1	0	1
14:92492872:G:A	0	0	0	0	0	0	0	0
14:92492884:G:A	0	0	0	0	0	0	0	0
14:92651693:A:G	343	182	456	219	237	1	1	1
14:92940717:A:G	10	6	10	4	6	1.0	0.0	1.0
14:93925353:G:A	0	0	0	0	0	0	0	0
14:93951075:G:A	1	1	1	0	1	1	0	1
14:93964532:G:A	0	0	0	0	0	0	0	0
14:94111816:G:T	0	0	0	0	0	0	0	0
14:94288468:G:A	0	0	0	0	0	0	0	0
14:94381078:A:G	4	2	4	2	2	1.0	0.5	0.5
14:94469564:G:C	0	0	0	0	0	0	0	0
14:94587512:T:C	0	0	0	0	0	0	0	0
14:94587526:C:T	0	0	0	0	0	0	0	0
14:94587675:A:G	0	0	0	0	0	0	0	0
14:94592125:A:C	0	0	0	0	0	0	0	0
14:94612340:G:T	0	0	0	0	0	0	0	0
14:94614466:G:A	0	0	0	0	0	0	0	0
14:94643680:G:T	0	0	0	0	0	0	0	0
14:94726298:C:A	0	0	0	0	0	0	0	0
14:94726370:C:T	0	0	0	0	0	0	0	0
14:94727040:T:G	1	0	1	1	0	1	1	0
14:95439984:G:A	3	1	16	15	1	7	7	0
14:95452288:T:C	1	0	1	1	0	1	1	0
14:95457333:A:C	4	1	7	6	1	1.0	1.0	0.0
14:95533483:T:C	0	0	0	0	0	0	0	0
14:95670457:A:G	14	11	36	5	31	1.5	0.0	1.0
14:95690850:G:A	0	0	0	0	0	0	0	0
14:95711836:G:A	2	0	2	2	0	1.0	1.0	0.0
14:96276266:G:A	0	0	0	0	0	0	0	0
14:96424160:T:C	0	0	0	0	0	0	0	0
14:96456415:C:G	0	0	0	0	0	0	0	0
14:96560658:A:G	13	7	22	14	8	1	0	1
14:96833516:A:G	133	68	149	78	71	1	1	1
14:96855352:C:T	10	5	11	5	6	1.0	0.5	0.5
14:99410168:A:G	2	1	4	2	2	2.0	1.0	1.0
14:99668878:G:A	0	0	0	0	0	0	0	0
14:99865539:T:C	0	0	0	0	0	0	0	0
14:100149624:C:T	9	5	20	5	15	1	0	1
14:100292165:G:A	3	3	3	0	3	1	0	1
14:100292940:C:T	2	0	2	2	0	1.0	1.0	0.0
14:100325789:C:T	0	0	0	0	0	0	0	0
14:100326145:C:A	0	0	0	0	0	0	0	0
14:100342508:G:A	39	4	59	55	4	1	1	0
14:100366054:T:C	11	0	31	31	0	1	1	0
14:100381370:A:G	0	0	0	0	0	0	0	0
14:100381593:A:G	1	1	1	0	1	1	0	1
14:100529975:T:C	0	0	0	0	0	0	0	0
14:100734308:T:C	0	0	0	0	0	0	0	0
14:100834701:C:G	0	0	0	0	0	0	0	0
14:100884682:G:T	0	0	0	0	0	0	0	0
14:100981036:T:C	0	0	0	0	0	0	0	0
14:101041390:C:T	0	0	0	0	0	0	0	0
14:101056219:T:C	0	0	0	0	0	0	0	0
14:101979824:G:A	9	5	10	4	6	1	0	1
14:102040728:G:C	0	0	0	0	0	0	0	0
14:102341993:C:T	2	0	2	2	0	1.0	1.0	0.0
14:102348608:G:A	7	4	8	4	4	1	0	1
14:102348705:C:T	16	8	30	19	11	1.0	0.5	0.5
14:102662440:G:T	0	0	0	0	0	0	0	0
14:103100448:C:T	0	0	0	0	0	0	0	0
14:103100498:C:G	0	0	0	0	0	0	0	0
14:103110438:C:T	0	0	0	0	0	0	0	0
14:103241942:G:A	0	0	0	0	0	0	0	0
14:103561933:T:C	0	0	0	0	0	0	0	0
14:103699416:G:A	8	5	33	11	22	3.0	0.0	1.5
14:103701227:A:G	24	6	33	19	14	1.0	1.0	0.0
14:103733019:C:T	4	2	5	3	2	1.0	0.5	0.5
14:103738786:G:A	0	0	0	0	0	0	0	0
14:103762893:G:C	0	0	0	0	0	0	0	0
14:103915165:T:C	635	275	778	475	303	1	1	0
14:103970594:C:T	0	0	0	0	0	0	0	0
14:103986303:G:A	0	0	0	0	0	0	0	0
14:104014746:T:C	0	0	0	0	0	0	0	0
14:104031206:C:T	0	0	0	0	0	0	0	0
14:104176004:A:G	0	0	0	0	0	0	0	0
14:104244314:C:T	0	0	0	0	0	0	0	0
14:104877956:C:T	0	0	0	0	0	0	0	0
14:104930933:C:A	18	10	44	8	36	1.0	0.0	1.0
14:104939262:G:C	0	0	0	0	0	0	0	0
14:104939605:G:A	0	0	0	0	0	0	0	0
14:104939901:A:C	0	0	0	0	0	0	0	0
14:104940694:A:G	1	1	12	0	12	12	0	12
14:104940871:T:C	1	1	1	0	1	1	0	1
14:104941693:A:G	0	0	0	0	0	0	0	0
14:104941845:T:G	0	0	0	0	0	0	0	0
14:104941978:T:C	0	0	0	0	0	0	0	0
14:104942474:A:G	0	0	0	0	0	0	0	0
14:104942490:A:C	0	0	0	0	0	0	0	0
14:104942618:A:G	0	0	0	0	0	0	0	0
14:104943570:T:C	0	0	0	0	0	0	0	0
14:104943622:G:T	0	0	0	0	0	0	0	0
14:104943846:T:C	0	0	0	0	0	0	0	0
14:104944074:C:T	0	0	0	0	0	0	0	0
14:104944438:A:G	0	0	0	0	0	0	0	0
14:104944490:C:T	0	0	0	0	0	0	0	0
14:104944816:G:A	0	0	0	0	0	0	0	0
14:104945363:A:G	0	0	0	0	0	0	0	0
14:104945444:G:A	0	0	0	0	0	0	0	0
14:104945729:C:T	1	0	6	6	0	6	6	0
14:104946867:G:T	0	0	0	0	0	0	0	0
14:104946886:A:G	0	0	0	0	0	0	0	0
14:104947453:G:A	0	0	0	0	0	0	0	0
14:104947901:C:A	0	0	0	0	0	0	0	0
14:104947915:C:T	0	0	0	0	0	0	0	0
14:104948292:G:A	0	0	0	0	0	0	0	0
14:104948453:A:G	0	0	0	0	0	0	0	0
14:104948473:C:G	0	0	0	0	0	0	0	0
14:104948863:G:C	0	0	0	0	0	0	0	0
14:104951857:A:G	1	0	4	4	0	4	4	0
14:104951923:TGACG:AGACA	1	0	4	4	0	4	4	0
14:104952007:T:G	1	0	1	1	0	1	1	0
14:104952054:C:T	1	0	3	3	0	3	3	0
14:104954713:T:G	0	0	0	0	0	0	0	0
14:105142998:A:G	0	0	0	0	0	0	0	0
14:105144945:A:G	0	0	0	0	0	0	0	0
14:105150705:C:T	0	0	0	0	0	0	0	0
14:105624509:T:C	0	0	0	0	0	0	0	0
14:105625815:G:A	0	0	0	0	0	0	0	0
14:105643720:G:A	242	169	357	120	237	1.0	0.0	1.0
14:105643800:C:T	304	96	488	314	174	1.0	1.0	0.0
14:105644577:G:T	2001	718	3956	2979	977	1	1	0
14:105644629:C:T	2331	2066	5450	1049	4401	2	0	1
14:105668369:A:G	3	0	8	8	0	1	1	0
14:105668469:G:A	5	0	8	8	0	1	1	0
14:105668934:G:A	2	1	9	2	7	4.5	1.0	3.5
14:105707924:C:G	1151	694	1789	834	955	1	1	1
14:105742782:T:C	271	95	403	285	118	1	1	0
14:105765831:T:G	17	5	18	12	6	1	1	0
14:105769274:A:T	99	93	113	6	107	1	0	1
14:105769791:T:A	79	7	104	97	7	1	1	0
14:105769806:G:A	71	63	99	13	86	1	0	1
14:105841082:A:G	380	43	473	427	46	1.0	1.0	0.0
14:105855558:C:T	1872	461	5749	5137	612	2.0	1.0	0.0
14:106557129:C:A	0	0	0	0	0	0	0	0
14:106557201:G:T	0	0	0	0	0	0	0	0
14:106592773:G:T	0	0	0	0	0	0	0	0
14:106606199:G:T	5	5	8	0	8	2	0	2
14:106622553:C:T	0	0	0	0	0	0	0	0
14:106643556:A:G	0	0	0	0	0	0	0	0
14:106657835:C:T	0	0	0	0	0	0	0	0
14:106658177:A:G	0	0	0	0	0	0	0	0
14:106666292:A:G	0	0	0	0	0	0	0	0
14:106872984:T:G	5	1	5	4	1	1	1	0
15:20534647:C:T	0	0	0	0	0	0	0	0
15:20572607:G:A	0	0	0	0	0	0	0	0
15:22681587:A:G	0	0	0	0	0	0	0	0
15:22912200:C:G	2	1	2	1	1	1.0	0.5	0.5
15:22933876:C:T	6	1	23	15	8	2.5	2.0	0.0
15:22946839:C:T	7	1	25	24	1	3	3	0
15:22947217:G:A	35	4	80	69	11	1	1	0
15:23311393:C:T	5	2	14	11	3	1	1	0
15:23361377:G:A	0	0	0	0	0	0	0	0
15:23364391:G:C	0	0	0	0	0	0	0	0
15:23365158:C:T	0	0	0	0	0	0	0	0
15:23440328:C:T	0	0	0	0	0	0	0	0
15:23440370:C:T	0	0	0	0	0	0	0	0
15:23440436:T:C	0	0	0	0	0	0	0	0
15:23566445:C:T	0	0	0	0	0	0	0	0
15:23610664:C:A	0	0	0	0	0	0	0	0
15:25681039:G:A	0	0	0	0	0	0	0	0
15:27966775:G:A	0	0	0	0	0	0	0	0
15:28257133:A:G	2	0	2	2	0	1.0	1.0	0.0
15:28808374:C:T	0	0	0	0	0	0	0	0
15:29054816:T:C	0	0	0	0	0	0	0	0
15:29123495:A:G	0	0	0	0	0	0	0	0
15:29234075:C:T	0	0	0	0	0	0	0	0
15:29234205:G:T	0	0	0	0	0	0	0	0
15:29234521:T:C	0	0	0	0	0	0	0	0
15:29716685:G:A	0	0	0	0	0	0	0	0
15:30005555:G:A	0	0	0	0	0	0	0	0
15:30797323:A:G	0	0	0	0	0	0	0	0
15:30798398:T:C	0	0	0	0	0	0	0	0
15:30883066:C:T	0	0	0	0	0	0	0	0
15:30905361:G:A	0	0	0	0	0	0	0	0
15:30937217:T:C	5	2	12	7	5	2	1	0
15:30974944:C:T	5	4	8	1	7	1	0	1
15:31037741:G:A	0	0	0	0	0	0	0	0
15:31038110:A:G	0	0	0	0	0	0	0	0
15:31042159:C:T	0	0	0	0	0	0	0	0
15:31050541:C:T	0	0	0	0	0	0	0	0
15:31076920:A:G	0	0	0	0	0	0	0	0
15:31453628:A:G	0	0	0	0	0	0	0	0
15:31453645:C:T	0	0	0	0	0	0	0	0
15:32598100:C:T	0	0	0	0	0	0	0	0
15:33012567:A:C	0	0	0	0	0	0	0	0
15:33012618:C:T	0	0	0	0	0	0	0	0
15:33012702:T:A	0	0	0	0	0	0	0	0
15:33067169:C:T	0	0	0	0	0	0	0	0
15:33067373:C:A	0	0	0	0	0	0	0	0
15:33154057:G:A	0	0	0	0	0	0	0	0
15:33154110:G:C	0	0	0	0	0	0	0	0
15:33154678:G:T	0	0	0	0	0	0	0	0
15:33154746:A:C	0	0	0	0	0	0	0	0
15:33739930:G:A	0	0	0	0	0	0	0	0
15:33807621:G:A	0	0	0	0	0	0	0	0
15:33820809:C:T	1	0	1	1	0	1	1	0
15:33835045:T:C	0	0	0	0	0	0	0	0
15:33844930:G:A	0	0	0	0	0	0	0	0
15:34225794:T:G	2	1	2	1	1	1.0	0.5	0.5
15:34236747:G:A	6	4	9	4	5	1.0	0.0	1.0
15:34258881:G:A	3	3	7	0	7	3	0	3
15:34318763:G:C	5	4	5	1	4	1	0	1
15:34357430:G:A	0	0	0	0	0	0	0	0
15:34373859:C:T	0	0	0	0	0	0	0	0
15:34374022:C:T	0	0	0	0	0	0	0	0
15:34374044:G:T	0	0	0	0	0	0	0	0
15:34381521:C:T	19	5	20	14	6	1	1	0
15:34752856:G:A	0	0	0	0	0	0	0	0
15:34792014:C:G	0	0	0	0	0	0	0	0
15:34964423:C:G	1	0	10	10	0	10	10	0
15:34981419:C:T	2	0	2	2	0	1.0	1.0	0.0
15:35084835:C:T	0	0	0	0	0	0	0	0
15:36881066:G:A	0	0	0	0	0	0	0	0
15:38322324:G:A	1	1	2	0	2	2	0	2
15:38351373:T:C	0	0	0	0	0	0	0	0
15:38458786:T:C	1	0	1	1	0	1	1	0
15:38499082:C:T	0	0	0	0	0	0	0	0
15:38696614:C:G	0	0	0	0	0	0	0	0
15:39934294:T:C	164	80	259	131	128	1.0	1.0	0.0
15:40020940:C:T	2	1	2	1	1	1.0	0.5	0.5
15:40036464:G:A	2493	1792	5789	2818	2971	2	1	1
15:40038317:T:G	3033	2490	10967	5737	5230	3	2	1
15:40170645:T:C	0	0	0	0	0	0	0	0
15:40185630:G:A	1	0	1	1	0	1	1	0
15:40266422:G:A	0	0	0	0	0	0	0	0
15:40393205:A:T	0	0	0	0	0	0	0	0
15:40413026:C:T	11	5	11	6	5	1	1	0
15:40480943:C:T	0	0	0	0	0	0	0	0
15:40621979:T:C	2	2	2	0	2	1.0	0.0	1.0
15:40622847:T:G	0	0	0	0	0	0	0	0
15:40622992:A:G	1	0	3	3	0	3	3	0
15:40623696:T:C	0	0	0	0	0	0	0	0
15:40624603:A:G	4	4	5	0	5	1.0	0.0	1.0
15:40813460:G:A	1	1	1	0	1	1	0	1
15:41164176:A:T	0	0	0	0	0	0	0	0
15:41184267:G:A	0	0	0	0	0	0	0	0
15:41190033:T:C	0	0	0	0	0	0	0	0
15:41342389:AC:GA	13	10	17	3	14	1	0	1
15:41380186:A:G	4	2	4	2	2	1.0	0.5	0.5
15:41394910:C:T	6	4	13	2	11	1.5	0.0	1.5
15:41527169:T:C	3	2	3	1	2	1	0	1
15:41527518:C:T	2	0	2	2	0	1.0	1.0	0.0
15:41529554:T:C	2	1	2	1	1	1.0	0.5	0.5
15:41565018:G:A	0	0	0	0	0	0	0	0
15:41568292:T:A	0	0	0	0	0	0	0	0
15:41570290:G:T	0	0	0	0	0	0	0	0
15:41699117:A:T	4	4	6	0	6	1.5	0.0	1.5
15:41734566:C:T	1	0	1	1	0	1	1	0
15:41749514:G:A	4	1	4	3	1	1.0	1.0	0.0
15:41811624:C:T	0	0	0	0	0	0	0	0
15:41843790:C:T	4	3	24	4	20	3.5	0.0	2.0
15:41845623:G:A	0	0	0	0	0	0	0	0
15:41846258:G:A	9	5	32	22	10	2	2	1
15:41858690:G:A	0	0	0	0	0	0	0	0
15:41876202:C:T	0	0	0	0	0	0	0	0
15:41919288:A:G	2	2	2	0	2	1.0	0.0	1.0
15:41943118:C:T	3	2	5	1	4	1	0	1
15:42081612:G:C	0	0	0	0	0	0	0	0
15:42141604:A:G	0	0	0	0	0	0	0	0
15:42142056:G:A	0	0	0	0	0	0	0	0
15:42142639:T:C	0	0	0	0	0	0	0	0
15:43131129:G:A	0	0	0	0	0	0	0	0
15:43253530:G:A	0	0	0	0	0	0	0	0
15:43279192:C:G	0	0	0	0	0	0	0	0
15:43287368:A:G	0	0	0	0	0	0	0	0
15:44615364:T:C	4	2	13	11	2	1.0	0.5	0.5
15:44651559:A:G	28	13	64	30	34	2.0	1.0	0.0
15:45253280:C:T	1	1	11	0	11	11	0	11
15:45262069:C:A	0	0	0	0	0	0	0	0
15:45264631:A:G	2	1	4	1	3	2.0	0.5	1.5
15:45362129:A:G	9	0	14	14	0	1	1	0
15:45369480:T:A	31	1	33	32	1	1	1	0
15:45376857:C:A	1	0	1	1	0	1	1	0
15:45487612:G:A	1	0	2	2	0	2	2	0
15:45676237:T:C	24	7	91	59	32	2.5	1.0	0.0
15:45689119:G:A	16	5	16	11	5	1.0	1.0	0.0
15:47770879:T:C	0	0	0	0	0	0	0	0
15:48428329:G:C	0	0	0	0	0	0	0	0
15:48505110:A:G	0	0	0	0	0	0	0	0
15:49000997:C:A	3	1	10	9	1	1	1	0
15:50018938:C:A	0	0	0	0	0	0	0	0
15:50018951:A:G	0	0	0	0	0	0	0	0
15:50182569:A:C	0	0	0	0	0	0	0	0
15:50484328:T:C	35	19	58	26	32	1	0	1
15:50574945:C:T	7	4	7	3	4	1	0	1
15:50915621:G:C	1	1	2	0	2	2	0	2
15:50925164:T:C	1	0	2	2	0	2	2	0
15:50945660:C:G	0	0	0	0	0	0	0	0
15:50945898:G:A	0	0	0	0	0	0	0	0
15:50945978:T:C	1	0	1	1	0	1	1	0
15:51002635:G:A	0	0	0	0	0	0	0	0
15:51236915:T:C	0	0	0	0	0	0	0	0
15:51859328:A:G	0	0	0	0	0	0	0	0
15:51860981:G:A	0	0	0	0	0	0	0	0
15:51861007:G:A	0	0	0	0	0	0	0	0
15:51947266:C:T	0	0	0	0	0	0	0	0
15:52095523:T:C	8	0	8	8	0	1.0	1.0	0.0
15:52141200:C:T	46	35	64	15	49	1.0	0.0	1.0
15:52154003:G:A	629	372	933	426	507	1	0	1
15:52154063:C:T	544	312	737	350	387	1.0	0.0	1.0
15:52319254:A:G	4	2	4	2	2	1.0	0.5	0.5
15:52372211:G:A	6	4	6	2	4	1.0	0.0	1.0
15:53702296:A:G	0	0	0	0	0	0	0	0
15:53710894:G:A	0	0	0	0	0	0	0	0
15:54321483:C:T	0	0	0	0	0	0	0	0
15:54549676:A:G	0	0	0	0	0	0	0	0
15:54555479:C:T	0	0	0	0	0	0	0	0
15:55196867:G:A	300	158	330	164	166	1.0	1.0	1.0
15:55196906:A:G	80	45	88	43	45	1.0	0.0	1.0
15:55205493:G:A	3	1	3	2	1	1	1	0
15:55355294:C:T	8	4	15	10	5	1.0	0.5	0.5
15:55371912:G:C	5	0	9	9	0	1	1	0
15:55430684:C:A	0	0	0	0	0	0	0	0
15:55738558:T:C	0	0	0	0	0	0	0	0
15:57543705:T:G	0	0	0	0	0	0	0	0
15:57625871:A:G	0	0	0	0	0	0	0	0
15:58179169:C:T	0	0	0	0	0	0	0	0
15:58184082:A:G	0	0	0	0	0	0	0	0
15:58432172:C:T	0	0	0	0	0	0	0	0
15:58542542:G:T	0	0	0	0	0	0	0	0
15:58545811:A:G	0	0	0	0	0	0	0	0
15:58545839:C:G	0	0	0	0	0	0	0	0
15:58568764:C:A	0	0	0	0	0	0	0	0
15:58691226:G:C	0	0	0	0	0	0	0	0
15:58691389:T:A	0	0	0	0	0	0	0	0
15:58692195:G:C	1	0	3	3	0	3	3	0
15:58692208:C:T	1	0	4	4	0	4	4	0
15:58692965:T:G	1	1	2	0	2	2	0	2
15:58883766:A:G	22	10	26	12	14	1.0	1.0	0.0
15:58887065:G:A	27	14	33	19	14	1	0	1
15:59055730:C:A	2	1	3	2	1	1.5	1.0	0.5
15:59066903:A:G	6	3	8	5	3	1.0	0.5	0.5
15:59207273:G:A	1	0	13	13	0	13	13	0
15:59207918:T:C	1	0	1	1	0	1	1	0
15:59552939:G:A	0	0	0	0	0	0	0	0
15:59619222:A:T	0	0	0	0	0	0	0	0
15:59689292:T:G	81	30	95	64	31	1	1	0
15:61910283:C:T	8	3	10	7	3	1.0	1.0	0.0
15:61967438:C:T	15	7	23	9	14	1	1	0
15:62247582:A:G	0	0	0	0	0	0	0	0
15:62255120:T:A	0	0	0	0	0	0	0	0
15:62260361:G:A	0	0	0	0	0	0	0	0
15:62698772:C:T	0	0	0	0	0	0	0	0
15:63043900:C:G	0	0	0	0	0	0	0	0
15:63048217:A:G	0	0	0	0	0	0	0	0
15:63640314:G:C	1	0	1	1	0	1	1	0
15:63678257:T:C	4	2	4	2	2	1.0	0.5	0.5
15:64127175:G:T	20	12	26	8	18	1.0	0.0	1.0
15:64265841:C:G	0	0	0	0	0	0	0	0
15:64381416:A:G	8	3	11	6	5	1.0	1.0	0.0
15:64414133:A:G	7	6	15	1	14	1	0	1
15:64418628:T:C	6	1	16	13	3	1.5	1.0	0.0
15:64593046:G:T	4	1	28	15	13	6.5	3.5	0.0
15:64670431:A:C	8	2	23	17	6	3.5	2.0	0.0
15:64675455:C:T	3	2	3	1	2	1	0	1
15:64943580:A:G	0	0	0	0	0	0	0	0
15:64944678:C:T	1	1	5	0	5	5	0	5
15:64981061:T:C	5	1	5	4	1	1	1	0
15:65334789:G:A	0	0	0	0	0	0	0	0
15:65385803:A:T	0	0	0	0	0	0	0	0
15:65611060:G:A	13	5	21	11	10	1	1	0
15:65624189:A:T	0	0	0	0	0	0	0	0
15:65702395:C:T	21	14	36	15	21	1	0	1
15:65771193:G:A	36	15	127	74	53	3.0	1.5	0.0
15:65771844:GC:AT	63	30	238	124	114	3	1	0
15:65772001:T:A	29	14	89	50	39	2	1	0
15:65816309:G:A	0	0	0	0	0	0	0	0
15:66119103:C:T	0	0	0	0	0	0	0	0
15:66326004:A:G	4	1	4	3	1	1.0	1.0	0.0
15:66337065:C:A	1	0	1	1	0	1	1	0
15:66379683:T:C	48	2	49	47	2	1.0	1.0	0.0
15:66379882:T:C	10	6	23	9	14	1.5	0.0	1.0
15:66564757:G:C	0	0	0	0	0	0	0	0
15:67236036:T:G	33	15	50	32	18	1	1	0
15:67628836:G:A	8	5	27	7	20	3.0	0.0	1.5
15:67658812:G:T	1	0	3	3	0	3	3	0
15:67670425:A:G	1	1	4	0	4	4	0	4
15:67824962:T:A	0	0	0	0	0	0	0	0
15:67832327:C:A	0	0	0	0	0	0	0	0
15:68946106:G:A	0	0	0	0	0	0	0	0
15:69035886:C:T	0	0	0	0	0	0	0	0
15:69803416:C:T	0	0	0	0	0	0	0	0
15:71780664:C:T	0	0	0	0	0	0	0	0
15:72899522:T:C	0	0	0	0	0	0	0	0
15:73249172:A:G	0	0	0	0	0	0	0	0
15:73258909:A:G	0	0	0	0	0	0	0	0
15:73272540:C:T	0	0	0	0	0	0	0	0
15:73884216:G:A	0	0	0	0	0	0	0	0
15:73927241:G:A	0	0	0	0	0	0	0	0
15:74128669:C:G	0	0	0	0	0	0	0	0
15:74133069:T:C	0	0	0	0	0	0	0	0
15:74133164:C:T	0	0	0	0	0	0	0	0
15:74175455:C:T	0	0	0	0	0	0	0	0
15:74196083:G:A	0	0	0	0	0	0	0	0
15:74207739:G:C	0	0	0	0	0	0	0	0
15:74598013:G:A	5	3	5	2	3	1	0	1
15:74720638:G:T	0	0	0	0	0	0	0	0
15:74720646:G:T	0	0	0	0	0	0	0	0
15:75012699:A:G	5	5	6	0	6	1	0	1
15:75206403:G:C	4	1	10	9	1	1.0	1.0	0.0
15:75322480:C:A	45	7	45	38	7	1	1	0
15:75338221:C:T	47	19	47	28	19	1	1	0
15:75358495:G:A	14	7	14	7	7	1.0	0.5	0.5
15:75358631:G:A	4	0	4	4	0	1.0	1.0	0.0
15:75617462:A:G	156	86	161	73	88	1.0	0.0	1.0
15:75639788:G:T	209	101	229	116	113	1	1	0
15:75775570:A:G	0	0	0	0	0	0	0	0
15:75775646:A:G	0	0	0	0	0	0	0	0
15:75783308:G:A	0	0	0	0	0	0	0	0
15:75844427:C:T	8	7	16	1	15	1.0	0.0	1.0
15:76203891:G:A	0	0	0	0	0	0	0	0
15:76260992:C:T	0	0	0	0	0	0	0	0
15:76261158:C:G	0	0	0	0	0	0	0	0
15:76261247:G:A	0	0	0	0	0	0	0	0
15:76338376:C:T	0	0	0	0	0	0	0	0
15:76381375:T:C	2	2	2	0	2	1.0	0.0	1.0
15:76434124:G:T	1	1	1	0	1	1	0	1
15:76883817:T:C	108	54	149	63	86	1.0	0.5	0.5
15:76883859:A:T	50	25	80	28	52	1.0	0.5	0.5
15:77052451:T:A	52	32	85	31	54	1.0	0.0	1.0
15:77158622:C:T	1	1	7	0	7	7	0	7
15:77896733:G:A	0	0	0	0	0	0	0	0
15:77918829:A:G	0	0	0	0	0	0	0	0
15:77919051:A:T	0	0	0	0	0	0	0	0
15:77941507:A:G	0	0	0	0	0	0	0	0
15:78098567:C:T	0	0	0	0	0	0	0	0
15:78105804:G:A	1	1	1	0	1	1	0	1
15:78105888:C:T	0	0	0	0	0	0	0	0
15:78173695:C:G	2	2	2	0	2	1.0	0.0	1.0
15:78533575:A:G	0	0	0	0	0	0	0	0
15:78548878:T:C	62	31	67	33	34	1.0	1.0	0.5
15:78590583:G:A	0	0	0	0	0	0	0	0
15:78617110:T:C	0	0	0	0	0	0	0	0
15:78618839:T:C	0	0	0	0	0	0	0	0
15:78625057:A:G	0	0	0	0	0	0	0	0
15:78727204:C:A	0	0	0	0	0	0	0	0
15:78731926:G:A	0	0	0	0	0	0	0	0
15:78733727:A:G	0	0	0	0	0	0	0	0
15:78734187:C:T	0	0	0	0	0	0	0	0
15:78771738:G:A	0	0	0	0	0	0	0	0
15:78771801:C:G	0	0	0	0	0	0	0	0
15:78796665:T:C	0	0	0	0	0	0	0	0
15:78873099:G:T	106	48	264	150	114	2.0	1.0	0.0
15:79294019:T:C	0	0	0	0	0	0	0	0
15:79294523:G:A	0	0	0	0	0	0	0	0
15:79559748:C:A	0	0	0	0	0	0	0	0
15:79559947:A:G	0	0	0	0	0	0	0	0
15:79896826:T:C	297	190	1185	364	821	2	0	1
15:79899001:G:A	13	9	13	4	9	1	0	1
15:79923255:G:T	7	4	9	3	6	1	0	1
15:79923673:C:A	55	27	81	40	41	1	1	0
15:79971003:A:C	614	374	904	435	469	1.0	1.0	1.0
15:80158047:G:A	0	0	0	0	0	0	0	0
15:80159830:G:C	0	0	0	0	0	0	0	0
15:80162403:T:C	0	0	0	0	0	0	0	0
15:80186303:T:C	0	0	0	0	0	0	0	0
15:80470305:C:T	0	0	0	0	0	0	0	0
15:80591684:G:A	0	0	0	0	0	0	0	0
15:82152096:A:G	3	0	3	3	0	1	1	0
15:82265693:G:C	1	1	6	0	6	6	0	6
15:82271650:C:T	0	0	0	0	0	0	0	0
15:82282538:T:C	1	0	1	1	0	1	1	0
15:82316302:C:T	0	0	0	0	0	0	0	0
15:82540442:T:A	342	165	368	199	169	1.0	1.0	0.0
15:83739794:A:G	0	0	0	0	0	0	0	0
15:83739882:C:T	0	0	0	0	0	0	0	0
15:83819884:A:G	0	0	0	0	0	0	0	0
15:83913152:T:C	0	0	0	0	0	0	0	0
15:83982433:C:A	0	0	0	0	0	0	0	0
15:84053481:C:T	0	0	0	0	0	0	0	0
15:84053769:A:G	0	0	0	0	0	0	0	0
15:84113665:A:C	0	0	0	0	0	0	0	0
15:84390487:C:T	0	0	0	0	0	0	0	0
15:84391944:C:G	0	0	0	0	0	0	0	0
15:84571216:C:T	0	0	0	0	0	0	0	0
15:84633977:G:A	50	10	205	178	27	3.0	2.0	0.0
15:84634066:G:A	53	46	172	23	149	3	0	2
15:84634492:T:G	4	2	8	4	4	2.0	0.5	1.0
15:84646233:T:G	12	8	13	4	9	1.0	0.0	1.0
15:84839914:C:G	0	0	0	0	0	0	0	0
15:84840409:G:A	0	0	0	0	0	0	0	0
15:84858449:C:T	0	0	0	0	0	0	0	0
15:84862764:T:C	0	0	0	0	0	0	0	0
15:85178681:A:G	0	0	0	0	0	0	0	0
15:85178695:G:A	0	0	0	0	0	0	0	0
15:85178761:T:G	0	0	0	0	0	0	0	0
15:85579423:T:C	15	8	15	7	8	1	0	1
15:85579548:T:C	8	5	8	3	5	1.0	0.0	1.0
15:85579685:T:C	7	5	7	2	5	1	0	1
15:85579788:C:T	10	3	19	14	5	1.0	1.0	0.0
15:85580133:G:A	50	25	84	41	43	1.0	0.5	0.5
15:85580602:T:C	10	6	10	4	6	1.0	0.0	1.0
15:85580693:C:T	19	12	19	7	12	1	0	1
15:85580757:G:A	19	11	19	8	11	1	0	1
15:85581188:C:T	21	11	25	12	13	1	0	1
15:85581252:C:G	21	10	25	15	10	1	1	0
15:85581324:G:A	11	6	14	8	6	1	0	1
15:85581481:A:G	22	16	23	6	17	1.0	0.0	1.0
15:85581715:T:C	24	9	24	15	9	1.0	1.0	0.0
15:85581737:G:A	27	10	28	17	11	1	1	0
15:85581800:G:A	29	11	29	18	11	1	1	0
15:85741111:C:T	47	26	77	35	42	1	0	1
15:85769217:C:T	0	0	0	0	0	0	0	0
15:86988050:A:C	0	0	0	0	0	0	0	0
15:88137453:G:A	0	0	0	0	0	0	0	0
15:88626422:G:A	62	33	71	33	38	1.0	0.0	1.0
15:89325639:G:A	13	7	17	9	8	1	0	1
15:89330184:G:A	6	3	21	5	16	2.0	0.5	1.0
15:89480327:G:A	0	0	0	0	0	0	0	0
15:89645099:C:T	0	0	0	0	0	0	0	0
15:89667026:G:A	0	0	0	0	0	0	0	0
15:89667032:A:G	0	0	0	0	0	0	0	0
15:89670112:C:A	0	0	0	0	0	0	0	0
15:89806327:C:T	0	0	0	0	0	0	0	0
15:90217759:T:C	1	0	5	5	0	5	5	0
15:90220987:G:A	36	20	56	24	32	1.0	0.0	1.0
15:90225039:C:T	40	25	45	20	25	1.0	0.0	1.0
15:90225088:C:T	39	17	44	24	20	1	1	0
15:90225727:A:C	45	20	77	43	34	1	1	0
15:90228472:G:A	43	19	51	32	19	1	1	0
15:90250870:G:A	0	0	0	0	0	0	0	0
15:90253326:G:A	2	1	5	1	4	2.5	0.5	2.0
15:90257176:C:G	0	0	0	0	0	0	0	0
15:90257217:C:T	0	0	0	0	0	0	0	0
15:90271432:C:T	34	14	109	45	64	2.0	1.0	0.0
15:90275409:G:C	0	0	0	0	0	0	0	0
15:90285248:G:A	0	0	0	0	0	0	0	0
15:90295161:C:T	0	0	0	0	0	0	0	0
15:90349061:C:T	0	0	0	0	0	0	0	0
15:90349070:T:A	0	0	0	0	0	0	0	0
15:90354653:G:C	0	0	0	0	0	0	0	0
15:90354720:C:T	0	0	0	0	0	0	0	0
15:90358940:C:T	0	0	0	0	0	0	0	0
15:90360176:A:G	0	0	0	0	0	0	0	0
15:90598578:A:C	0	0	0	0	0	0	0	0
15:90803693:C:A	3	2	3	1	2	1	0	1
15:90811275:C:T	9	5	9	4	5	1	0	1
15:90912228:C:T	1	0	1	1	0	1	1	0
15:90953012:C:T	21	12	25	12	13	1	0	1
15:91000531:C:T	17	8	60	26	34	3	1	0
15:91017831:G:T	18	8	39	15	24	1.0	1.0	0.0
15:92171901:A:T	0	0	0	0	0	0	0	0
15:92281638:T:C	0	0	0	0	0	0	0	0
15:92286222:G:A	0	0	0	0	0	0	0	0
15:92904992:G:A	2	1	2	1	1	1.0	0.5	0.5
15:92967373:A:G	11	2	15	10	5	1	1	0
15:93045034:G:C	0	0	0	0	0	0	0	0
15:93045059:G:A	0	0	0	0	0	0	0	0
15:93066231:A:T	0	0	0	0	0	0	0	0
15:93066287:G:A	0	0	0	0	0	0	0	0
15:93073704:C:G	0	0	0	0	0	0	0	0
15:93073746:A:G	0	0	0	0	0	0	0	0
15:93431047:C:G	0	0	0	0	0	0	0	0
15:94340879:G:C	10	5	15	9	6	1.0	0.5	0.5
15:96758333:C:T	0	0	0	0	0	0	0	0
15:96758447:C:G	0	0	0	0	0	0	0	0
15:97427733:T:C	0	0	0	0	0	0	0	0
15:98480739:T:G	0	0	0	0	0	0	0	0
15:98934996:G:A	0	0	0	0	0	0	0	0
15:98968564:C:G	0	0	0	0	0	0	0	0
15:98968644:G:A	0	0	0	0	0	0	0	0
15:99712600:G:T	10	4	15	9	6	1.0	1.0	0.0
15:99712687:A:G	37	14	55	35	20	1	1	0
15:99729475:G:C	4	1	4	3	1	1.0	1.0	0.0
15:99791048:G:A	1	0	3	3	0	3	3	0
15:99791077:C:T	1	0	2	2	0	2	2	0
15:99791547:C:A	0	0	0	0	0	0	0	0
15:99791595:G:A	0	0	0	0	0	0	0	0
15:99791614:A:G	0	0	0	0	0	0	0	0
15:99791756:A:G	0	0	0	0	0	0	0	0
15:99792010:G:A	0	0	0	0	0	0	0	0
15:99792538:A:G	0	0	0	0	0	0	0	0
15:99792714:T:C	0	0	0	0	0	0	0	0
15:99792870:C:T	0	0	0	0	0	0	0	0
15:99800170:A:G	0	0	0	0	0	0	0	0
15:99800208:C:T	0	0	0	0	0	0	0	0
15:100152748:G:A	0	0	0	0	0	0	0	0
15:100281262:G:A	0	0	0	0	0	0	0	0
15:100281371:G:A	0	0	0	0	0	0	0	0
15:100501716:T:C	0	0	0	0	0	0	0	0
15:100553719:T:A	3	3	14	0	14	5	0	5
15:100554130:C:G	0	0	0	0	0	0	0	0
15:100554159:G:A	0	0	0	0	0	0	0	0
15:100569472:C:A	18	8	28	15	13	1.0	1.0	0.0
15:100573745:A:G	5	3	5	2	3	1	0	1
15:100574213:G:A	4	3	7	1	6	1.0	0.0	1.0
15:101055052:G:A	3	1	3	2	1	1	1	0
15:101057995:G:A	5	2	5	3	2	1	1	0
15:101058109:C:T	3	2	4	1	3	1	0	1
15:101066056:C:T	3	3	3	0	3	1	0	1
15:101067245:T:C	0	0	0	0	0	0	0	0
15:101067308:T:C	0	0	0	0	0	0	0	0
15:101178495:G:A	4	2	5	2	3	1.0	0.5	0.5
15:101274445:C:T	30	16	34	18	16	1.0	0.5	1.0
15:101651831:A:G	2	2	2	0	2	1.0	0.0	1.0
15:101652215:C:T	21	13	21	8	13	1	0	1
15:101652337:T:G	17	11	21	8	13	1	0	1
15:101655983:C:T	0	0	0	0	0	0	0	0
15:101724273:C:A	320	171	345	168	177	1.0	0.0	1.0
15:101737277:G:C	63	5	165	152	13	2	2	0
15:101771852:C:T	0	0	0	0	0	0	0	0
16:173671:G:C	6	6	15	3	12	1.0	0.0	1.0
16:254515:C:T	158	79	548	281	267	3.0	1.0	0.5
16:259525:G:A	26	11	32	16	16	1.0	1.0	0.0
16:270760:C:T	0	0	0	0	0	0	0	0
16:399345:G:C	3	3	11	0	11	1	0	1
16:399659:G:A	252	210	309	55	254	1.0	0.0	1.0
16:405646:A:G	0	0	0	0	0	0	0	0
16:406416:T:G	2	1	2	1	1	1.0	0.5	0.5
16:554554:T:C	5	3	5	2	3	1	0	1
16:655873:G:A	0	0	0	0	0	0	0	0
16:722141:G:C	0	0	0	0	0	0	0	0
16:723341:G:A	0	0	0	0	0	0	0	0
16:723367:G:T	0	0	0	0	0	0	0	0
16:732397:C:T	0	0	0	0	0	0	0	0
16:734180:C:T	0	0	0	0	0	0	0	0
16:853697:C:G	1	0	1	1	0	1	1	0
16:1065904:G:A	0	0	0	0	0	0	0	0
16:1201803:C:T	0	0	0	0	0	0	0	0
16:1314364:A:G	1773	1025	2884	1546	1338	1	1	1
16:1324817:A:G	44	26	55	24	31	1.0	0.0	1.0
16:1338908:C:T	5	1	7	6	1	1	1	0
16:1434454:T:C	3	0	3	3	0	1	1	0
16:1438645:A:G	7	2	8	6	2	1	1	0
16:1448519:A:G	0	0	0	0	0	0	0	0
16:1486322:A:G	0	0	0	0	0	0	0	0
16:1486379:G:T	0	0	0	0	0	0	0	0
16:1487873:G:A	0	0	0	0	0	0	0	0
16:1488362:C:A	0	0	0	0	0	0	0	0
16:1509837:T:C	12	5	12	7	5	1.0	1.0	0.0
16:1510885:A:G	2	1	2	1	1	1.0	0.5	0.5
16:1632280:A:G	5	3	13	7	6	2	0	1
16:1773443:C:G	15	5	29	14	15	1	1	0
16:1791032:G:A	1	1	1	0	1	1	0	1
16:1794871:GCCG:ACCA	0	0	0	0	0	0	0	0
16:1809849:A:G	0	0	0	0	0	0	0	0
16:1827697:C:G	6	2	6	4	2	1.0	1.0	0.0
16:1862020:T:G	0	0	0	0	0	0	0	0
16:1975205:A:C	5	3	5	2	3	1	0	1
16:1980126:G:A	0	0	0	0	0	0	0	0
16:1984660:T:C	10	6	14	7	7	1.0	0.0	1.0
16:1985783:C:T	1	1	1	0	1	1	0	1
16:1986047:T:C	4	2	4	2	2	1.0	0.5	0.5
16:1989791:G:A	0	0	0	0	0	0	0	0
16:1998795:C:T	5	1	5	4	1	1	1	0
16:1998825:C:G	4	1	4	3	1	1.0	1.0	0.0
16:1999848:T:C	6	2	6	4	2	1.0	1.0	0.0
16:2033357:A:G	0	0	0	0	0	0	0	0
16:2055334:C:G	0	0	0	0	0	0	0	0
16:2055399:C:T	0	0	0	0	0	0	0	0
16:2072959:T:C	4	2	5	3	2	1.0	0.5	0.5
16:2088217:A:C	1	0	1	1	0	1	1	0
16:2088268:T:C	11	6	14	5	9	1	0	1
16:2090009:A:G	5	2	5	3	2	1	1	0
16:2090453:T:C	2	1	2	1	1	1.0	0.5	0.5
16:2090679:T:C	3	3	3	0	3	1	0	1
16:2105818:A:C	1	1	1	0	1	1	0	1
16:2109995:G:A	1	0	2	2	0	2	2	0
16:2110502:T:G	0	0	0	0	0	0	0	0
16:2111792:GGAG:AGAA	0	0	0	0	0	0	0	0
16:2112886:A:G	0	0	0	0	0	0	0	0
16:2172285:C:T	3	1	4	2	2	1	1	0
16:2207104:C:G	30	15	52	23	29	1.0	0.5	0.5
16:2210566:C:T	2	1	2	1	1	1.0	0.5	0.5
16:2235356:C:T	10	7	10	3	7	1.0	0.0	1.0
16:2251519:G:C	28	13	36	18	18	1.0	1.0	0.0
16:2298527:G:C	0	0	0	0	0	0	0	0
16:2324458:G:A	0	0	0	0	0	0	0	0
16:2460602:C:T	2	1	2	1	1	1.0	0.5	0.5
16:2769771:T:A	33	16	39	23	16	1	1	0
16:3204470:T:C	0	0	0	0	0	0	0	0
16:3204783:C:G	0	0	0	0	0	0	0	0
16:3204972:T:C	0	0	0	0	0	0	0	0
16:3216071:A:G	0	0	0	0	0	0	0	0
16:3243888:C:T	0	0	0	0	0	0	0	0
16:3243922:A:T	0	0	0	0	0	0	0	0
16:3247073:A:G	0	0	0	0	0	0	0	0
16:3247175:T:C	0	0	0	0	0	0	0	0
16:3247181:C:T	0	0	0	0	0	0	0	0
16:3249749:G:A	0	0	0	0	0	0	0	0
16:3254762:A:G	0	0	0	0	0	0	0	0
16:3323351:A:G	0	0	0	0	0	0	0	0
16:3496405:C:G	0	0	0	0	0	0	0	0
16:3533173:C:T	1	0	2	2	0	2	2	0
16:3563588:G:A	2	1	2	1	1	1.0	0.5	0.5
16:3564135:G:A	0	0	0	0	0	0	0	0
16:3589138:A:G	4	1	12	10	2	1.5	1.0	0.0
16:3606481:C:T	0	0	0	0	0	0	0	0
16:3671772:G:C	6	5	11	1	10	1.5	0.0	1.5
16:4114336:C:T	0	0	0	0	0	0	0	0
16:4469438:G:A	230	109	282	151	131	1.0	1.0	0.0
16:4575930:C:T	0	0	0	0	0	0	0	0
16:4701044:C:T	5	3	6	3	3	1	0	1
16:4740272:G:A	0	0	0	0	0	0	0	0
16:4746392:A:G	0	0	0	0	0	0	0	0
16:4747456:C:T	0	0	0	0	0	0	0	0
16:4783969:C:T	0	0	0	0	0	0	0	0
16:4787544:A:G	0	0	0	0	0	0	0	0
16:4805278:A:G	14	7	15	7	8	1.0	0.5	0.5
16:4880099:C:T	4	3	6	1	5	1.0	0.0	1.0
16:4884563:C:G	0	0	0	0	0	0	0	0
16:4885145:C:T	1	1	3	0	3	3	0	3
16:4892098:C:T	0	0	0	0	0	0	0	0
16:5000896:G:C	0	0	0	0	0	0	0	0
16:5025541:G:A	8	4	10	6	4	1.0	0.5	0.5
16:5025632:G:A	8	3	8	5	3	1.0	1.0	0.0
16:5030522:C:T	0	0	0	0	0	0	0	0
16:5047946:A:G	1	0	1	1	0	1	1	0
16:5073269:C:T	0	0	0	0	0	0	0	0
16:5078816:G:A	4	1	6	5	1	1.5	1.5	0.0
16:5082635:C:T	3	2	3	1	2	1	0	1
16:5090560:C:T	55	31	68	31	37	1	0	1
16:5207367:A:G	0	0	0	0	0	0	0	0
16:8646378:T:C	0	0	0	0	0	0	0	0
16:8774919:C:A	1	0	1	1	0	1	1	0
16:8859224:C:G	344	161	411	222	189	1.0	1.0	0.0
16:10480939:C:T	4	1	9	6	3	2.0	1.0	0.0
16:10480956:G:A	5	1	7	6	1	1	1	0
16:10538055:C:T	0	0	0	0	0	0	0	0
16:10676101:T:C	0	0	0	0	0	0	0	0
16:10694767:T:C	0	0	0	0	0	0	0	0
16:10901993:G:T	1	1	1	0	1	1	0	1
16:10923201:G:A	5	3	5	2	3	1	0	1
16:11027214:C:G	3	2	6	3	3	2	0	1
16:11027408:C:A	11	11	11	0	11	1	0	1
16:11350715:A:C	17	13	19	5	14	1	0	1
16:11461011:C:T	0	0	0	0	0	0	0	0
16:11553636:T:C	1115	604	1486	782	704	1	1	1
16:11742542:C:G	296	177	417	170	247	1.0	0.0	1.0
16:11875867:G:C	43	26	94	34	60	1	0	1
16:11887630:G:A	21	7	37	30	7	1	1	0
16:12568538:G:A	3	1	14	2	12	1	1	0
16:12908530:C:T	0	0	0	0	0	0	0	0
16:13948101:T:C	0	0	0	0	0	0	0	0
16:14662051:G:A	9	7	27	4	23	2	0	2
16:15036113:A:G	15	10	23	5	18	1	0	1
16:15038105:A:G	16	8	18	10	8	1.0	0.5	0.5
16:15038117:G:T	18	8	21	12	9	1.0	1.0	0.0
16:15040032:T:G	14	7	15	7	8	1.0	0.5	0.5
16:15104600:C:T	5	2	9	5	4	1	1	0
16:15127485:C:A	7	4	18	4	14	2	0	2
16:15717166:C:T	0	0	0	0	0	0	0	0
16:15717205:C:T	0	0	0	0	0	0	0	0
16:15724284:A:C	11	6	17	6	11	1	0	1
16:15727006:C:T	1	0	15	15	0	15	15	0
16:15735572:G:A	1	0	8	8	0	8	8	0
16:15745177:G:A	0	0	0	0	0	0	0	0
16:15756347:A:G	0	0	0	0	0	0	0	0
16:15776175:A:G	0	0	0	0	0	0	0	0
16:15778891:G:T	0	0	0	0	0	0	0	0
16:16044456:G:A	5	1	5	4	1	1	1	0
16:16068182:C:T	11	3	33	19	14	1	1	0
16:16357770:C:T	0	0	0	0	0	0	0	0
16:17134511:G:A	178	68	461	305	156	2.0	1.0	0.0
16:17198217:G:C	3	1	4	3	1	1	1	0
16:19030273:G:A	0	0	0	0	0	0	0	0
16:19056611:G:A	0	0	0	0	0	0	0	0
16:19067715:G:A	26	16	59	18	41	1.5	0.0	1.0
16:19068862:C:T	3	0	7	7	0	1	1	0
16:19073976:C:T	35	10	37	25	12	1	1	0
16:19183586:C:T	1	1	1	0	1	1	0	1
16:19537139:C:T	1	1	1	0	1	1	0	1
16:19700395:C:T	6	5	8	1	7	1.0	0.0	1.0
16:19710433:C:T	0	0	0	0	0	0	0	0
16:19710484:C:T	0	0	0	0	0	0	0	0
16:20032008:T:C	0	0	0	0	0	0	0	0
16:20429731:C:G	0	0	0	0	0	0	0	0
16:20437198:T:C	0	0	0	0	0	0	0	0
16:20437205:T:C	0	0	0	0	0	0	0	0
16:20465530:T:C	0	0	0	0	0	0	0	0
16:20474064:A:G	0	0	0	0	0	0	0	0
16:20540753:G:T	0	0	0	0	0	0	0	0
16:20554074:C:T	0	0	0	0	0	0	0	0
16:20564726:C:A	0	0	0	0	0	0	0	0
16:20590760:T:A	0	0	0	0	0	0	0	0
16:20737009:C:A	17	9	33	23	10	1	0	1
16:20785065:G:C	3	1	3	2	1	1	1	0
16:20797961:C:A	2	1	3	2	1	1.5	1.0	0.5
16:20798745:T:C	0	0	0	0	0	0	0	0
16:20948596:G:A	0	0	0	0	0	0	0	0
16:20954951:G:A	0	0	0	0	0	0	0	0
16:20963747:G:A	0	0	0	0	0	0	0	0
16:20963981:A:G	0	0	0	0	0	0	0	0
16:20964200:A:G	0	0	0	0	0	0	0	0
16:20965038:T:G	0	0	0	0	0	0	0	0
16:20969840:T:C	0	0	0	0	0	0	0	0
16:20997368:T:C	0	0	0	0	0	0	0	0
16:21067372:T:G	0	0	0	0	0	0	0	0
16:21174063:G:A	37	16	61	38	23	1	1	0
16:21179532:A:C	50	31	159	71	88	2.0	0.0	1.0
16:21205740:G:A	0	0	0	0	0	0	0	0
16:21211351:C:A	0	0	0	0	0	0	0	0
16:21520173:T:C	221	88	1336	832	504	5	3	0
16:21687628:C:T	0	0	0	0	0	0	0	0
16:21983090:G:A	49	21	65	43	22	1	1	0
16:22132997:C:T	0	0	0	0	0	0	0	0
16:22251193:C:A	1	0	1	1	0	1	1	0
16:22814725:T:G	0	0	0	0	0	0	0	0
16:23213095:G:A	0	0	0	0	0	0	0	0
16:23215466:C:G	0	0	0	0	0	0	0	0
16:23371926:G:A	0	0	0	0	0	0	0	0
16:23595574:G:T	1	1	3	0	3	3	0	3
16:24154809:T:C	94	43	122	63	59	1.0	1.0	0.0
16:24191137:C:T	92	50	114	62	52	1.0	0.0	1.0
16:24571551:A:G	24	13	26	12	14	1.0	0.5	1.0
16:24790416:G:A	1	1	1	0	1	1	0	1
16:24790658:C:T	3	3	4	0	4	1	0	1
16:24827541:A:G	0	0	0	0	0	0	0	0
16:24943862:T:C	27	10	53	25	28	1	1	0
16:25031956:G:A	61	40	390	144	246	6	0	4
16:25228484:G:C	0	0	0	0	0	0	0	0
16:25244185:C:T	1	1	1	0	1	1	0	1
16:25246714:A:G	1	1	2	0	2	2	0	2
16:25251957:G:A	0	0	0	0	0	0	0	0
16:25257047:A:G	2	0	9	9	0	4.5	4.5	0.0
16:27226789:C:T	43	25	64	28	36	1	0	1
16:27362859:T:C	11	6	11	5	6	1	0	1
16:27363079:A:G	10	6	13	4	9	1.0	0.0	1.0
16:27363606:T:G	11	4	11	7	4	1	1	0
16:27363708:T:C	15	8	25	12	13	1	0	1
16:27463624:C:T	1	0	1	1	0	1	1	0
16:27505926:G:A	1	0	1	1	0	1	1	0
16:27963166:T:C	0	0	0	0	0	0	0	0
16:28111905:G:A	26	14	31	16	15	1.0	0.0	1.0
16:28240558:G:A	0	0	0	0	0	0	0	0
16:28362840:G:C	1	1	1	0	1	1	0	1
16:28495551:A:G	0	0	0	0	0	0	0	0
16:28496727:A:G	0	0	0	0	0	0	0	0
16:28496748:C:T	0	0	0	0	0	0	0	0
16:28497126:A:G	0	0	0	0	0	0	0	0
16:28502082:A:G	0	0	0	0	0	0	0	0
16:28592334:T:G	0	0	0	0	0	0	0	0
16:28597020:T:C	0	0	0	0	0	0	0	0
16:28605807:T:C	0	0	0	0	0	0	0	0
16:28638330:C:A	0	0	0	0	0	0	0	0
16:28844201:G:C	3	0	3	3	0	1	1	0
16:28863801:T:G	17	0	56	56	0	3	3	0
16:28887472:T:C	0	0	0	0	0	0	0	0
16:28904206:G:A	144	112	173	36	137	1.0	0.0	1.0
16:28933075:C:G	205	76	231	149	82	1	1	0
16:28933379:G:T	86	47	108	51	57	1.0	0.0	1.0
16:28984436:C:A	5	3	5	2	3	1	0	1
16:29695123:C:T	0	0	0	0	0	0	0	0
16:29977895:C:T	5	2	5	3	2	1	1	0
16:29983601:C:T	8	5	15	3	12	1.0	0.0	1.0
16:29986879:A:G	1	0	1	1	0	1	1	0
16:30007179:C:T	0	0	0	0	0	0	0	0
16:30070046:G:T	2	1	2	1	1	1.0	0.5	0.5
16:30188263:G:A	9	6	10	3	7	1	0	1
16:30397640:C:T	1	1	1	0	1	1	0	1
16:30655482:C:T	2	1	2	1	1	1.0	0.5	0.5
16:31084678:G:A	2	0	15	15	0	7.5	7.5	0.0
16:31094694:C:T	764	382	6157	3493	2664	7.0	3.0	0.5
16:31182621:C:A	1622	995	3254	1669	1585	1.0	1.0	1.0
16:31183958:C:T	530	259	622	339	283	1.0	1.0	0.0
16:31192208:G:C	0	0	0	0	0	0	0	0
16:31219142:C:T	0	0	0	0	0	0	0	0
16:31325398:G:A	18	8	29	12	17	1.0	1.0	0.0
16:31462770:A:G	3	1	3	2	1	1	1	0
16:31465137:C:T	0	0	0	0	0	0	0	0
16:31528613:G:T	7	0	7	7	0	1	1	0
16:31569209:A:C	6	0	6	6	0	1.0	1.0	0.0
16:33698410:T:A	0	0	0	0	0	0	0	0
16:34268412:G:C	0	0	0	0	0	0	0	0
16:35169737:C:G	0	0	0	0	0	0	0	0
16:46689686:T:C	4	2	14	10	4	2.5	1.0	0.5
16:46740087:C:A	0	0	0	0	0	0	0	0
16:47650919:C:A	15	8	26	14	12	1	0	1
16:48100931:G:A	0	0	0	0	0	0	0	0
16:48130866:T:C	0	0	0	0	0	0	0	0
16:49638609:A:G	0	0	0	0	0	0	0	0
16:50308747:C:T	5	0	7	7	0	1	1	0
16:50699948:C:G	0	0	0	0	0	0	0	0
16:50710008:C:T	0	0	0	0	0	0	0	0
16:50723365:G:A	0	0	0	0	0	0	0	0
16:50793607:C:T	21	10	27	15	12	1	1	0
16:50807475:C:T	0	0	0	0	0	0	0	0
16:50807573:G:A	0	0	0	0	0	0	0	0
16:51645773:C:T	0	0	0	0	0	0	0	0
16:52439351:A:G	0	0	0	0	0	0	0	0
16:52655601:A:G	3	0	3	3	0	1	1	0
16:52935600:C:G	0	0	0	0	0	0	0	0
16:53292948:G:A	4	3	6	3	3	1.0	0.0	1.0
16:53324527:A:G	8	2	11	6	5	1.0	1.0	0.0
16:53470022:G:A	22	6	23	16	7	1.0	1.0	0.0
16:53470809:T:C	19	7	21	13	8	1	1	0
16:53479121:C:T	5	3	7	3	4	1	0	1
16:53479143:T:C	5	3	9	3	6	1	0	1
16:53602088:G:A	0	0	0	0	0	0	0	0
16:53637842:C:T	1	0	1	1	0	1	1	0
16:53686524:C:T	0	0	0	0	0	0	0	0
16:55485623:G:C	0	0	0	0	0	0	0	0
16:55493201:G:A	0	0	0	0	0	0	0	0
16:55502815:C:T	0	0	0	0	0	0	0	0
16:55528554:G:A	1	0	1	1	0	1	1	0
16:55697923:G:A	0	0	0	0	0	0	0	0
16:55846568:A:C	0	0	0	0	0	0	0	0
16:55846622:G:C	0	0	0	0	0	0	0	0
16:55849706:T:C	0	0	0	0	0	0	0	0
16:56343836:A:G	0	0	0	0	0	0	0	0
16:56511263:T:C	7	6	10	1	9	1	0	1
16:56626773:A:G	0	0	0	0	0	0	0	0
16:56644113:G:A	15	5	29	19	10	2	1	0
16:56805527:C:T	9	5	16	4	12	1	0	1
16:56821584:C:G	3	0	3	3	0	1	1	0
16:56879601:C:T	1	0	1	1	0	1	1	0
16:56973441:C:T	1	1	1	0	1	1	0	1
16:56982180:G:A	16	5	42	27	15	2.0	1.5	0.0
16:56983750:G:A	0	0	0	0	0	0	0	0
16:57026185:C:T	4	2	8	5	3	2.0	1.0	0.5
16:57061863:C:T	11	5	11	6	5	1	1	0
16:57125336:C:T	0	0	0	0	0	0	0	0
16:57465990:T:C	719	366	1019	545	474	1	1	1
16:57469301:C:T	2	1	2	1	1	1.0	0.5	0.5
16:57737214:G:T	87	44	89	45	44	1	0	1
16:57752605:C:T	0	0	0	0	0	0	0	0
16:57752799:C:T	2	2	2	0	2	1.0	0.0	1.0
16:57903884:T:C	0	0	0	0	0	0	0	0
16:57960043:T:C	0	0	0	0	0	0	0	0
16:57985492:G:A	0	0	0	0	0	0	0	0
16:58045261:G:A	0	0	0	0	0	0	0	0
16:58506971:G:A	0	0	0	0	0	0	0	0
16:58541585:G:A	9	1	14	12	2	1	1	0
16:58553833:C:T	4	1	4	3	1	1.0	1.0	0.0
16:58667412:G:A	4	3	4	1	3	1.0	0.0	1.0
16:58716700:G:A	6	3	8	5	3	1.0	0.5	0.5
16:58723764:A:C	181	87	243	129	114	1	1	0
16:58723779:A:G	198	99	269	141	128	1.0	1.0	0.5
16:60357268:A:G	0	0	0	0	0	0	0	0
16:60358651:G:A	0	0	0	0	0	0	0	0
16:64988211:C:T	0	0	0	0	0	0	0	0
16:64988331:C:T	0	0	0	0	0	0	0	0
16:64991815:G:A	0	0	0	0	0	0	0	0
16:66386982:C:T	0	0	0	0	0	0	0	0
16:66398520:T:C	0	0	0	0	0	0	0	0
16:66727713:T:C	8	7	8	1	7	1.0	0.0	1.0
16:66966364:G:A	0	0	0	0	0	0	0	0
16:67435753:C:T	1	0	1	1	0	1	1	0
16:68823538:T:C	0	0	0	0	0	0	0	0
16:69109913:G:A	0	0	0	0	0	0	0	0
16:69167147:C:T	16	6	19	13	6	1.0	1.0	0.0
16:69320779:C:T	0	0	0	0	0	0	0	0
16:69321060:A:G	22	13	50	16	34	2.0	0.0	1.0
16:69330540:A:G	6	3	24	21	3	1.0	0.5	0.5
16:69339511:T:C	50	20	88	52	36	1.5	1.0	0.0
16:69339991:T:A	14	6	43	33	10	2.5	1.5	0.0
16:69742474:T:A	13	6	16	10	6	1	1	0
16:69757363:T:G	0	0	0	0	0	0	0	0
16:70130431:A:G	2	0	2	2	0	1.0	1.0	0.0
16:71066935:T:C	0	0	0	0	0	0	0	0
16:71203799:C:T	0	0	0	0	0	0	0	0
16:71230620:T:A	0	0	0	0	0	0	0	0
16:71230658:A:G	0	0	0	0	0	0	0	0
16:71475685:G:A	2	2	2	0	2	1.0	0.0	1.0
16:71475731:G:C	1	1	1	0	1	1	0	1
16:71626501:G:A	0	0	0	0	0	0	0	0
16:71648927:C:T	1	0	1	1	0	1	1	0
16:71678883:A:G	0	0	0	0	0	0	0	0
16:71739287:G:T	6	4	12	6	6	1.5	0.0	1.0
16:71954207:C:T	0	0	0	0	0	0	0	0
16:71967237:G:A	0	0	0	0	0	0	0	0
16:71977282:G:T	0	0	0	0	0	0	0	0
16:71977294:A:C	0	0	0	0	0	0	0	0
16:71977362:A:G	0	0	0	0	0	0	0	0
16:71986395:G:A	0	0	0	0	0	0	0	0
16:71986424:A:G	0	0	0	0	0	0	0	0
16:71998332:T:A	0	0	0	0	0	0	0	0
16:72005706:G:T	0	0	0	0	0	0	0	0
16:72005772:T:C	0	0	0	0	0	0	0	0
16:72006133:T:G	0	0	0	0	0	0	0	0
16:72008783:A:C	9	3	20	13	7	1	1	0
16:72014433:T:C	0	0	0	0	0	0	0	0
16:72150730:C:T	1	1	1	0	1	1	0	1
16:72793859:T:C	1	1	1	0	1	1	0	1
16:72798236:T:A	0	0	0	0	0	0	0	0
16:72950769:C:T	3	1	5	2	3	1	1	0
16:72957530:C:T	0	0	0	0	0	0	0	0
16:73092959:T:G	0	0	0	0	0	0	0	0
16:74716498:T:C	2	2	2	0	2	1.0	0.0	1.0
16:74740049:G:A	13	4	15	10	5	1	1	0
16:75204205:C:T	0	0	0	0	0	0	0	0
16:75206985:G:A	0	0	0	0	0	0	0	0
16:75294018:A:G	16	8	21	11	10	1.0	0.5	0.5
16:75479345:G:C	0	0	0	0	0	0	0	0
16:76235415:C:G	0	0	0	0	0	0	0	0
16:76309870:C:T	0	0	0	0	0	0	0	0
16:77195074:C:T	4	3	5	2	3	1.0	0.0	1.0
16:77199441:C:T	4	3	6	3	3	1.0	0.0	1.0
16:77291428:G:T	0	0	0	0	0	0	0	0
16:77356059:A:G	0	0	0	0	0	0	0	0
16:77892602:T:A	0	0	0	0	0	0	0	0
16:77892744:T:C	0	0	0	0	0	0	0	0
16:77892910:A:G	0	0	0	0	0	0	0	0
16:78029103:T:C	0	0	0	0	0	0	0	0
16:78049572:C:T	0	0	0	0	0	0	0	0
16:78278630:A:G	0	0	0	0	0	0	0	0
16:78386878:G:A	1	1	1	0	1	1	0	1
16:80548970:G:T	0	0	0	0	0	0	0	0
16:81123748:G:A	0	0	0	0	0	0	0	0
16:81127973:G:A	0	0	0	0	0	0	0	0
16:81147383:C:G	0	0	0	0	0	0	0	0
16:81165915:T:C	0	0	0	0	0	0	0	0
16:81168015:C:A	0	0	0	0	0	0	0	0
16:81168020:G:A	0	0	0	0	0	0	0	0
16:81262175:C:A	0	0	0	0	0	0	0	0
16:81268089:A:T	0	0	0	0	0	0	0	0
16:81476213:C:T	4	0	24	24	0	5.0	5.0	0.0
16:81476240:C:T	4	0	20	20	0	3.0	3.0	0.0
16:81786163:T:C	299	153	447	218	229	1	1	1
16:81908423:C:G	45	19	85	55	30	1	1	0
16:82170106:G:T	26	14	53	23	30	2.0	0.0	1.0
16:82170137:T:C	34	13	49	29	20	1.0	1.0	0.0
16:82884247:T:C	0	0	0	0	0	0	0	0
16:83949466:C:T	0	0	0	0	0	0	0	0
16:83951171:A:C	0	0	0	0	0	0	0	0
16:84001841:C:G	0	0	0	0	0	0	0	0
16:84169905:G:A	1	1	3	0	3	3	0	3
16:84169989:C:G	1	1	3	0	3	3	0	3
16:84170006:A:G	1	0	4	4	0	4	4	0
16:84170333:C:T	0	0	0	0	0	0	0	0
16:84174729:G:T	0	0	0	0	0	0	0	0
16:84175892:T:C	0	0	0	0	0	0	0	0
16:84176132:T:C	1	0	1	1	0	1	1	0
16:84176210:T:C	3	0	3	3	0	1	1	0
16:84176258:G:C	3	0	4	4	0	1	1	0
16:84178363:A:C	0	0	0	0	0	0	0	0
16:84179247:G:C	3	1	3	2	1	1	1	0
16:84181527:C:T	1	0	1	1	0	1	1	0
16:84184959:T:C	30	14	37	23	14	1.0	1.0	0.0
16:84236870:G:A	0	0	0	0	0	0	0	0
16:84326857:C:T	0	0	0	0	0	0	0	0
16:84452071:T:A	0	0	0	0	0	0	0	0
16:84453297:C:T	0	0	0	0	0	0	0	0
16:84657438:C:T	3	1	3	2	1	1	1	0
16:84745084:CCCGTCAG:TCCGCCAC	10	4	10	6	4	1.0	1.0	0.0
16:85067370:G:A	0	0	0	0	0	0	0	0
16:87311261:G:A	1	1	3	0	3	3	0	3
16:87460131:T:C	0	0	0	0	0	0	0	0
16:87644538:T:C	0	0	0	0	0	0	0	0
16:87644559:G:A	0	0	0	0	0	0	0	0
16:87690232:T:C	0	0	0	0	0	0	0	0
16:87696093:C:T	0	0	0	0	0	0	0	0
16:87701921:G:A	0	0	0	0	0	0	0	0
16:87755258:G:A	61	20	75	51	24	1	1	0
16:87984203:C:T	28	10	34	23	11	1.0	1.0	0.0
16:88018555:C:A	4	2	4	2	2	1.0	0.5	0.5
16:88027544:C:T	5	3	8	4	4	1	0	1
16:88072119:G:A	10	5	20	13	7	1.5	0.5	0.5
16:88439227:A:G	1	0	1	1	0	1	1	0
16:88439340:G:A	0	0	0	0	0	0	0	0
16:88439378:C:A	0	0	0	0	0	0	0	0
16:88647078:C:A	33	19	37	17	20	1	0	1
16:88657939:G:T	127	54	160	94	66	1	1	0
16:88737574:C:G	0	0	0	0	0	0	0	0
16:88738326:A:G	0	0	0	0	0	0	0	0
16:88743072:A:G	0	0	0	0	0	0	0	0
16:88743278:T:C	0	0	0	0	0	0	0	0
16:88805821:A:G	1	0	2	2	0	2	2	0
16:88808224:C:G	1	1	1	0	1	1	0	1
16:88951161:G:C	0	0	0	0	0	0	0	0
16:89114357:A:T	33	25	102	15	87	2	0	1
16:89114475:G:A	23	16	32	14	18	1	0	1
16:89136665:C:T	0	0	0	0	0	0	0	0
16:89154771:G:A	0	0	0	0	0	0	0	0
16:89168540:C:A	0	0	0	0	0	0	0	0
16:89171820:G:A	0	0	0	0	0	0	0	0
16:89196249:G:A	0	0	0	0	0	0	0	0
16:89198679:A:G	0	0	0	0	0	0	0	0
16:89233024:G:T	1	1	1	0	1	1	0	1
16:89233034:G:A	0	0	0	0	0	0	0	0
16:89233399:A:G	0	0	0	0	0	0	0	0
16:89233422:A:G	0	0	0	0	0	0	0	0
16:89282198:A:G	9	4	13	6	7	1	1	0
16:89530649:G:T	0	0	0	0	0	0	0	0
16:89530813:A:G	2	2	2	0	2	1.0	0.0	1.0
16:89553201:C:T	0	0	0	0	0	0	0	0
16:89637957:G:C	0	0	0	0	0	0	0	0
16:89694244:C:T	6	2	17	9	8	1.5	1.0	0.0
16:89723490:T:C	6	3	11	3	8	1.0	0.5	0.5
16:89739569:G:A	10	5	11	5	6	1.0	0.5	0.5
16:89783072:C:T	0	0	0	0	0	0	0	0
16:89792600:G:A	0	0	0	0	0	0	0	0
16:89799635:T:C	0	0	0	0	0	0	0	0
16:89965888:T:G	1	0	5	5	0	5	5	0
16:89971474:C:T	5	0	5	5	0	1	1	0
16:90031264:C:A	11	3	14	8	6	1	1	0
16:90036679:C:T	1	1	1	0	1	1	0	1
16:90036709:G:A	1	1	1	0	1	1	0	1
16:90057865:G:T	0	0	0	0	0	0	0	0
16:90063728:C:T	0	0	0	0	0	0	0	0
16:90074947:A:C	0	0	0	0	0	0	0	0
16:90093656:A:G	0	0	0	0	0	0	0	0
16:90093732:A:G	0	0	0	0	0	0	0	0
16:90093818:TTCT:CTCG	0	0	0	0	0	0	0	0
16:90094626:C:A	0	0	0	0	0	0	0	0
16:90095345:T:C	0	0	0	0	0	0	0	0
16:90095444:A:G	0	0	0	0	0	0	0	0
16:90095778:T:C	0	0	0	0	0	0	0	0
17:137637:G:A	0	0	0	0	0	0	0	0
17:156324:G:C	0	0	0	0	0	0	0	0
17:156366:A:G	0	0	0	0	0	0	0	0
17:410508:G:A	33	0	35	35	0	1	1	0
17:562535:G:A	2	1	3	2	1	1.5	1.0	0.5
17:714629:G:A	183	75	273	153	120	1	1	0
17:714753:C:T	43	23	53	21	32	1	0	1
17:745827:A:G	6	4	6	2	4	1.0	0.0	1.0
17:1067173:C:T	4	3	9	6	3	1.0	0.0	1.0
17:1470224:T:C	5	2	6	4	2	1	1	0
17:1484178:C:T	73	43	102	44	58	1	0	1
17:1553024:G:A	17	8	22	10	12	1	1	0
17:1661034:G:A	8	2	15	13	2	1.0	1.0	0.0
17:1673075:C:T	1	1	4	0	4	4	0	4
17:1675645:C:T	9	2	12	10	2	1	1	0
17:1677635:G:C	107	50	268	152	116	2	1	0
17:1681030:A:G	42	14	129	82	47	1.5	1.0	0.0
17:1681836:A:G	19	9	25	14	11	1	1	0
17:1708035:C:T	0	0	0	0	0	0	0	0
17:1726675:C:T	0	0	0	0	0	0	0	0
17:1734008:A:G	6	2	6	4	2	1.0	1.0	0.0
17:1736164:A:G	20	12	22	8	14	1.0	0.0	1.0
17:1737415:C:T	14	5	17	9	8	1.0	1.0	0.0
17:1745000:C:T	0	0	0	0	0	0	0	0
17:1745728:C:T	1	1	3	0	3	3	0	3
17:1769810:G:A	0	0	0	0	0	0	0	0
17:1771833:C:T	335	175	444	214	230	1	1	1
17:1776511:A:G	1	0	3	3	0	3	3	0
17:1776708:T:C	23	13	55	30	25	1	0	1
17:1783116:T:C	47	24	73	41	32	1	0	1
17:1800249:G:C	5	2	6	4	2	1	1	0
17:1800688:C:T	1	0	3	3	0	3	3	0
17:1804599:T:A	0	0	0	0	0	0	0	0
17:2036938:A:G	31	15	57	28	29	1	1	0
17:2040594:T:C	25	15	41	17	24	1	0	1
17:2188471:C:T	4	0	4	4	0	1.0	1.0	0.0
17:2282806:C:T	2	1	5	3	2	2.5	1.5	1.0
17:2299649:T:C	2	0	2	2	0	1.0	1.0	0.0
17:2299873:T:G	4	0	4	4	0	1.0	1.0	0.0
17:2300159:A:G	1	1	1	0	1	1	0	1
17:2307707:G:A	0	0	0	0	0	0	0	0
17:2363505:G:A	2	2	4	0	4	2.0	0.0	2.0
17:2363518:T:C	2	2	2	0	2	1.0	0.0	1.0
17:2365017:G:A	1	0	1	1	0	1	1	0
17:2415256:G:C	1	0	1	1	0	1	1	0
17:2670358:C:T	6	2	10	8	2	1.5	1.5	0.0
17:2692670:G:A	2	1	2	1	1	1.0	0.5	0.5
17:3026098:G:A	2	0	5	5	0	2.5	2.5	0.0
17:3027045:G:A	0	0	0	0	0	0	0	0
17:3062879:G:C	1	0	6	6	0	6	6	0
17:3062897:G:A	1	0	7	7	0	7	7	0
17:3062979:G:A	1	0	9	9	0	9	9	0
17:3063014:C:T	1	0	6	6	0	6	6	0
17:3116496:A:G	0	0	0	0	0	0	0	0
17:3198296:C:T	0	0	0	0	0	0	0	0
17:3216103:G:T	0	0	0	0	0	0	0	0
17:3216317:G:A	0	0	0	0	0	0	0	0
17:3216379:A:G	0	0	0	0	0	0	0	0
17:3216473:C:T	0	0	0	0	0	0	0	0
17:3265898:G:C	0	0	0	0	0	0	0	0
17:3278261:A:G	0	0	0	0	0	0	0	0
17:3310434:A:G	0	0	0	0	0	0	0	0
17:3310568:C:G	0	0	0	0	0	0	0	0
17:3310617:G:C	0	0	0	0	0	0	0	0
17:3310668:A:G	0	0	0	0	0	0	0	0
17:3310812:C:A	0	0	0	0	0	0	0	0
17:3310834:A:G	0	0	0	0	0	0	0	0
17:3432966:A:G	0	0	0	0	0	0	0	0
17:3433763:A:G	0	0	0	0	0	0	0	0
17:3449015:T:C	0	0	0	0	0	0	0	0
17:3476195:A:G	0	0	0	0	0	0	0	0
17:3518783:G:A	0	0	0	0	0	0	0	0
17:3583408:G:A	1	1	1	0	1	1	0	1
17:3589906:C:G	1	0	1	1	0	1	1	0
17:3724053:C:T	1	1	1	0	1	1	0	1
17:3753865:C:T	0	0	0	0	0	0	0	0
17:3753881:T:C	0	0	0	0	0	0	0	0
17:3814413:C:T	8	5	8	3	5	1.0	0.0	1.0
17:3897786:C:T	0	0	0	0	0	0	0	0
17:3915494:G:A	0	0	0	0	0	0	0	0
17:3915536:A:G	0	0	0	0	0	0	0	0
17:3925408:T:C	57	30	98	49	49	1	0	1
17:3930446:G:A	2	0	2	2	0	1.0	1.0	0.0
17:3936391:G:A	34	15	44	22	22	1.0	1.0	0.0
17:3937634:A:G	29	9	47	22	25	1	1	0
17:3942633:A:G	33	17	54	26	28	1	1	1
17:3943508:A:G	28	17	62	26	36	1.0	0.0	1.0
17:3944719:A:C	31	18	56	24	32	1	0	1
17:4006831:A:G	4	2	5	2	3	1.0	0.5	0.5
17:4008969:C:T	0	0	0	0	0	0	0	0
17:4044350:T:C	15	8	25	14	11	1	0	1
17:4049789:T:C	14	6	26	16	10	1.0	1.0	0.0
17:4049808:A:G	13	5	25	15	10	1	1	0
17:4062770:A:G	6	4	7	2	5	1.0	0.0	1.0
17:4074238:G:A	5	4	12	1	11	1	0	1
17:4095905:C:T	2	1	2	1	1	1.0	0.5	0.5
17:4112703:A:G	1	0	1	1	0	1	1	0
17:4302150:T:C	2	2	3	0	3	1.5	0.0	1.5
17:4434117:C:G	0	0	0	0	0	0	0	0
17:4487837:C:T	10	3	10	7	3	1.0	1.0	0.0
17:4487858:A:G	16	5	16	11	5	1.0	1.0	0.0
17:4487906:A:G	32	12	33	21	12	1.0	1.0	0.0
17:4554276:C:T	36	20	40	19	21	1.0	0.0	1.0
17:4558453:G:A	0	0	0	0	0	0	0	0
17:4559740:G:T	0	0	0	0	0	0	0	0
17:4632244:G:A	0	0	0	0	0	0	0	0
17:4632946:T:C	0	0	0	0	0	0	0	0
17:4719343:C:T	18	8	21	12	9	1.0	1.0	0.0
17:4735189:T:C	9	6	10	3	7	1	0	1
17:4783119:A:C	0	0	0	0	0	0	0	0
17:4809100:A:T	3	2	3	1	2	1	0	1
17:4892976:CAGT:TAGC	0	0	0	0	0	0	0	0
17:4892991:C:T	10	7	15	5	10	1.0	0.0	1.0
17:4901607:G:A	0	0	0	0	0	0	0	0
17:4953081:A:G	15	6	18	11	7	1	1	0
17:4960115:A:G	3	3	3	0	3	1	0	1
17:4972333:A:G	6	0	7	7	0	1.0	1.0	0.0
17:5023587:A:G	8	5	10	5	5	1.0	0.0	1.0
17:5033041:A:T	1	1	1	0	1	1	0	1
17:5033603:C:T	0	0	0	0	0	0	0	0
17:5109327:C:T	1	0	2	2	0	2	2	0
17:5132362:G:T	0	0	0	0	0	0	0	0
17:5135843:C:T	0	0	0	0	0	0	0	0
17:5139051:C:A	0	0	0	0	0	0	0	0
17:5139127:G:A	0	0	0	0	0	0	0	0
17:5139420:G:A	0	0	0	0	0	0	0	0
17:5139542:C:T	0	0	0	0	0	0	0	0
17:5182562:C:T	1	1	1	0	1	1	0	1
17:5223473:G:A	6	4	35	13	22	5.0	0.0	2.5
17:5515479:G:A	21	13	46	28	18	1	0	1
17:5521586:C:G	17	11	22	6	16	1	0	1
17:5521671:G:A	15	8	16	7	9	1	0	1
17:5529975:G:A	9	6	26	20	6	1	0	1
17:5530521:A:G	23	11	34	21	13	1	1	0
17:5530646:T:C	27	14	35	18	17	1	0	1
17:5533965:G:A	19	6	34	27	7	1	1	0
17:5541923:G:A	17	8	20	10	10	1	1	0
17:5541994:G:A	16	7	24	11	13	1.0	1.0	0.0
17:5558575:C:A	3	3	3	0	3	1	0	1
17:5558815:T:C	12	4	14	10	4	1.0	1.0	0.0
17:5559334:G:A	4	0	4	4	0	1.0	1.0	0.0
17:5583844:C:G	11	4	19	15	4	1	1	0
17:6610009:G:A	0	0	0	0	0	0	0	0
17:6620978:T:A	4	2	8	5	3	2.0	1.0	0.5
17:6661308:C:A	13	3	38	30	8	2	1	0
17:6780684:C:G	0	0	0	0	0	0	0	0
17:6999424:G:A	1	1	1	0	1	1	0	1
17:6999441:A:G	1	1	1	0	1	1	0	1
17:7001742:T:G	5	5	9	0	9	2	0	2
17:7038789:C:T	0	0	0	0	0	0	0	0
17:7078034:G:C	1	0	1	1	0	1	1	0
17:7078078:A:G	1	1	1	0	1	1	0	1
17:7107810:C:T	0	0	0	0	0	0	0	0
17:7108754:GGCCCCC:TGCCTCT	0	0	0	0	0	0	0	0
17:7173778:C:T	0	0	0	0	0	0	0	0
17:7227798:G:A	0	0	0	0	0	0	0	0
17:7283804:T:C	0	0	0	0	0	0	0	0
17:7311505:C:T	20	8	23	12	11	1.0	1.0	0.0
17:7314144:T:C	623	312	1679	910	769	2	1	1
17:7318066:G:A	10	5	36	21	15	3.0	0.5	0.5
17:7318220:G:C	0	0	0	0	0	0	0	0
17:7318225:T:C	0	0	0	0	0	0	0	0
17:7318388:G:T	0	0	0	0	0	0	0	0
17:7342052:A:G	598	299	974	494	480	1.0	1.0	0.5
17:7382947:C:T	0	0	0	0	0	0	0	0
17:7383007:T:A	0	0	0	0	0	0	0	0
17:7390396:C:T	30	17	133	60	73	3.0	0.0	1.0
17:7394133:A:G	883	535	4360	1957	2403	4	0	1
17:7403408:A:G	12	8	33	9	24	2.5	0.0	1.0
17:7426313:T:G	0	0	0	0	0	0	0	0
17:7445306:A:G	0	0	0	0	0	0	0	0
17:7447225:G:A	0	0	0	0	0	0	0	0
17:7550188:C:A	307	171	947	426	521	2	0	1
17:7559652:A:G	66	41	97	36	61	1.0	0.0	1.0
17:7575180:G:A	1934	1273	19263	9728	9535	8.0	4.0	3.0
17:7587859:G:T	2	2	2	0	2	1.0	0.0	1.0
17:7626829:G:C	4	2	4	2	2	1.0	0.5	0.5
17:7626953:C:T	20	8	23	13	10	1.0	1.0	0.0
17:7630105:G:A	0	0	0	0	0	0	0	0
17:7630399:T:C	0	0	0	0	0	0	0	0
17:7651454:C:T	0	0	0	0	0	0	0	0
17:7674797:T:C	0	0	0	0	0	0	0	0
17:7676154:G:C	57	32	74	38	36	1	0	1
17:7754711:G:T	0	0	0	0	0	0	0	0
17:7754716:C:T	0	0	0	0	0	0	0	0
17:7776841:G:A	0	0	0	0	0	0	0	0
17:7778160:C:T	0	0	0	0	0	0	0	0
17:7903922:C:T	2	0	2	2	0	1.0	1.0	0.0
17:7939735:C:T	2	1	2	1	1	1.0	0.5	0.5
17:7945769:C:G	4	2	4	2	2	1.0	0.5	0.5
17:8047059:C:T	0	0	0	0	0	0	0	0
17:8047076:G:A	0	0	0	0	0	0	0	0
17:8047634:C:A	0	0	0	0	0	0	0	0
17:8080651:G:C	0	0	0	0	0	0	0	0
17:8118747:G:A	0	0	0	0	0	0	0	0
17:8176179:G:C	22	11	22	11	11	1.0	0.5	0.5
17:8253992:C:T	20	10	23	11	12	1.0	0.5	0.5
17:8257831:C:T	1	0	6	6	0	6	6	0
17:8264282:T:C	0	0	0	0	0	0	0	0
17:8313150:T:C	0	0	0	0	0	0	0	0
17:8320958:T:C	0	0	0	0	0	0	0	0
17:8340343:G:A	0	0	0	0	0	0	0	0
17:8369449:G:A	1	0	7	7	0	7	7	0
17:8513583:C:T	0	0	0	0	0	0	0	0
17:8560600:G:A	0	0	0	0	0	0	0	0
17:8561512:G:A	0	0	0	0	0	0	0	0
17:8561538:G:A	0	0	0	0	0	0	0	0
17:8797664:C:T	0	0	0	0	0	0	0	0
17:9491914:G:A	61	32	94	51	43	1	0	1
17:9568394:T:G	227	121	242	121	121	1	1	1
17:9682848:C:T	0	0	0	0	0	0	0	0
17:9889451:G:A	0	0	0	0	0	0	0	0
17:9889555:T:C	0	0	0	0	0	0	0	0
17:10313193:G:A	0	0	0	0	0	0	0	0
17:10320476:C:T	0	0	0	0	0	0	0	0
17:10343882:G:A	0	0	0	0	0	0	0	0
17:10393169:G:A	0	0	0	0	0	0	0	0
17:10500729:G:A	0	0	0	0	0	0	0	0
17:11241911:C:T	0	0	0	0	0	0	0	0
17:11769290:G:T	0	0	0	0	0	0	0	0
17:11929970:A:G	0	0	0	0	0	0	0	0
17:11930048:G:A	0	0	0	0	0	0	0	0
17:11962145:G:A	0	0	0	0	0	0	0	0
17:12753100:T:C	0	0	0	0	0	0	0	0
17:12974213:C:T	0	0	0	0	0	0	0	0
17:14069638:C:T	61	33	83	38	45	1	0	1
17:14076741:A:T	132	65	151	78	73	1.0	1.0	0.0
17:14077033:G:A	10	5	16	6	10	1.0	0.5	0.5
17:14191992:A:G	3	1	3	2	1	1	1	0
17:15239438:G:A	0	0	0	0	0	0	0	0
17:15304047:T:G	0	0	0	0	0	0	0	0
17:15588894:A:G	0	0	0	0	0	0	0	0
17:15704463:A:G	0	0	0	0	0	0	0	0
17:15741192:C:T	0	0	0	0	0	0	0	0
17:15741975:G:A	0	0	0	0	0	0	0	0
17:15783925:G:T	1	0	1	1	0	1	1	0
17:15787253:G:A	0	0	0	0	0	0	0	0
17:15787574:C:G	0	0	0	0	0	0	0	0
17:15787805:C:A	0	0	0	0	0	0	0	0
17:15817600:C:T	0	0	0	0	0	0	0	0
17:16000288:C:A	23	7	24	17	7	1	1	0
17:16026773:G:A	3	3	3	0	3	1	0	1
17:16325918:A:G	5	4	8	1	7	1	0	1
17:16422654:A:G	7	4	9	5	4	1	0	1
17:16422691:A:C	4	3	4	1	3	1.0	0.0	1.0
17:16433678:C:G	20	10	38	26	12	1.0	0.5	0.5
17:16818967:G:A	0	0	0	0	0	0	0	0
17:16832713:A:G	0	0	0	0	0	0	0	0
17:16893377:C:T	0	0	0	0	0	0	0	0
17:16952564:C:T	433	225	548	271	277	1	1	1
17:16988951:G:A	11	4	19	14	5	1	1	0
17:16989020:C:T	9	3	39	20	19	4	1	0
17:17142710:C:A	4	1	9	4	5	1.5	1.0	0.0
17:17158927:C:G	3	2	4	1	3	1	0	1
17:17165791:G:A	0	0	0	0	0	0	0	0
17:17224157:G:A	1	1	1	0	1	1	0	1
17:17264850:G:A	8	4	18	13	5	1.0	0.5	0.5
17:17276167:G:A	21	12	28	12	16	1	0	1
17:17794940:G:A	1	1	1	0	1	1	0	1
17:17814832:C:A	0	0	0	0	0	0	0	0
17:17817969:A:C	0	0	0	0	0	0	0	0
17:18651201:T:C	0	0	0	0	0	0	0	0
17:18662110:G:A	0	0	0	0	0	0	0	0
17:18671685:A:T	0	0	0	0	0	0	0	0
17:18727682:G:A	0	0	0	0	0	0	0	0
17:18744312:T:A	0	0	0	0	0	0	0	0
17:18749757:G:A	0	0	0	0	0	0	0	0
17:18781329:G:T	3	1	4	3	1	1	1	0
17:18797530:C:A	1	1	1	0	1	1	0	1
17:18908389:A:G	1	0	3	3	0	3	3	0
17:18971407:C:G	1	0	1	1	0	1	1	0
17:18976955:C:A	0	0	0	0	0	0	0	0
17:19015083:G:C	0	0	0	0	0	0	0	0
17:19019867:C:T	0	0	0	0	0	0	0	0
17:19713923:G:T	0	0	0	0	0	0	0	0
17:19739639:G:C	0	0	0	0	0	0	0	0
17:19742625:A:C	1	1	1	0	1	1	0	1
17:19909228:T:C	10	7	22	8	14	1.5	0.0	1.0
17:19958145:C:T	11	5	11	6	5	1	1	0
17:20110489:G:A	1	0	1	1	0	1	1	0
17:20111865:G:C	0	0	0	0	0	0	0	0
17:20112115:G:A	0	0	0	0	0	0	0	0
17:20112287:G:C	0	0	0	0	0	0	0	0
17:20204460:T:C	4	1	5	4	1	1.0	1.0	0.0
17:20314062:G:A	0	0	0	0	0	0	0	0
17:20351285:A:G	0	0	0	0	0	0	0	0
17:20376520:C:G	0	0	0	0	0	0	0	0
17:20429637:G:A	0	0	0	0	0	0	0	0
17:20841288:C:T	4	0	33	33	0	8.0	8.0	0.0
17:20841334:A:C	3	0	17	17	0	7	7	0
17:20902035:A:G	0	0	0	0	0	0	0	0
17:20902358:C:G	0	0	0	0	0	0	0	0
17:20981555:C:T	80	38	180	115	65	1.0	1.0	0.0
17:20981571:C:T	85	49	208	81	127	1	0	1
17:21005012:T:C	0	0	0	0	0	0	0	0
17:21007891:G:T	3	1	6	5	1	2	2	0
17:21011322:G:A	1	1	1	0	1	1	0	1
17:21021210:G:A	51	28	75	34	41	1	0	1
17:21171870:G:T	0	0	0	0	0	0	0	0
17:21291531:T:C	1	0	5	5	0	5	5	0
17:21291540:G:A	1	0	3	3	0	3	3	0
17:21295710:A:T	12	0	25	25	0	1.0	1.0	0.0
17:21295725:G:A	14	0	25	25	0	1.0	1.0	0.0
17:21296091:C:T	33	0	69	69	0	1	1	0
17:21296187:G:A	19	0	27	27	0	1	1	0
17:21298879:C:A	460	1	760	759	1	1.0	1.0	0.0
17:21298925:G:C	320	0	471	471	0	1.0	1.0	0.0
17:21302148:C:T	23	0	26	26	0	1	1	0
17:21415317:C:A	0	0	0	0	0	0	0	0
17:21415351:G:A	0	0	0	0	0	0	0	0
17:22298956:G:A	0	0	0	0	0	0	0	0
17:27412711:G:A	0	0	0	0	0	0	0	0
17:27430027:G:A	0	0	0	0	0	0	0	0
17:27582824:G:T	0	0	0	0	0	0	0	0
17:27769571:G:A	0	0	0	0	0	0	0	0
17:28468063:G:A	1669	0	2721	2721	0	1	1	0
17:28468138:G:A	541	0	642	642	0	1	1	0
17:28468295:G:T	4	0	4	4	0	1.0	1.0	0.0
17:28497138:A:G	0	0	0	0	0	0	0	0
17:28537284:G:C	0	0	0	0	0	0	0	0
17:28963972:G:A	0	0	0	0	0	0	0	0
17:29286132:A:G	4	1	5	3	2	1.0	1.0	0.0
17:29562968:T:C	30	16	36	15	21	1.0	0.0	1.0
17:29609328:C:T	0	0	0	0	0	0	0	0
17:29617071:C:T	0	0	0	0	0	0	0	0
17:29632885:G:A	8	7	16	1	15	1.0	0.0	1.0
17:30222880:G:T	0	0	0	0	0	0	0	0
17:30558349:A:G	0	0	0	0	0	0	0	0
17:30560116:G:A	1	0	1	1	0	1	1	0
17:30563283:G:A	0	0	0	0	0	0	0	0
17:30784350:A:G	17	11	17	6	11	1	0	1
17:31050001:G:A	0	0	0	0	0	0	0	0
17:31181757:G:A	3	1	6	4	2	2	1	0
17:31219157:T:C	0	0	0	0	0	0	0	0
17:31226467:G:A	2	2	2	0	2	1.0	0.0	1.0
17:31378929:T:C	0	0	0	0	0	0	0	0
17:31525074:A:G	1	0	1	1	0	1	1	0
17:31530442:G:A	0	0	0	0	0	0	0	0
17:31709634:C:T	0	0	0	0	0	0	0	0
17:31856838:T:C	83	52	96	32	64	1	0	1
17:31901637:G:A	25	15	30	11	19	1	0	1
17:32003267:G:A	0	0	0	0	0	0	0	0
17:33291714:A:G	0	0	0	0	0	0	0	0
17:34037767:G:A	0	0	0	0	0	0	0	0
17:34285875:G:A	0	0	0	0	0	0	0	0
17:34980567:G:A	7	1	16	13	3	2	1	0
17:35005610:G:A	1	0	2	2	0	2	2	0
17:35148982:G:A	0	0	0	0	0	0	0	0
17:35265572:C:T	0	0	0	0	0	0	0	0
17:35363447:C:A	0	0	0	0	0	0	0	0
17:35407646:G:T	1	0	2	2	0	2	2	0
17:35422527:A:G	0	0	0	0	0	0	0	0
17:35422900:A:C	1	0	1	1	0	1	1	0
17:35441180:G:A	0	0	0	0	0	0	0	0
17:35444977:G:A	0	0	0	0	0	0	0	0
17:35479527:G:A	0	0	0	0	0	0	0	0
17:35750213:G:A	0	0	0	0	0	0	0	0
17:35855337:G:A	0	0	0	0	0	0	0	0
17:35913045:T:C	0	0	0	0	0	0	0	0
17:35917049:G:T	0	0	0	0	0	0	0	0
17:35925533:A:C	0	0	0	0	0	0	0	0
17:35934827:A:G	0	0	0	0	0	0	0	0
17:36486677:G:A	5	1	5	4	1	1	1	0
17:36498436:G:A	4	4	4	0	4	1.0	0.0	1.0
17:36586165:G:A	35	20	47	21	26	1	0	1
17:36989342:T:C	26	13	30	15	15	1.0	0.5	0.5
17:37056706:C:T	23	12	23	11	12	1	0	1
17:37406385:G:A	6	2	6	4	2	1.0	1.0	0.0
17:38604500:G:T	0	0	0	0	0	0	0	0
17:38770478:T:G	1	1	1	0	1	1	0	1
17:38770514:G:A	0	0	0	0	0	0	0	0
17:38898519:C:T	14	5	20	11	9	1.0	1.0	0.0
17:38898631:A:G	0	0	0	0	0	0	0	0
17:38898713:C:T	0	0	0	0	0	0	0	0
17:38914405:A:G	13	5	17	12	5	1	1	0
17:38937257:T:C	0	0	0	0	0	0	0	0
17:39072512:A:G	0	0	0	0	0	0	0	0
17:39160735:T:C	0	0	0	0	0	0	0	0
17:39162776:T:G	0	0	0	0	0	0	0	0
17:39162812:C:T	0	0	0	0	0	0	0	0
17:39177990:G:A	1	1	1	0	1	1	0	1
17:39864168:G:A	522	270	1688	817	871	2.0	1.0	1.0
17:39965740:G:A	1	0	1	1	0	1	1	0
17:39965846:C:T	1	0	1	1	0	1	1	0
17:40020003:A:T	2	0	2	2	0	1.0	1.0	0.0
17:40023239:A:G	10	3	11	8	3	1.0	1.0	0.0
17:40029853:C:T	8	2	9	7	2	1.0	1.0	0.0
17:40484492:C:T	0	0	0	0	0	0	0	0
17:40488873:A:G	0	0	0	0	0	0	0	0
17:40699520:T:C	0	0	0	0	0	0	0	0
17:40701194:C:A	0	0	0	0	0	0	0	0
17:40794020:T:C	0	0	0	0	0	0	0	0
17:40799739:C:T	0	0	0	0	0	0	0	0
17:40822210:C:T	0	0	0	0	0	0	0	0
17:40834800:TT:GA	1	1	1	0	1	1	0	1
17:40882600:T:C	0	0	0	0	0	0	0	0
17:40925461:A:G	0	0	0	0	0	0	0	0
17:40928252:T:C	0	0	0	0	0	0	0	0
17:40958710:C:T	0	0	0	0	0	0	0	0
17:40966545:G:A	0	0	0	0	0	0	0	0
17:40978203:G:A	0	0	0	0	0	0	0	0
17:40978276:G:A	0	0	0	0	0	0	0	0
17:40978832:A:G	0	0	0	0	0	0	0	0
17:40978953:A:G	0	0	0	0	0	0	0	0
17:40978962:T:C	0	0	0	0	0	0	0	0
17:40981045:C:T	0	0	0	0	0	0	0	0
17:40981301:T:G	0	0	0	0	0	0	0	0
17:40983118:G:A	0	0	0	0	0	0	0	0
17:40983969:C:T	0	0	0	0	0	0	0	0
17:40984165:T:C	0	0	0	0	0	0	0	0
17:41004584:T:C	0	0	0	0	0	0	0	0
17:41004591:A:G	0	0	0	0	0	0	0	0
17:41008922:G:A	0	0	0	0	0	0	0	0
17:41029916:A:C	0	0	0	0	0	0	0	0
17:41140214:G:A	0	0	0	0	0	0	0	0
17:41149394:C:T	0	0	0	0	0	0	0	0
17:41149533:A:T	0	0	0	0	0	0	0	0
17:41424307:TGGT:AGGC	0	0	0	0	0	0	0	0
17:41462841:GT:AC	0	0	0	0	0	0	0	0
17:41462863:G:A	0	0	0	0	0	0	0	0
17:41462967:G:A	0	0	0	0	0	0	0	0
17:41464147:C:T	0	0	0	0	0	0	0	0
17:41467111:T:C	0	0	0	0	0	0	0	0
17:41478942:G:A	0	0	0	0	0	0	0	0
17:41487088:T:G	0	0	0	0	0	0	0	0
17:41518389:T:C	0	0	0	0	0	0	0	0
17:41525223:A:G	0	0	0	0	0	0	0	0
17:41528069:G:C	0	0	0	0	0	0	0	0
17:41567738:T:A	0	0	0	0	0	0	0	0
17:41571564:T:G	0	0	0	0	0	0	0	0
17:41586466:A:G	0	0	0	0	0	0	0	0
17:41586555:C:T	0	0	0	0	0	0	0	0
17:41586604:G:A	0	0	0	0	0	0	0	0
17:41586829:G:A	0	0	0	0	0	0	0	0
17:41611492:A:G	0	0	0	0	0	0	0	0
17:41622908:G:C	0	0	0	0	0	0	0	0
17:41727098:G:A	0	0	0	0	0	0	0	0
17:41727343:T:C	0	0	0	0	0	0	0	0
17:41727420:G:A	0	0	0	0	0	0	0	0
17:41727813:C:A	0	0	0	0	0	0	0	0
17:41803375:G:A	0	0	0	0	0	0	0	0
17:42170234:T:C	0	0	0	0	0	0	0	0
17:42202901:C:T	0	0	0	0	0	0	0	0
17:42669909:C:G	1	0	1	1	0	1	1	0
17:43092412:C:T	0	0	0	0	0	0	0	0
17:43526514:T:C	0	0	0	0	0	0	0	0
17:43719886:C:G	1	1	2	0	2	2	0	2
17:43720324:A:C	1	0	1	1	0	1	1	0
17:43823998:G:T	0	0	0	0	0	0	0	0
17:43854007:A:G	0	0	0	0	0	0	0	0
17:43882440:T:C	0	0	0	0	0	0	0	0
17:43882975:T:C	0	0	0	0	0	0	0	0
17:43917426:C:T	0	0	0	0	0	0	0	0
17:43925078:T:G	0	0	0	0	0	0	0	0
17:43953163:G:C	0	0	0	0	0	0	0	0
17:44148179:A:C	0	0	0	0	0	0	0	0
17:44176643:C:G	92	6	149	131	18	1.0	1.0	0.0
17:44190581:G:A	20	13	45	17	28	1.0	0.0	1.0
17:44210151:C:T	29	16	38	16	22	1	0	1
17:44257767:C:T	0	0	0	0	0	0	0	0
17:44374686:C:T	0	0	0	0	0	0	0	0
17:44379752:C:T	1	0	1	1	0	1	1	0
17:44708845:G:C	9	1	44	42	2	4	4	0
17:44876041:A:G	9	5	14	6	8	1	0	1
17:44883641:C:T	1	0	3	3	0	3	3	0
17:44904739:C:T	0	0	0	0	0	0	0	0
17:44915174:G:A	0	0	0	0	0	0	0	0
17:44926116:T:C	0	0	0	0	0	0	0	0
17:45034320:G:A	22	10	41	22	19	1.0	1.0	0.0
17:45099436:C:T	18	10	26	8	18	1.0	0.0	1.0
17:45103957:A:G	0	0	0	0	0	0	0	0
17:45149847:T:C	48	20	124	83	41	1.0	1.0	0.0
17:45234253:A:G	12	7	12	5	7	1.0	0.0	1.0
17:45242403:C:T	58	33	73	33	40	1.0	0.0	1.0
17:45255758:C:T	5	1	18	15	3	3	2	0
17:45264774:G:C	10	5	21	13	8	1.0	0.5	0.5
17:46875165:G:T	0	0	0	0	0	0	0	0
17:46931204:G:A	351	198	1816	793	1023	4	0	1
17:46940493:A:G	3	1	3	2	1	1	1	0
17:47017175:T:C	0	0	0	0	0	0	0	0
17:47017639:G:A	1	0	3	3	0	3	3	0
17:47017714:T:G	1	0	5	5	0	5	5	0
17:47017726:G:A	1	0	6	6	0	6	6	0
17:47054389:A:G	0	0	0	0	0	0	0	0
17:47290971:A:C	0	0	0	0	0	0	0	0
17:47370466:A:G	6	4	6	2	4	1.0	0.0	1.0
17:47412885:C:T	4	3	12	2	10	1.5	0.0	1.0
17:47492449:A:G	27	7	45	36	9	1	1	0
17:47808390:C:T	8	6	27	13	14	2.5	0.0	1.5
17:47813341:C:T	3	0	3	3	0	1	1	0
17:47816765:C:A	0	0	0	0	0	0	0	0
17:47835330:C:T	0	0	0	0	0	0	0	0
17:47945523:C:T	0	0	0	0	0	0	0	0
17:47981705:T:C	16	7	16	9	7	1.0	1.0	0.0
17:48026394:A:G	1	0	1	1	0	1	1	0
17:48057436:C:T	6	3	7	4	3	1.0	0.5	0.5
17:48170609:C:T	75	6	129	92	37	1	1	0
17:48184809:C:T	60	43	111	31	80	1.0	0.0	1.0
17:48722450:A:G	0	0	0	0	0	0	0	0
17:48728081:A:G	0	0	0	0	0	0	0	0
17:48770002:C:A	0	0	0	0	0	0	0	0
17:48817015:A:C	0	0	0	0	0	0	0	0
17:48862296:C:G	29	17	38	16	22	1	0	1
17:48958680:C:A	0	0	0	0	0	0	0	0
17:48958681:C:G	0	0	0	0	0	0	0	0
17:49171768:T:C	0	0	0	0	0	0	0	0
17:49252343:T:C	0	0	0	0	0	0	0	0
17:49510638:C:T	0	0	0	0	0	0	0	0
17:49706301:C:T	83	39	90	48	42	1	1	0
17:49994861:G:A	0	0	0	0	0	0	0	0
17:50192065:C:T	0	0	0	0	0	0	0	0
17:50193012:G:A	0	0	0	0	0	0	0	0
17:50196542:A:C	0	0	0	0	0	0	0	0
17:50278607:C:T	0	0	0	0	0	0	0	0
17:50278899:G:C	0	0	0	0	0	0	0	0
17:50378624:A:T	1	1	2	0	2	2	0	2
17:50378832:T:C	1	1	6	0	6	6	0	6
17:50461674:T:C	7	4	9	3	6	1	0	1
17:50464346:G:A	2	0	2	2	0	1.0	1.0	0.0
17:50479965:G:A	118	62	118	56	62	1.0	0.0	1.0
17:50479987:T:C	86	45	86	41	45	1.0	0.0	1.0
17:50521424:G:A	0	0	0	0	0	0	0	0
17:50526142:C:T	0	0	0	0	0	0	0	0
17:50531356:T:C	0	0	0	0	0	0	0	0
17:50539297:G:A	0	0	0	0	0	0	0	0
17:50541888:C:A	1	0	3	3	0	3	3	0
17:50550593:C:T	8	2	8	6	2	1.0	1.0	0.0
17:50552097:A:G	12	6	13	6	7	1.0	0.5	0.5
17:50575993:C:A	0	0	0	0	0	0	0	0
17:50836117:C:T	0	0	0	0	0	0	0	0
17:50839972:C:T	0	0	0	0	0	0	0	0
17:50840171:G:A	0	0	0	0	0	0	0	0
17:50863061:T:C	10	4	10	6	4	1.0	1.0	0.0
17:51273441:A:C	10	7	11	4	7	1.0	0.0	1.0
17:53823368:C:T	0	0	0	0	0	0	0	0
17:53824282:C:T	0	0	0	0	0	0	0	0
17:53824891:C:T	0	0	0	0	0	0	0	0
17:56372677:C:A	0	0	0	0	0	0	0	0
17:56372773:G:A	0	0	0	0	0	0	0	0
17:56499041:G:C	0	0	0	0	0	0	0	0
17:56795078:T:C	5	1	14	11	3	3	2	0
17:56795194:C:A	0	0	0	0	0	0	0	0
17:56834978:G:A	20	13	20	7	13	1.0	0.0	1.0
17:56901433:G:A	2	0	2	2	0	1.0	1.0	0.0
17:57872703:C:T	0	0	0	0	0	0	0	0
17:58169740:C:A	0	0	0	0	0	0	0	0
17:58169945:G:C	0	0	0	0	0	0	0	0
17:58170093:A:G	0	0	0	0	0	0	0	0
17:58170214:C:T	0	0	0	0	0	0	0	0
17:58192760:T:C	0	0	0	0	0	0	0	0
17:58193733:G:C	0	0	0	0	0	0	0	0
17:58205665:G:A	1	1	1	0	1	1	0	1
17:58302339:C:T	0	0	0	0	0	0	0	0
17:58304368:A:G	2	2	2	0	2	1.0	0.0	1.0
17:58304947:G:T	0	0	0	0	0	0	0	0
17:58306383:T:C	0	0	0	0	0	0	0	0
17:58308757:A:G	0	0	0	0	0	0	0	0
17:58308997:T:A	4	2	4	2	2	1.0	0.5	0.5
17:58316479:G:C	1	0	2	2	0	2	2	0
17:58327685:C:T	2	2	5	0	5	2.5	0.0	2.5
17:58415439:T:C	1	1	3	0	3	3	0	3
17:58507147:T:C	7	6	14	1	13	1	0	1
17:58508511:G:C	3	2	3	1	2	1	0	1
17:58521078:T:C	0	0	0	0	0	0	0	0
17:58559547:T:C	0	0	0	0	0	0	0	0
17:58581657:C:T	0	0	0	0	0	0	0	0
17:58613487:T:C	0	0	0	0	0	0	0	0
17:61408194:C:T	0	0	0	0	0	0	0	0
17:61590592:G:A	2	0	2	2	0	1.0	1.0	0.0
17:61590660:G:C	2	0	2	2	0	1.0	1.0	0.0
17:61590991:C:T	13	0	13	13	0	1	1	0
17:61683635:A:G	0	0	0	0	0	0	0	0
17:61685986:A:G	0	0	0	0	0	0	0	0
17:61686104:T:C	0	0	0	0	0	0	0	0
17:62137028:G:A	0	0	0	0	0	0	0	0
17:62688959:G:A	0	0	0	0	0	0	0	0
17:63482562:C:T	0	0	0	0	0	0	0	0
17:63484948:C:T	0	0	0	0	0	0	0	0
17:63485192:G:A	0	0	0	0	0	0	0	0
17:63485413:T:C	0	0	0	0	0	0	0	0
17:63486691:A:G	68	23	110	77	33	1.0	1.0	0.0
17:63486920:T:C	0	0	0	0	0	0	0	0
17:63488629:G:C	12	3	16	11	5	1.0	1.0	0.0
17:63488637:A:C	11	3	16	10	6	1	1	0
17:63488670:G:A	194	75	831	548	283	3.5	2.0	0.0
17:63496400:T:C	20	6	60	41	19	2.0	1.0	0.0
17:63497131:G:A	1	0	1	1	0	1	1	0
17:63534062:T:C	0	0	0	0	0	0	0	0
17:63545691:C:T	0	0	0	0	0	0	0	0
17:63699178:G:C	192	102	210	103	107	1.0	1.0	1.0
17:63704965:T:C	4	4	4	0	4	1.0	0.0	1.0
17:63823837:T:A	13	6	20	8	12	1	1	0
17:63826085:G:C	97	53	111	47	64	1	0	1
17:63829486:T:C	2	2	4	0	4	2.0	0.0	2.0
17:63830911:C:T	36	21	65	28	37	1.0	0.0	1.0
17:63830956:G:A	3	1	3	2	1	1	1	0
17:63910045:A:T	0	0	0	0	0	0	0	0
17:63930138:A:G	1248	752	1918	943	975	1.0	1.0	1.0
17:63951584:C:T	0	0	0	0	0	0	0	0
17:63972729:C:T	0	0	0	0	0	0	0	0
17:64485684:A:G	5	1	6	5	1	1	1	0
17:64491665:A:G	0	0	0	0	0	0	0	0
17:64491739:T:C	0	0	0	0	0	0	0	0
17:64505810:C:G	44	24	64	35	29	1.0	0.0	1.0
17:64505849:A:G	67	42	97	44	53	1	0	1
17:66029213:A:G	0	0	0	0	0	0	0	0
17:66214639:C:A	0	0	0	0	0	0	0	0
17:66688960:G:A	0	0	0	0	0	0	0	0
17:66788904:G:A	0	0	0	0	0	0	0	0
17:67031624:G:C	0	0	0	0	0	0	0	0
17:67108550:T:G	14	9	37	11	26	1.0	0.0	1.0
17:67109255:C:T	11	5	15	10	5	1	1	0
17:67735977:A:G	9	4	17	7	10	1	1	0
17:67743511:A:G	10	5	14	9	5	1.0	0.5	0.5
17:67784910:C:T	0	0	0	0	0	0	0	0
17:68250275:A:G	193	111	211	97	114	1	0	1
17:68452981:G:A	30	18	41	13	28	1.0	0.0	1.0
17:68877602:G:A	0	0	0	0	0	0	0	0
17:68891534:C:T	0	0	0	0	0	0	0	0
17:69035316:C:T	1	0	6	6	0	6	6	0
17:69085689:T:C	62	32	75	34	41	1.0	0.0	1.0
17:69112221:C:G	13	7	21	10	11	1	0	1
17:69113692:T:A	15	7	32	16	16	1	1	0
17:69149100:G:A	0	0	0	0	0	0	0	0
17:69153416:A:T	1	1	2	0	2	2	0	2
17:69153977:C:T	2	1	3	1	2	1.5	0.5	1.0
17:69215890:A:G	1	0	2	2	0	2	2	0
17:69216282:G:A	0	0	0	0	0	0	0	0
17:69264785:A:G	2	0	7	7	0	3.5	3.5	0.0
17:69271176:T:C	0	0	0	0	0	0	0	0
17:69294699:T:C	1	1	1	0	1	1	0	1
17:69308306:C:T	8	6	10	2	8	1.0	0.0	1.0
17:69516862:C:A	27	14	27	13	14	1	0	1
17:71621433:A:G	0	0	0	0	0	0	0	0
17:72124410:A:C	0	0	0	0	0	0	0	0
17:73196524:G:A	85	39	105	59	46	1	1	0
17:73196734:A:G	4	2	8	3	5	1.5	0.5	0.5
17:73200670:A:G	4	2	14	10	4	2.0	0.5	0.5
17:73201184:G:C	3	2	12	10	2	1	0	1
17:73201300:C:T	6	2	11	4	7	1.0	1.0	0.0
17:73201609:G:A	6	2	9	4	5	1.0	1.0	0.0
17:73207295:C:T	10	4	16	10	6	1.0	1.0	0.0
17:73236548:T:C	1	1	1	0	1	1	0	1
17:73236742:G:C	6	2	7	5	2	1.0	1.0	0.0
17:73242294:G:A	1	0	1	1	0	1	1	0
17:73242948:G:T	6	3	8	3	5	1.0	0.5	0.5
17:73248491:C:T	9	5	9	4	5	1	0	1
17:73338334:G:A	4	0	4	4	0	1.0	1.0	0.0
17:74237420:G:A	0	0	0	0	0	0	0	0
17:74244029:G:A	1	0	1	1	0	1	1	0
17:74249962:T:C	0	0	0	0	0	0	0	0
17:74250327:C:T	0	0	0	0	0	0	0	0
17:74252344:A:G	1	1	1	0	1	1	0	1
17:74299827:C:T	0	0	0	0	0	0	0	0
17:74305293:A:G	0	0	0	0	0	0	0	0
17:74307310:G:A	0	0	0	0	0	0	0	0
17:74309395:C:T	0	0	0	0	0	0	0	0
17:74352928:C:T	0	0	0	0	0	0	0	0
17:74354273:G:A	0	0	0	0	0	0	0	0
17:74355267:C:T	0	0	0	0	0	0	0	0
17:74372411:T:C	0	0	0	0	0	0	0	0
17:74544797:G:A	2	1	2	1	1	1.0	0.5	0.5
17:74549416:CT:TG	0	0	0	0	0	0	0	0
17:74592187:A:C	0	0	0	0	0	0	0	0
17:74612695:G:A	0	0	0	0	0	0	0	0
17:74613950:C:T	0	0	0	0	0	0	0	0
17:74619154:C:T	0	0	0	0	0	0	0	0
17:74864131:G:A	0	0	0	0	0	0	0	0
17:74866471:T:C	18	13	21	5	16	1.0	0.0	1.0
17:74866908:C:T	2	0	2	2	0	1.0	1.0	0.0
17:74868645:G:A	0	0	0	0	0	0	0	0
17:74941756:G:A	0	0	0	0	0	0	0	0
17:74947031:G:A	0	0	0	0	0	0	0	0
17:74953051:C:T	0	0	0	0	0	0	0	0
17:75226770:G:A	1	0	1	1	0	1	1	0
17:75234761:C:T	12	6	19	9	10	1.0	0.5	0.5
17:75261905:C:T	224	109	584	317	267	2.0	1.0	0.0
17:75273449:A:G	19	12	19	7	12	1	0	1
17:75492713:C:T	0	0	0	0	0	0	0	0
17:75493486:C:G	0	0	0	0	0	0	0	0
17:75493732:C:T	3	0	3	3	0	1	1	0
17:75503115:G:A	0	0	0	0	0	0	0	0
17:75516991:C:T	9	2	9	7	2	1	1	0
17:75517104:C:A	2	0	2	2	0	1.0	1.0	0.0
17:75523332:C:T	3	2	4	2	2	1	1	1
17:75556104:G:A	10	4	17	13	4	1.0	1.0	0.0
17:75591187:C:T	3	1	3	2	1	1	1	0
17:75594736:C:T	3	0	8	8	0	2	2	0
17:75594749:T:G	4	1	8	7	1	2.0	2.0	0.0
17:75601463:A:G	2	1	2	1	1	1.0	0.5	0.5
17:75706055:G:A	29	9	31	21	10	1	1	0
17:75754778:C:G	10	9	10	1	9	1.0	0.0	1.0
17:75757422:T:C	0	0	0	0	0	0	0	0
17:75757580:C:T	0	0	0	0	0	0	0	0
17:75778796:G:A	298	222	349	93	256	1.0	0.0	1.0
17:75831124:T:C	12	7	22	10	12	2.0	0.0	1.0
17:75840081:C:G	9	2	25	23	2	1	1	0
17:75841061:A:C	2	1	3	2	1	1.5	1.0	0.5
17:75892342:ATGGA:GTGGC	4	2	4	2	2	1.0	0.5	0.5
17:75900965:A:G	1	0	1	1	0	1	1	0
17:75904607:T:C	949	515	6608	3508	3100	6	2	1
17:75926860:T:C	1	1	7	0	7	7	0	7
17:75930040:C:A	1	1	1	0	1	1	0	1
17:75953459:G:C	5	2	7	3	4	1	1	0
17:76001393:G:A	2	1	2	1	1	1.0	0.5	0.5
17:76292329:C:T	0	0	0	0	0	0	0	0
17:76293347:T:A	0	0	0	0	0	0	0	0
17:76527709:C:T	37	21	46	20	26	1	0	1
17:76561349:C:T	613	338	2102	969	1133	3	1	1
17:76924990:G:C	0	0	0	0	0	0	0	0
17:76940494:G:A	0	0	0	0	0	0	0	0
17:77499315:T:C	165	88	344	176	168	1	0	1
17:78097785:T:C	2	1	3	2	1	1.5	1.0	0.5
17:78119220:G:A	1	1	1	0	1	1	0	1
17:78119272:T:C	1	1	1	0	1	1	0	1
17:78131665:T:C	71	41	112	44	68	1	0	1
17:78132305:G:C	20	10	36	18	18	1.0	0.5	0.5
17:78134494:A:T	32	16	50	21	29	1.0	0.5	0.5
17:78138156:G:A	46	25	68	26	42	1.0	0.0	1.0
17:78138569:G:T	2	1	2	1	1	1.0	0.5	0.5
17:78157867:C:T	0	0	0	0	0	0	0	0
17:78161190:G:A	0	0	0	0	0	0	0	0
17:78234648:T:C	0	0	0	0	0	0	0	0
17:78425383:CGGA:TGGG	2	0	8	8	0	4.0	4.0	0.0
17:78427016:G:A	1	0	1	1	0	1	1	0
17:78501838:C:A	0	0	0	0	0	0	0	0
17:78514956:T:C	0	0	0	0	0	0	0	0
17:78532708:A:G	0	0	0	0	0	0	0	0
17:78803778:T:C	9	3	12	9	3	1	1	0
17:78803816:A:G	11	5	14	9	5	1	1	0
17:78806262:C:T	6	1	13	7	6	1.0	1.0	0.0
17:79731283:C:T	2	2	2	0	2	1.0	0.0	1.0
17:79735540:C:G	0	0	0	0	0	0	0	0
17:79784685:G:A	0	0	0	0	0	0	0	0
17:80010342:C:T	0	0	0	0	0	0	0	0
17:80081959:T:G	0	0	0	0	0	0	0	0
17:80099763:A:G	0	0	0	0	0	0	0	0
17:80110970:G:A	0	0	0	0	0	0	0	0
17:80113310:A:G	2	1	2	1	1	1.0	0.5	0.5
17:80137481:T:C	12	7	12	5	7	1.0	0.0	1.0
17:80188371:G:A	0	0	0	0	0	0	0	0
17:80201684:T:C	1	1	1	0	1	1	0	1
17:80205094:C:T	0	0	0	0	0	0	0	0
17:80210594:C:T	0	0	0	0	0	0	0	0
17:80214155:A:G	0	0	0	0	0	0	0	0
17:80291868:T:C	0	0	0	0	0	0	0	0
17:80298430:C:G	10	6	14	6	8	1.0	0.0	1.0
17:80319389:A:T	0	0	0	0	0	0	0	0
17:80332071:G:A	15	2	36	34	2	1	1	0
17:80332302:G:C	6	5	6	1	5	1.0	0.0	1.0
17:80332480:A:G	10	5	10	5	5	1.0	0.5	0.5
17:80332508:C:G	8	3	8	5	3	1.0	1.0	0.0
17:80337708:G:A	8	3	19	13	6	1.0	1.0	0.0
17:80345336:G:A	5	3	5	2	3	1	0	1
17:80353558:G:A	12	5	13	7	6	1.0	1.0	0.0
17:80360040:T:C	6	3	11	6	5	1.5	0.5	0.5
17:80380861:C:T	13	6	31	20	11	2	1	0
17:80383800:A:G	15	7	16	9	7	1	1	0
17:80421934:G:A	10	1	11	9	2	1.0	1.0	0.0
17:80427788:G:T	0	0	0	0	0	0	0	0
17:80846529:C:T	0	0	0	0	0	0	0	0
17:80846574:G:A	0	0	0	0	0	0	0	0
17:80922729:C:T	1	0	1	1	0	1	1	0
17:80961397:C:T	0	0	0	0	0	0	0	0
17:80976662:C:T	1	0	1	1	0	1	1	0
17:80976736:A:G	1	0	1	1	0	1	1	0
17:81115734:C:T	0	0	0	0	0	0	0	0
17:81165673:C:G	0	0	0	0	0	0	0	0
17:81166705:C:G	0	0	0	0	0	0	0	0
17:81196776:C:T	3	1	5	4	1	1	1	0
17:81233436:G:A	12	3	14	11	3	1.0	1.0	0.0
17:81252464:T:C	16	6	17	10	7	1.0	1.0	0.0
17:81271002:T:C	8	3	8	5	3	1.0	1.0	0.0
17:81457511:C:T	0	0	0	0	0	0	0	0
17:81510981:G:A	332	176	397	199	198	1.0	1.0	1.0
17:81541374:T:C	11	2	34	25	9	1	1	0
17:81622216:G:A	24	12	40	20	20	1.0	0.5	0.5
17:81629785:C:T	32	14	50	28	22	1.0	1.0	0.0
17:81642384:G:T	2	2	2	0	2	1.0	0.0	1.0
17:81647921:C:T	0	0	0	0	0	0	0	0
17:81651029:C:T	15	5	16	11	5	1	1	0
17:81808949:C:A	0	0	0	0	0	0	0	0
17:81811590:T:C	0	0	0	0	0	0	0	0
17:81812864:C:T	0	0	0	0	0	0	0	0
17:81845225:A:G	20	12	25	12	13	1.0	0.0	1.0
17:81847258:G:A	23	12	36	14	22	1	0	1
17:81869287:C:T	3	2	3	1	2	1	0	1
17:82016855:T:C	6	2	6	4	2	1.0	1.0	0.0
17:82022880:C:A	5	4	6	2	4	1	0	1
17:82028280:C:T	1	0	4	4	0	4	4	0
17:82036150:G:A	2	2	3	0	3	1.5	0.0	1.5
17:82036724:C:T	557	409	733	235	498	1	0	1
17:82037444:A:G	198	147	516	120	396	2.0	0.0	1.0
17:82081234:G:A	5	3	5	2	3	1	0	1
17:82083590:G:A	1	0	1	1	0	1	1	0
17:82113574:G:A	0	0	0	0	0	0	0	0
17:82201690:T:C	9	4	11	5	6	1	1	0
17:82201789:G:A	12	8	14	4	10	1.0	0.0	1.0
17:82317377:T:C	0	0	0	0	0	0	0	0
17:82322989:G:A	1	1	1	0	1	1	0	1
17:82394427:G:A	4	2	5	2	3	1.0	0.5	0.5
17:82433808:A:G	15	10	18	5	13	1	0	1
17:82657767:G:A	0	0	0	0	0	0	0	0
17:82659676:G:A	0	0	0	0	0	0	0	0
17:82749052:G:A	0	0	0	0	0	0	0	0
17:82750725:C:G	0	0	0	0	0	0	0	0
17:82752221:G:T	28	14	28	14	14	1.0	0.5	0.5
17:82830589:T:C	0	0	0	0	0	0	0	0
17:82830616:A:G	0	0	0	0	0	0	0	0
17:82870327:C:T	8	4	10	4	6	1.0	0.5	0.5
17:82905981:T:C	9	3	9	6	3	1	1	0
17:83048753:C:T	16	8	27	15	12	1.0	0.5	0.5
17:83085102:C:T	2	0	2	2	0	1.0	1.0	0.0
18:580623:T:C	0	0	0	0	0	0	0	0
18:658147:C:A	0	0	0	0	0	0	0	0
18:691173:G:A	0	0	0	0	0	0	0	0
18:706558:C:T	60	60	71	1	70	1.0	0.0	1.0
18:712568:G:A	17	17	19	0	19	1	0	1
18:832354:T:C	0	0	0	0	0	0	0	0
18:832420:T:C	0	0	0	0	0	0	0	0
18:909560:A:G	0	0	0	0	0	0	0	0
18:2707621:G:A	22	11	31	14	17	1.0	0.5	0.5
18:2724932:A:T	22	12	37	15	22	1.0	0.0	1.0
18:2750479:A:G	25	13	28	15	13	1	0	1
18:2763699:C:T	26	13	42	16	26	1.0	0.5	0.5
18:2920290:G:A	2	2	5	0	5	2.5	0.0	2.5
18:3075748:G:A	0	0	0	0	0	0	0	0
18:3164387:C:T	1	1	2	0	2	2	0	2
18:3168818:G:A	0	0	0	0	0	0	0	0
18:3188978:A:G	0	0	0	0	0	0	0	0
18:3215158:CAC:GAG	1	0	1	1	0	1	1	0
18:3580744:A:G	0	0	0	0	0	0	0	0
18:5233106:C:G	0	0	0	0	0	0	0	0
18:5891638:C:A	0	0	0	0	0	0	0	0
18:6462643:C:G	210	2	227	225	2	1.0	1.0	0.0
18:6889974:A:G	0	0	0	0	0	0	0	0
18:6898416:C:T	0	0	0	0	0	0	0	0
18:6943265:G:A	0	0	0	0	0	0	0	0
18:6997819:A:C	0	0	0	0	0	0	0	0
18:6999629:T:C	0	0	0	0	0	0	0	0
18:7008592:T:C	0	0	0	0	0	0	0	0
18:7011414:G:A	0	0	0	0	0	0	0	0
18:7012124:A:G	0	0	0	0	0	0	0	0
18:7023372:A:G	0	0	0	0	0	0	0	0
18:7033038:G:A	0	0	0	0	0	0	0	0
18:8413806:G:A	0	0	0	0	0	0	0	0
18:8413905:G:A	0	0	0	0	0	0	0	0
18:9547949:T:C	3	0	4	4	0	1	1	0
18:9678299:T:C	0	0	0	0	0	0	0	0
18:9678969:T:C	0	0	0	0	0	0	0	0
18:9678980:C:T	0	0	0	0	0	0	0	0
18:10636793:G:A	0	0	0	0	0	0	0	0
18:10741013:G:A	0	0	0	0	0	0	0	0
18:10758025:G:A	0	0	0	0	0	0	0	0
18:10759842:C:A	0	0	0	0	0	0	0	0
18:10762964:G:A	0	0	0	0	0	0	0	0
18:10763009:T:C	0	0	0	0	0	0	0	0
18:11610333:G:T	0	0	0	0	0	0	0	0
18:11610350:G:A	0	0	0	0	0	0	0	0
18:11610383:C:A	0	0	0	0	0	0	0	0
18:11619522:GCC:ACA	0	0	0	0	0	0	0	0
18:11644724:T:C	0	0	0	0	0	0	0	0
18:12068079:G:T	1	0	1	1	0	1	1	0
18:12076366:C:A	0	0	0	0	0	0	0	0
18:12094032:G:T	0	0	0	0	0	0	0	0
18:12096250:G:T	0	0	0	0	0	0	0	0
18:12102157:G:C	0	0	0	0	0	0	0	0
18:12115510:G:A	0	0	0	0	0	0	0	0
18:12124153:C:G	0	0	0	0	0	0	0	0
18:12211484:G:A	0	0	0	0	0	0	0	0
18:12211648:G:T	4	0	4	4	0	1.0	1.0	0.0
18:12254786:G:C	0	0	0	0	0	0	0	0
18:12308794:G:C	245	203	383	75	308	1	0	1
18:12329537:C:G	14	7	14	7	7	1.0	0.5	0.5
18:12348286:T:C	12	3	21	18	3	1.0	1.0	0.0
18:12351343:C:T	9	6	20	4	16	1	0	1
18:14179504:T:C	39	19	74	40	34	1	1	0
18:14187347:A:G	1	1	2	0	2	2	0	2
18:14361639:C:T	0	0	0	0	0	0	0	0
18:14361826:C:T	0	0	0	0	0	0	0	0
18:14537950:A:G	0	0	0	0	0	0	0	0
18:14542891:G:C	0	0	0	0	0	0	0	0
18:14543058:T:G	0	0	0	0	0	0	0	0
18:14543099:C:T	0	0	0	0	0	0	0	0
18:14613455:T:G	0	0	0	0	0	0	0	0
18:14613528:T:C	0	0	0	0	0	0	0	0
18:14613816:A:G	0	0	0	0	0	0	0	0
18:14752958:G:A	0	0	0	0	0	0	0	0
18:14848821:C:T	0	0	0	0	0	0	0	0
18:14992530:G:A	0	0	0	0	0	0	0	0
18:22415768:T:C	0	0	0	0	0	0	0	0
18:22416048:G:A	0	0	0	0	0	0	0	0
18:23520276:C:T	14	5	26	17	9	1.0	1.0	0.0
18:23533321:T:C	1	0	1	1	0	1	1	0
18:23539792:A:G	0	0	0	0	0	0	0	0
18:23539813:G:A	2	1	2	1	1	1.0	0.5	0.5
18:23540480:T:C	0	0	0	0	0	0	0	0
18:23560468:T:C	0	0	0	0	0	0	0	0
18:23561451:G:A	1	0	1	1	0	1	1	0
18:23901226:T:C	0	0	0	0	0	0	0	0
18:24156541:T:C	0	0	0	0	0	0	0	0
18:26151933:A:G	0	0	0	0	0	0	0	0
18:26256055:T:C	0	0	0	0	0	0	0	0
18:26292271:A:G	0	0	0	0	0	0	0	0
18:26599892:G:A	0	0	0	0	0	0	0	0
18:26600299:G:A	0	0	0	0	0	0	0	0
18:26600333:T:C	0	0	0	0	0	0	0	0
18:26865728:C:T	0	0	0	0	0	0	0	0
18:27453318:T:A	0	0	0	0	0	0	0	0
18:28652224:T:G	0	0	0	0	0	0	0	0
18:28652352:A:G	0	0	0	0	0	0	0	0
18:28652966:G:A	0	0	0	0	0	0	0	0
18:31006998:A:G	0	0	0	0	0	0	0	0
18:31031022:C:T	0	0	0	0	0	0	0	0
18:31031095:A:T	0	0	0	0	0	0	0	0
18:31069009:C:T	0	0	0	0	0	0	0	0
18:31093602:T:C	0	0	0	0	0	0	0	0
18:31318238:A:G	0	0	0	0	0	0	0	0
18:31318331:A:G	0	0	0	0	0	0	0	0
18:31333636:C:T	0	0	0	0	0	0	0	0
18:31354718:A:T	0	0	0	0	0	0	0	0
18:31355412:C:T	0	0	0	0	0	0	0	0
18:31388408:G:A	0	0	0	0	0	0	0	0
18:31388996:C:T	0	0	0	0	0	0	0	0
18:31413538:C:A	0	0	0	0	0	0	0	0
18:31413626:C:T	0	0	0	0	0	0	0	0
18:31545891:A:G	0	0	0	0	0	0	0	0
18:31897807:G:A	3	2	3	1	2	1	0	1
18:32511977:A:C	0	0	0	0	0	0	0	0
18:35337680:T:C	16	8	16	8	8	1.0	0.5	0.5
18:35842254:A:T	0	0	0	0	0	0	0	0
18:35977503:A:G	22	10	25	15	10	1.0	1.0	0.0
18:36164739:T:C	2	0	2	2	0	1.0	1.0	0.0
18:36730705:C:T	0	0	0	0	0	0	0	0
18:36744128:G:A	0	0	0	0	0	0	0	0
18:36818951:C:T	203	72	223	149	74	1	1	0
18:39334889:C:T	0	0	0	0	0	0	0	0
18:39335330:G:A	5	5	5	0	5	1	0	1
18:39335564:T:C	38	0	40	40	0	1.0	1.0	0.0
18:39335618:C:T	4	0	6	6	0	1.0	1.0	0.0
18:42743532:G:T	0	0	0	0	0	0	0	0
18:45666191:G:A	6	1	13	10	3	2.0	1.5	0.0
18:45682394:G:A	1	1	2	0	2	2	0	2
18:45682536:C:T	0	0	0	0	0	0	0	0
18:45837787:C:G	0	0	0	0	0	0	0	0
18:45840212:G:A	0	0	0	0	0	0	0	0
18:45901110:G:A	2	1	3	1	2	1.5	0.5	1.0
18:45910637:G:A	0	0	0	0	0	0	0	0
18:45917745:A:G	1	0	1	1	0	1	1	0
18:46084306:A:G	92	0	109	109	0	1.0	1.0	0.0
18:46084341:G:C	107	0	136	136	0	1	1	0
18:46555180:T:C	0	0	0	0	0	0	0	0
18:46560300:T:G	0	0	0	0	0	0	0	0
18:48039905:G:A	0	0	0	0	0	0	0	0
18:48817295:C:T	1	0	1	1	0	1	1	0
18:49562285:T:G	0	0	0	0	0	0	0	0
18:49567494:C:T	0	0	0	0	0	0	0	0
18:50250874:C:T	1	0	1	1	0	1	1	0
18:50273809:G:C	19	7	27	13	14	1	1	0
18:50276028:C:T	1	1	1	0	1	1	0	1
18:50283501:G:T	1	1	1	0	1	1	0	1
18:50283981:A:G	27	6	28	22	6	1	1	0
18:50801445:G:A	0	0	0	0	0	0	0	0
18:50806833:C:G	0	0	0	0	0	0	0	0
18:50984326:T:C	5	0	5	5	0	1	1	0
18:51051412:G:C	6	3	10	7	3	1.5	1.0	0.5
18:52752316:G:A	0	0	0	0	0	0	0	0
18:52906232:C:G	0	0	0	0	0	0	0	0
18:53410624:T:C	0	0	0	0	0	0	0	0
18:53416283:C:T	0	0	0	0	0	0	0	0
18:58149559:G:A	0	0	0	0	0	0	0	0
18:58981524:C:T	60	19	96	66	30	1.0	1.0	0.0
18:59273075:G:T	0	0	0	0	0	0	0	0
18:59900467:G:A	85	61	203	52	151	1	0	1
18:62415843:G:C	0	0	0	0	0	0	0	0
18:62442484:C:T	0	0	0	0	0	0	0	0
18:62560600:T:C	8	7	19	6	13	1.0	0.0	1.0
18:63489373:G:C	0	0	0	0	0	0	0	0
18:63493054:T:C	0	0	0	0	0	0	0	0
18:63497369:T:C	0	0	0	0	0	0	0	0
18:63503488:T:C	0	0	0	0	0	0	0	0
18:63597064:G:A	0	0	0	0	0	0	0	0
18:63597234:C:T	0	0	0	0	0	0	0	0
18:63720043:C:T	0	0	0	0	0	0	0	0
18:63723082:C:A	0	0	0	0	0	0	0	0
18:63723098:C:T	0	0	0	0	0	0	0	0
18:63723127:T:C	0	0	0	0	0	0	0	0
18:63918026:T:C	0	0	0	0	0	0	0	0
18:66509149:C:T	0	0	0	0	0	0	0	0
18:74073508:A:G	40	39	44	2	42	1.0	0.0	1.0
18:74510926:T:C	37	7	64	45	19	1	1	0
18:74567400:C:T	0	0	0	0	0	0	0	0
18:74632597:G:A	1	1	2	0	2	2	0	2
18:75064165:G:A	2	1	2	1	1	1.0	0.5	0.5
18:76899171:A:G	4	2	7	5	2	1.0	0.5	0.5
18:76980380:A:G	3	1	5	4	1	2	2	0
18:80133156:T:A	2	0	5	5	0	2.5	2.5	0.0
18:80137309:G:A	7	2	7	5	2	1	1	0
19:501743:T:C	1	1	1	0	1	1	0	1
19:579010:G:A	0	0	0	0	0	0	0	0
19:579035:C:T	0	0	0	0	0	0	0	0
19:580665:T:C	351	164	397	210	187	1	1	0
19:617614:G:A	19	10	19	9	10	1	0	1
19:641215:T:C	0	0	0	0	0	0	0	0
19:687078:G:A	0	0	0	0	0	0	0	0
19:746712:C:T	0	0	0	0	0	0	0	0
19:757399:A:C	0	0	0	0	0	0	0	0
19:757606:T:C	0	0	0	0	0	0	0	0
19:830854:T:C	0	0	0	0	0	0	0	0
19:1005231:C:T	0	0	0	0	0	0	0	0
19:1011216:G:A	15	9	16	6	10	1	0	1
19:1012121:G:A	11	6	11	5	6	1	0	1
19:1014399:A:G	88	51	91	39	52	1.0	0.0	1.0
19:1036553:T:C	70	30	94	61	33	1.0	1.0	0.0
19:1095337:C:T	46	16	49	31	18	1.0	1.0	0.0
19:1104079:G:A	138	72	153	71	82	1.0	0.0	1.0
19:1371355:T:C	0	0	0	0	0	0	0	0
19:1397444:G:A	2	1	2	1	1	1.0	0.5	0.5
19:1440069:G:C	3270	26	61404	61378	26	16.0	16.0	0.0
19:1482081:C:A	1	0	1	1	0	1	1	0
19:1497544:A:G	0	0	0	0	0	0	0	0
19:1526932:A:C	0	0	0	0	0	0	0	0
19:1533973:C:G	0	0	0	0	0	0	0	0
19:1784891:A:G	0	0	0	0	0	0	0	0
19:1784945:A:G	0	0	0	0	0	0	0	0
19:1806084:A:C	0	0	0	0	0	0	0	0
19:2046404:G:A	64	40	82	25	57	1.0	0.0	1.0
19:2099251:G:A	0	0	0	0	0	0	0	0
19:2138655:T:G	56	27	63	32	31	1.0	1.0	0.0
19:2339881:G:A	9	3	26	10	16	2	1	0
19:2339950:T:C	9	5	25	7	18	1	0	1
19:2341049:C:T	3	1	3	2	1	1	1	0
19:2353152:C:A	29	18	32	13	19	1	0	1
19:2396558:C:T	0	0	0	0	0	0	0	0
19:2396613:C:T	0	0	0	0	0	0	0	0
19:2398851:A:G	0	0	0	0	0	0	0	0
19:2410334:T:C	0	0	0	0	0	0	0	0
19:2878137:T:C	0	0	0	0	0	0	0	0
19:2917289:C:A	1	0	2	2	0	2	2	0
19:2989699:T:C	0	0	0	0	0	0	0	0
19:2994923:G:A	0	0	0	0	0	0	0	0
19:3005476:C:T	0	0	0	0	0	0	0	0
19:3155904:G:A	0	0	0	0	0	0	0	0
19:3543382:C:G	4	4	9	0	9	1.0	0.0	1.0
19:3595796:A:G	4	2	14	7	7	3.5	1.5	1.0
19:3595925:G:A	1	1	1	0	1	1	0	1
19:3637397:T:C	0	0	0	0	0	0	0	0
19:3653527:C:T	0	0	0	0	0	0	0	0
19:3728611:G:A	0	0	0	0	0	0	0	0
19:3731987:G:A	0	0	0	0	0	0	0	0
19:3771588:G:A	0	0	0	0	0	0	0	0
19:4174953:A:G	2	0	2	2	0	1.0	1.0	0.0
19:4186398:T:G	3	1	5	4	1	2	2	0
19:4306314:T:C	0	0	0	0	0	0	0	0
19:4333714:C:T	5	0	5	5	0	1	1	0
19:4442339:C:T	10	8	18	3	15	1.5	0.0	1.0
19:4511734:A:T	0	0	0	0	0	0	0	0
19:4685264:A:C	0	0	0	0	0	0	0	0
19:4816707:G:A	8	3	12	9	3	1.0	1.0	0.0
19:4852125:C:T	9	3	12	6	6	1	1	0
19:4902742:G:A	1	1	2	0	2	2	0	2
19:4910912:C:T	2	1	8	6	2	4.0	3.0	1.0
19:4945902:ACAC:CCAT	0	0	0	0	0	0	0	0
19:5210771:G:A	0	0	0	0	0	0	0	0
19:5273560:T:G	0	0	0	0	0	0	0	0
19:5277962:T:C	1	0	1	1	0	1	1	0
19:5455600:C:T	0	0	0	0	0	0	0	0
19:5455785:A:G	0	0	0	0	0	0	0	0
19:5455965:CGT:TGC	0	0	0	0	0	0	0	0
19:5456439:T:C	0	0	0	0	0	0	0	0
19:5696135:G:A	8	4	9	4	5	1.0	0.5	0.5
19:5772939:G:A	0	0	0	0	0	0	0	0
19:5832578:A:C	0	0	0	0	0	0	0	0
19:6312279:T:C	0	0	0	0	0	0	0	0
19:6411819:C:G	0	0	0	0	0	0	0	0
19:6586257:G:A	28	19	34	10	24	1.0	0.0	1.0
19:6669923:G:A	7	5	7	2	5	1	0	1
19:6677978:G:A	0	0	0	0	0	0	0	0
19:6709693:C:T	0	0	0	0	0	0	0	0
19:6713280:C:T	0	0	0	0	0	0	0	0
19:6731071:G:A	15	8	20	9	11	1	1	1
19:6737470:T:C	203	112	232	110	122	1	0	1
19:6737498:G:A	117	58	131	67	64	1	1	0
19:6896472:G:A	0	0	0	0	0	0	0	0
19:7166365:C:T	0	0	0	0	0	0	0	0
19:7440096:C:T	0	0	0	0	0	0	0	0
19:7459960:C:T	15	9	33	16	17	2	0	1
19:7459969:C:T	17	11	37	16	21	2	0	1
19:7504396:A:G	0	0	0	0	0	0	0	0
19:7508212:T:A	0	0	0	0	0	0	0	0
19:7528703:C:T	3	2	7	1	6	1	0	1
19:7542022:G:C	2	0	5	5	0	2.5	2.5	0.0
19:7542555:C:T	1	0	2	2	0	2	2	0
19:7555663:A:G	16	10	30	12	18	1.0	0.0	1.0
19:7557340:G:A	4	3	4	1	3	1.0	0.0	1.0
19:7559055:G:A	19	6	27	20	7	1	1	0
19:7629507:G:A	22	7	23	16	7	1.0	1.0	0.0
19:7633434:C:T	0	0	0	0	0	0	0	0
19:7646335:T:C	46	30	51	17	34	1.0	0.0	1.0
19:7647307:G:A	5	3	5	2	3	1	0	1
19:7678513:C:T	0	0	0	0	0	0	0	0
19:7682407:T:G	2224	1522	25192	12216	12976	9.0	4.0	4.0
19:7690170:G:A	50	23	76	39	37	1.0	1.0	0.0
19:7741065:A:T	0	0	0	0	0	0	0	0
19:7871322:A:G	0	0	0	0	0	0	0	0
19:7879964:A:C	0	0	0	0	0	0	0	0
19:7921753:C:G	206	101	278	148	130	1.0	1.0	0.0
19:7935219:A:G	0	0	0	0	0	0	0	0
19:8057853:G:A	0	0	0	0	0	0	0	0
19:8057883:T:C	0	0	0	0	0	0	0	0
19:8073170:C:A	0	0	0	0	0	0	0	0
19:8081037:C:T	0	0	0	0	0	0	0	0
19:8112035:C:T	0	0	0	0	0	0	0	0
19:8112061:T:C	0	0	0	0	0	0	0	0
19:8126300:C:T	0	0	0	0	0	0	0	0
19:8126517:G:A	0	0	0	0	0	0	0	0
19:8131624:G:C	0	0	0	0	0	0	0	0
19:8371280:C:T	0	0	0	0	0	0	0	0
19:8438461:G:C	2	1	3	1	2	1.5	0.5	1.0
19:8499590:G:T	1	0	1	1	0	1	1	0
19:8499639:T:G	2	0	2	2	0	1.0	1.0	0.0
19:8577276:T:C	5	3	5	2	3	1	0	1
19:8604988:C:T	0	0	0	0	0	0	0	0
19:8605046:C:G	0	0	0	0	0	0	0	0
19:8900736:C:T	0	0	0	0	0	0	0	0
19:8909478:A:G	0	0	0	0	0	0	0	0
19:8916887:C:T	0	0	0	0	0	0	0	0
19:8917630:C:G	0	0	0	0	0	0	0	0
19:8966905:G:T	0	0	0	0	0	0	0	0
19:9093631:A:G	0	0	0	0	0	0	0	0
19:9140544:C:T	31	16	55	28	27	1	1	1
19:9140582:T:C	50	26	108	58	50	1.0	1.0	1.0
19:9185988:T:C	0	0	0	0	0	0	0	0
19:9191318:G:T	0	0	0	0	0	0	0	0
19:9191468:G:A	0	0	0	0	0	0	0	0
19:9214440:G:A	0	0	0	0	0	0	0	0
19:9214576:G:A	0	0	0	0	0	0	0	0
19:9235751:T:C	0	0	0	0	0	0	0	0
19:9235923:C:G	0	0	0	0	0	0	0	0
19:9324254:T:C	1	0	1	1	0	1	1	0
19:9380138:C:T	2	1	7	4	3	3.5	2.0	1.5
19:9380930:G:C	1	0	6	6	0	6	6	0
19:9381465:C:T	1	1	1	0	1	1	0	1
19:9381694:A:T	4	1	11	8	3	2.0	1.0	0.0
19:9413509:A:G	20	16	25	7	18	1.0	0.0	1.0
19:9610725:A:T	3	1	3	2	1	1	1	0
19:9610878:G:C	2	2	2	0	2	1.0	0.0	1.0
19:9693748:T:G	0	0	0	0	0	0	0	0
19:9757602:T:C	1	0	1	1	0	1	1	0
19:9757728:C:T	0	0	0	0	0	0	0	0
19:9857463:G:A	0	0	0	0	0	0	0	0
19:9857758:C:T	0	0	0	0	0	0	0	0
19:9967913:T:C	0	0	0	0	0	0	0	0
19:10004083:C:T	0	0	0	0	0	0	0	0
19:10055256:A:G	0	0	0	0	0	0	0	0
19:10058569:A:G	0	0	0	0	0	0	0	0
19:10058585:C:T	0	0	0	0	0	0	0	0
19:10058602:T:G	0	0	0	0	0	0	0	0
19:10107656:A:G	5	3	8	5	3	1	0	1
19:10114659:G:A	3	1	6	4	2	2	1	0
19:10115101:A:G	45	26	51	22	29	1	0	1
19:10115148:G:A	6	1	12	11	1	1.5	1.5	0.0
19:10156401:T:C	0	0	0	0	0	0	0	0
19:10160358:C:G	0	0	0	0	0	0	0	0
19:10162696:T:C	6	4	7	2	5	1.0	0.0	1.0
19:10308454:C:T	4	1	13	11	2	3.0	2.5	0.0
19:10315746:A:C	238	134	1025	496	529	4.0	1.0	1.0
19:10315952:T:C	30	19	36	13	23	1.0	0.0	1.0
19:10339609:G:A	128	63	133	69	64	1.0	1.0	0.0
19:10361776:G:A	9	5	9	4	5	1	0	1
19:10416969:C:G	0	0	0	0	0	0	0	0
19:10467167:C:A	0	0	0	0	0	0	0	0
19:10514391:A:C	0	0	0	0	0	0	0	0
19:10557707:T:C	7	4	7	3	4	1	0	1
19:10557776:A:G	7	3	8	5	3	1	1	0
19:10559508:C:G	17	11	17	6	11	1	0	1
19:10561817:C:T	67	30	96	57	39	1	1	0
19:11113505:C:T	0	0	0	0	0	0	0	0
19:11113589:A:G	0	0	0	0	0	0	0	0
19:11116926:C:T	0	0	0	0	0	0	0	0
19:11120205:T:C	0	0	0	0	0	0	0	0
19:11123265:A:G	0	0	0	0	0	0	0	0
19:11166556:G:A	0	0	0	0	0	0	0	0
19:11215443:A:G	1	0	6	6	0	6	6	0
19:11215449:C:T	1	0	6	6	0	6	6	0
19:11215909:G:A	3	2	23	12	11	6	0	5
19:11221894:T:A	1	0	1	1	0	1	1	0
19:11239664:C:G	0	0	0	0	0	0	0	0
19:11248123:G:A	4	4	15	0	15	2.5	0.0	2.5
19:11252470:A:T	0	0	0	0	0	0	0	0
19:11354640:G:C	5	4	5	1	4	1	0	1
19:11416585:G:A	0	0	0	0	0	0	0	0
19:11458582:G:A	0	0	0	0	0	0	0	0
19:11780188:G:A	0	0	0	0	0	0	0	0
19:12187032:C:T	7	4	12	8	4	1	0	1
19:12284664:T:C	1	0	3	3	0	3	3	0
19:12294737:T:C	130	69	242	123	119	1.0	0.0	1.0
19:12380684:C:T	0	0	0	0	0	0	0	0
19:12380825:A:G	0	0	0	0	0	0	0	0
19:12380840:C:T	0	0	0	0	0	0	0	0
19:12380965:T:C	0	0	0	0	0	0	0	0
19:12381135:T:C	0	0	0	0	0	0	0	0
19:12381141:A:C	0	0	0	0	0	0	0	0
19:12679514:G:A	29	13	34	17	17	1	1	0
19:12924192:G:A	9	3	9	6	3	1	1	0
19:13877602:A:G	0	0	0	0	0	0	0	0
19:13889357:T:C	0	0	0	0	0	0	0	0
19:13890057:C:T	0	0	0	0	0	0	0	0
19:13904898:C:A	0	0	0	0	0	0	0	0
19:13919876:T:C	15	7	24	17	7	1	1	0
19:13954529:T:C	142	71	202	96	106	1.0	1.0	0.5
19:13972949:T:C	1	0	1	1	0	1	1	0
19:14398152:T:C	4	2	11	5	6	2.5	0.5	0.5
19:14610207:C:T	17	10	32	17	15	1	0	1
19:14706736:T:A	2	1	2	1	1	1.0	0.5	0.5
19:14736201:G:C	1	1	1	0	1	1	0	1
19:14792272:T:C	0	0	0	0	0	0	0	0
19:14799398:C:G	0	0	0	0	0	0	0	0
19:14799509:A:G	0	0	0	0	0	0	0	0
19:14827804:T:C	0	0	0	0	0	0	0	0
19:14841086:G:T	0	0	0	0	0	0	0	0
19:14864556:A:G	0	0	0	0	0	0	0	0
19:14880627:T:G	0	0	0	0	0	0	0	0
19:14880647:C:T	0	0	0	0	0	0	0	0
19:14903907:A:G	0	0	0	0	0	0	0	0
19:14917284:T:C	0	0	0	0	0	0	0	0
19:14927942:G:T	0	0	0	0	0	0	0	0
19:15020518:G:A	0	0	0	0	0	0	0	0
19:15022950:G:C	0	0	0	0	0	0	0	0
19:15022975:C:A	0	0	0	0	0	0	0	0
19:15022987:G:A	0	0	0	0	0	0	0	0
19:15122770:C:A	6	2	8	6	2	1.0	1.0	0.0
19:15122820:G:A	0	0	0	0	0	0	0	0
19:15458567:G:C	12	6	17	10	7	1.0	0.5	0.5
19:15475861:A:T	0	0	0	0	0	0	0	0
19:15476374:C:T	0	0	0	0	0	0	0	0
19:15476534:T:C	0	0	0	0	0	0	0	0
19:15615676:G:T	0	0	0	0	0	0	0	0
19:15615762:G:A	0	0	0	0	0	0	0	0
19:15628505:T:C	0	0	0	0	0	0	0	0
19:15647117:T:C	0	0	0	0	0	0	0	0
19:15652881:G:A	0	0	0	0	0	0	0	0
19:15673251:C:A	0	0	0	0	0	0	0	0
19:15673576:C:T	0	0	0	0	0	0	0	0
19:15678288:A:G	0	0	0	0	0	0	0	0
19:15678330:G:A	0	0	0	0	0	0	0	0
19:15678440:A:G	0	0	0	0	0	0	0	0
19:15728157:G:A	0	0	0	0	0	0	0	0
19:15728649:G:A	0	0	0	0	0	0	0	0
19:15741413:A:C	0	0	0	0	0	0	0	0
19:15742270:G:A	0	0	0	0	0	0	0	0
19:15771099:A:G	0	0	0	0	0	0	0	0
19:15771143:A:G	0	0	0	0	0	0	0	0
19:15794829:C:T	0	0	0	0	0	0	0	0
19:15807992:C:G	0	0	0	0	0	0	0	0
19:15886010:G:A	0	0	0	0	0	0	0	0
19:15902528:T:C	0	0	0	0	0	0	0	0
19:15903183:T:C	0	0	0	0	0	0	0	0
19:15911334:A:G	0	0	0	0	0	0	0	0
19:15913728:A:G	0	0	0	0	0	0	0	0
19:15913852:G:C	0	0	0	0	0	0	0	0
19:15914366:C:T	0	0	0	0	0	0	0	0
19:15923904:A:G	0	0	0	0	0	0	0	0
19:15927524:G:A	0	0	0	0	0	0	0	0
19:15929482:A:G	0	0	0	0	0	0	0	0
19:15934331:T:C	0	0	0	0	0	0	0	0
19:16035590:A:G	0	0	0	0	0	0	0	0
19:16480653:G:A	0	0	0	0	0	0	0	0
19:16482762:G:A	0	0	0	0	0	0	0	0
19:16490383:C:T	0	0	0	0	0	0	0	0
19:16501167:T:C	3	3	3	0	3	1	0	1
19:16501200:T:C	3	3	8	0	8	1	0	1
19:16555290:G:C	3	1	3	2	1	1	1	0
19:16731241:G:T	0	0	0	0	0	0	0	0
19:16744454:A:G	0	0	0	0	0	0	0	0
19:16893238:T:C	0	0	0	0	0	0	0	0
19:16895976:G:A	0	0	0	0	0	0	0	0
19:17060075:C:T	74	30	96	56	40	1.0	1.0	0.0
19:17235632:A:T	3	2	3	1	2	1	0	1
19:17258271:C:T	0	0	0	0	0	0	0	0
19:17455825:T:A	0	0	0	0	0	0	0	0
19:17549491:G:A	59	27	89	51	38	1	1	0
19:17606087:G:T	0	0	0	0	0	0	0	0
19:17630238:A:G	0	0	0	0	0	0	0	0
19:17774461:A:G	10	7	14	4	10	1.0	0.0	1.0
19:17776215:T:C	2	0	4	4	0	2.0	2.0	0.0
19:17781782:A:G	11	6	12	6	6	1	0	1
19:17821329:T:C	1	0	1	1	0	1	1	0
19:17830033:G:A	0	0	0	0	0	0	0	0
19:17888430:C:T	0	0	0	0	0	0	0	0
19:18010645:G:C	13	7	19	7	12	1	0	1
19:18059574:G:A	5	3	14	9	5	2	0	1
19:18175134:G:A	2470	1937	43403	19425	23978	12.0	5.0	7.0
19:18193890:A:G	88	42	90	47	43	1.0	1.0	0.0
19:18195014:C:T	9	4	16	11	5	1	1	0
19:18196180:G:C	17	5	17	12	5	1	1	0
19:18196298:C:T	3	3	3	0	3	1	0	1
19:18392051:C:T	10	9	39	4	35	4.0	0.0	3.0
19:18427932:A:C	15	11	18	4	14	1	0	1
19:18434976:G:T	3	1	3	2	1	1	1	0
19:18435868:T:C	6	4	12	2	10	1.0	0.0	1.0
19:18668303:C:T	0	0	0	0	0	0	0	0
19:19025732:C:T	11	4	43	29	14	2	1	0
19:19120059:A:G	2	1	2	1	1	1.0	0.5	0.5
19:19626877:C:T	4	3	4	1	3	1.0	0.0	1.0
19:20006154:C:T	1	0	1	1	0	1	1	0
19:20023037:C:T	17	7	35	26	9	1	1	0
19:20691845:T:C	0	0	0	0	0	0	0	0
19:20691932:C:G	0	0	0	0	0	0	0	0
19:20937347:A:G	0	0	0	0	0	0	0	0
19:21536917:T:A	6	4	6	2	4	1.0	0.0	1.0
19:21569186:C:T	0	0	0	0	0	0	0	0
19:21569221:C:G	1	0	1	1	0	1	1	0
19:21655763:T:C	0	0	0	0	0	0	0	0
19:21970693:A:T	0	0	0	0	0	0	0	0
19:21970999:G:C	0	0	0	0	0	0	0	0
19:21971930:T:C	1	1	3	0	3	3	0	3
19:21972152:C:T	1	1	1	0	1	1	0	1
19:21972718:A:G	2	2	4	0	4	2.0	0.0	2.0
19:21973006:C:G	1	0	1	1	0	1	1	0
19:21974141:G:A	1	1	1	0	1	1	0	1
19:21974500:G:A	0	0	0	0	0	0	0	0
19:21974687:C:A	2	2	2	0	2	1.0	0.0	1.0
19:22180691:G:A	0	0	0	0	0	0	0	0
19:22976595:C:T	0	0	0	0	0	0	0	0
19:23222655:T:G	1	0	2	2	0	2	2	0
19:23222778:T:C	4	2	6	4	2	1.0	0.5	0.5
19:23359895:G:C	25	10	32	21	11	1	1	0
19:23360088:T:C	16	5	20	15	5	1.0	1.0	0.0
19:23384895:T:C	0	0	0	0	0	0	0	0
19:23653520:C:T	5	2	8	6	2	1	1	0
19:23933175:C:T	0	0	0	0	0	0	0	0
19:23933472:C:G	0	0	0	0	0	0	0	0
19:29701026:A:G	1	1	1	0	1	1	0	1
19:29701568:G:A	7	5	7	2	5	1	0	1
19:29701598:G:C	7	5	7	2	5	1	0	1
19:29702275:G:C	11	4	25	21	4	1	1	0
19:30444797:C:A	0	0	0	0	0	0	0	0
19:30548088:T:C	0	0	0	0	0	0	0	0
19:30548349:C:T	0	0	0	0	0	0	0	0
19:30548762:C:T	0	0	0	0	0	0	0	0
19:32382792:A:G	3	3	3	0	3	1	0	1
19:32439163:G:A	0	0	0	0	0	0	0	0
19:32791018:A:G	0	0	0	0	0	0	0	0
19:32802701:C:T	0	0	0	0	0	0	0	0
19:32818124:A:T	0	0	0	0	0	0	0	0
19:32862135:G:A	0	0	0	0	0	0	0	0
19:32862155:G:T	0	0	0	0	0	0	0	0
19:32862558:G:A	0	0	0	0	0	0	0	0
19:32864149:A:G	0	0	0	0	0	0	0	0
19:32864163:A:G	0	0	0	0	0	0	0	0
19:32868629:T:C	0	0	0	0	0	0	0	0
19:32879255:A:C	3	2	3	1	2	1	0	1
19:32899890:G:A	0	0	0	0	0	0	0	0
19:33126602:G:A	10	5	12	7	5	1.0	0.5	0.5
19:33126677:C:T	10	4	19	12	7	1.0	1.0	0.0
19:33144855:C:T	0	0	0	0	0	0	0	0
19:33164238:C:T	0	0	0	0	0	0	0	0
19:33361109:G:A	0	0	0	0	0	0	0	0
19:33589322:C:G	0	0	0	0	0	0	0	0
19:34092795:C:T	0	0	0	0	0	0	0	0
19:34092811:T:G	0	0	0	0	0	0	0	0
19:34092824:A:G	0	0	0	0	0	0	0	0
19:34825463:C:G	0	0	0	0	0	0	0	0
19:34825540:C:T	0	0	0	0	0	0	0	0
19:34929937:A:G	0	0	0	0	0	0	0	0
19:34931904:C:T	2	2	5	0	5	2.5	0.0	2.5
19:34943334:A:G	2	2	2	0	2	1.0	0.0	1.0
19:34943608:T:C	1	1	1	0	1	1	0	1
19:34943744:T:C	0	0	0	0	0	0	0	0
19:34944102:G:A	0	0	0	0	0	0	0	0
19:34959325:C:T	0	0	0	0	0	0	0	0
19:35015825:G:A	13	3	22	19	3	1	1	0
19:35086966:G:A	0	0	0	0	0	0	0	0
19:35099276:T:A	0	0	0	0	0	0	0	0
19:35106558:A:G	0	0	0	0	0	0	0	0
19:35106716:C:T	0	0	0	0	0	0	0	0
19:35121255:C:G	0	0	0	0	0	0	0	0
19:35121264:T:A	0	0	0	0	0	0	0	0
19:35126366:T:C	0	0	0	0	0	0	0	0
19:35126735:C:G	0	0	0	0	0	0	0	0
19:35157462:T:G	2901	2313	10226	4987	5239	3	1	1
19:35169643:T:C	174	76	205	112	93	1.0	1.0	0.0
19:35228035:C:T	0	0	0	0	0	0	0	0
19:35228117:C:T	0	0	0	0	0	0	0	0
19:35278658:T:G	3	2	3	1	2	1	0	1
19:35279161:C:T	2	2	2	0	2	1.0	0.0	1.0
19:35302686:C:T	0	0	0	0	0	0	0	0
19:35383542:A:G	0	0	0	0	0	0	0	0
19:35450346:T:A	0	0	0	0	0	0	0	0
19:35507460:T:G	47	46	109	2	107	2	0	1
19:35513204:A:G	0	0	0	0	0	0	0	0
19:35513269:C:A	0	0	0	0	0	0	0	0
19:35527026:G:C	0	0	0	0	0	0	0	0
19:35527370:C:T	0	0	0	0	0	0	0	0
19:35542558:C:T	0	0	0	0	0	0	0	0
19:35651285:C:T	1868	1111	3206	1727	1479	1.0	1.0	1.0
19:35733804:A:G	17	7	24	14	10	1	1	0
19:35742569:G:A	9	1	17	16	1	1	1	0
19:35812019:T:C	0	0	0	0	0	0	0	0
19:35831368:C:T	0	0	0	0	0	0	0	0
19:35848345:C:T	0	0	0	0	0	0	0	0
19:35851310:C:T	0	0	0	0	0	0	0	0
19:36104534:A:C	0	0	0	0	0	0	0	0
19:36421958:G:A	0	0	0	0	0	0	0	0
19:36449858:G:T	24	11	30	19	11	1.0	1.0	0.0
19:36750239:A:G	2	1	5	4	1	2.5	2.0	0.5
19:36949903:C:T	1	1	1	0	1	1	0	1
19:36950209:C:T	2	1	2	1	1	1.0	0.5	0.5
19:36950463:T:C	1	0	1	1	0	1	1	0
19:36950560:T:C	1	1	1	0	1	1	0	1
19:36991249:A:G	4	0	7	7	0	1.0	1.0	0.0
19:36996730:G:A	2	2	2	0	2	1.0	0.0	1.0
19:36996964:A:T	0	0	0	0	0	0	0	0
19:36996971:C:A	0	0	0	0	0	0	0	0
19:36997073:G:A	0	0	0	0	0	0	0	0
19:36997295:G:A	1	0	1	1	0	1	1	0
19:36997397:A:G	2	1	2	1	1	1.0	0.5	0.5
19:36997570:C:G	0	0	0	0	0	0	0	0
19:36997579:G:C	0	0	0	0	0	0	0	0
19:36997597:T:C	0	0	0	0	0	0	0	0
19:37185626:G:A	2	1	2	1	1	1.0	0.5	0.5
19:37186846:T:A	3	3	3	0	3	1	0	1
19:37556044:C:A	3	1	5	4	1	1	1	0
19:37697332:T:G	1	0	1	1	0	1	1	0
19:37791900:G:C	11	0	11	11	0	1	1	0
19:37792087:T:C	6	0	6	6	0	1.0	1.0	0.0
19:37885463:A:G	0	0	0	0	0	0	0	0
19:37888806:C:T	0	0	0	0	0	0	0	0
19:37891688:C:T	0	0	0	0	0	0	0	0
19:38307448:C:T	6	3	17	10	7	1.0	0.5	0.5
19:38315691:G:C	0	0	0	0	0	0	0	0
19:38370693:G:A	0	0	0	0	0	0	0	0
19:38444640:A:G	0	0	0	0	0	0	0	0
19:38455542:G:A	0	0	0	0	0	0	0	0
19:38459264:C:T	0	0	0	0	0	0	0	0
19:38466163:G:A	0	0	0	0	0	0	0	0
19:38466199:C:T	0	0	0	0	0	0	0	0
19:38469040:C:T	0	0	0	0	0	0	0	0
19:38502916:C:T	0	0	0	0	0	0	0	0
19:38504270:G:A	0	0	0	0	0	0	0	0
19:38504798:T:C	0	0	0	0	0	0	0	0
19:38504870:T:C	0	0	0	0	0	0	0	0
19:38505335:G:A	0	0	0	0	0	0	0	0
19:38506350:T:C	0	0	0	0	0	0	0	0
19:38512085:A:G	0	0	0	0	0	0	0	0
19:38528513:A:G	0	0	0	0	0	0	0	0
19:38534726:C:G	0	0	0	0	0	0	0	0
19:38535885:G:C	0	0	0	0	0	0	0	0
19:38543411:T:A	0	0	0	0	0	0	0	0
19:38578001:A:C	0	0	0	0	0	0	0	0
19:38595964:T:C	42	22	55	27	28	1.0	0.5	1.0
19:38609954:G:A	47	25	78	34	44	1	0	1
19:38701093:C:T	58	31	125	58	67	1.0	0.0	1.0
19:38706105:C:T	20	9	27	14	13	1.0	1.0	0.0
19:38733773:A:G	186	109	440	216	224	1.0	0.0	1.0
19:38831447:T:G	2153	1473	10766	5134	5632	4	2	2
19:38876471:T:C	32	20	34	12	22	1.0	0.0	1.0
19:38911815:C:G	0	0	0	0	0	0	0	0
19:38918048:C:G	2	1	3	2	1	1.5	1.0	0.5
19:38926247:C:T	205	84	344	202	142	1	1	0
19:38930748:A:G	5	3	5	2	3	1	0	1
19:39100315:G:A	0	0	0	0	0	0	0	0
19:39269551:A:G	0	0	0	0	0	0	0	0
19:39383218:T:G	5	2	11	6	5	2	1	0
19:39504071:T:C	0	0	0	0	0	0	0	0
19:39505387:C:T	0	0	0	0	0	0	0	0
19:39540064:C:T	13	9	17	8	9	1	0	1
19:39870288:G:A	2	2	2	0	2	1.0	0.0	1.0
19:39875734:G:C	0	0	0	0	0	0	0	0
19:39886257:CCCG:TCCT	0	0	0	0	0	0	0	0
19:39894014:C:T	0	0	0	0	0	0	0	0
19:39914180:G:A	1	0	1	1	0	1	1	0
19:39934575:G:T	0	0	0	0	0	0	0	0
19:39943284:T:C	16	14	18	4	14	1.0	0.0	1.0
19:39980699:T:C	26	13	31	13	18	1.0	0.5	0.5
19:40024555:A:G	1	1	6	0	6	6	0	6
19:40074519:A:G	1	0	1	1	0	1	1	0
19:40242628:C:G	15	6	21	12	9	1	1	0
19:40423456:T:C	331	166	414	227	187	1	1	1
19:40441541:A:G	9	4	15	6	9	1	1	0
19:40472733:G:A	0	0	0	0	0	0	0	0
19:40577538:C:T	24	12	38	17	21	1.0	0.5	0.5
19:40580403:G:C	48	23	58	31	27	1.0	1.0	0.0
19:40612150:A:G	3	1	13	12	1	1	1	0
19:40623937:C:T	5	3	5	2	3	1	0	1
19:40703784:G:A	5	3	5	2	3	1	0	1
19:40714124:G:A	146	62	181	109	72	1.0	1.0	0.0
19:40763576:T:C	2	1	9	1	8	4.5	0.5	4.0
19:40777460:C:G	1	0	1	1	0	1	1	0
19:40779968:T:G	8	4	9	4	5	1.0	0.5	0.5
19:40826266:C:T	1	1	3	0	3	3	0	3
19:40844710:G:A	0	0	0	0	0	0	0	0
19:40845264:C:T	0	0	0	0	0	0	0	0
19:40847031:C:T	0	0	0	0	0	0	0	0
19:40898201:G:T	0	0	0	0	0	0	0	0
19:41025692:C:G	0	0	0	0	0	0	0	0
19:41026100:G:A	0	0	0	0	0	0	0	0
19:41136395:C:T	0	0	0	0	0	0	0	0
19:41206519:A:G	0	0	0	0	0	0	0	0
19:41363487:T:C	129	71	186	86	100	1	0	1
19:41577321:T:C	20	10	22	12	10	1.0	0.5	0.5
19:41579520:G:A	4	3	4	1	3	1.0	0.0	1.0
19:41625899:C:T	0	0	0	0	0	0	0	0
19:41727239:G:A	0	0	0	0	0	0	0	0
19:41830879:A:G	0	0	0	0	0	0	0	0
19:41888239:C:T	1177	621	1826	1004	822	1	1	1
19:42294897:C:T	19	6	22	16	6	1	1	0
19:42509211:A:G	5	5	6	0	6	1	0	1
19:42528409:G:A	11	8	11	3	8	1	0	1
19:42583332:A:C	0	0	0	0	0	0	0	0
19:42626528:G:A	0	0	0	0	0	0	0	0
19:42739065:AA:GG	0	0	0	0	0	0	0	0
19:42868882:G:A	0	0	0	0	0	0	0	0
19:42868926:C:G	0	0	0	0	0	0	0	0
19:42907679:G:A	0	0	0	0	0	0	0	0
19:43175885:T:A	0	0	0	0	0	0	0	0
19:43175995:C:T	0	0	0	0	0	0	0	0
19:43176117:G:C	0	0	0	0	0	0	0	0
19:43179129:A:G	0	0	0	0	0	0	0	0
19:43184852:G:A	0	0	0	0	0	0	0	0
19:43198190:C:T	0	0	0	0	0	0	0	0
19:43204093:G:C	0	0	0	0	0	0	0	0
19:43258907:C:T	0	0	0	0	0	0	0	0
19:43269447:T:C	0	0	0	0	0	0	0	0
19:43353892:A:T	0	0	0	0	0	0	0	0
19:43353914:G:A	0	0	0	0	0	0	0	0
19:43354426:G:A	0	0	0	0	0	0	0	0
19:43360396:C:A	0	0	0	0	0	0	0	0
19:43373607:C:A	0	0	0	0	0	0	0	0
19:43379121:G:C	0	0	0	0	0	0	0	0
19:43463540:T:C	0	0	0	0	0	0	0	0
19:43475437:G:T	5	3	5	2	3	1	0	1
19:43486643:G:A	4	0	11	11	0	2.0	2.0	0.0
19:43551574:T:C	17	8	32	21	11	1	1	0
19:43578639:T:C	0	0	0	0	0	0	0	0
19:43613430:T:C	3	2	5	1	4	1	0	1
19:43614036:A:C	1	1	1	0	1	1	0	1
19:43614201:G:A	3	0	3	3	0	1	1	0
19:43652320:T:C	1	0	1	1	0	1	1	0
19:43718993:C:T	0	0	0	0	0	0	0	0
19:43798472:T:C	0	0	0	0	0	0	0	0
19:43798914:C:G	0	0	0	0	0	0	0	0
19:43802330:C:T	0	0	0	0	0	0	0	0
19:43802424:G:T	0	0	0	0	0	0	0	0
19:43873517:G:A	2	1	2	1	1	1.0	0.5	0.5
19:43914191:C:T	1	1	1	0	1	1	0	1
19:43914528:G:C	3	0	5	5	0	2	2	0
19:43914541:T:C	4	0	5	5	0	1.0	1.0	0.0
19:44107804:T:C	8	5	8	3	5	1.0	0.0	1.0
19:44367127:C:T	0	0	0	0	0	0	0	0
19:44367133:C:T	0	0	0	0	0	0	0	0
19:44472854:T:C	0	0	0	0	0	0	0	0
19:44477666:G:C	12	9	23	6	17	1.0	0.0	1.0
19:44479350:G:C	15	7	21	12	9	1	1	0
19:44520547:G:C	0	0	0	0	0	0	0	0
19:44524136:T:C	0	0	0	0	0	0	0	0
19:44813547:CGCC:TGCT	0	0	0	0	0	0	0	0
19:44819487:A:G	0	0	0	0	0	0	0	0
19:44926902:G:A	0	0	0	0	0	0	0	0
19:44927023:C:G	0	0	0	0	0	0	0	0
19:45306777:A:G	0	0	0	0	0	0	0	0
19:45315577:A:G	0	0	0	0	0	0	0	0
19:45591339:G:A	0	0	0	0	0	0	0	0
19:45629993:C:T	22	12	27	12	15	1.0	0.0	1.0
19:45629998:G:A	22	12	27	12	15	1.0	0.0	1.0
19:45638587:T:C	119	49	204	129	75	1	1	0
19:45678284:G:C	1	1	1	0	1	1	0	1
19:45681959:C:A	0	0	0	0	0	0	0	0
19:45703004:G:A	0	0	0	0	0	0	0	0
19:45759028:C:A	0	0	0	0	0	0	0	0
19:45761705:C:T	0	0	0	0	0	0	0	0
19:45765644:C:T	0	0	0	0	0	0	0	0
19:45765818:G:A	1	0	1	1	0	1	1	0
19:46161143:A:G	0	0	0	0	0	0	0	0
19:46320546:C:T	0	0	0	0	0	0	0	0
19:46412445:C:T	0	0	0	0	0	0	0	0
19:46412751:A:G	0	0	0	0	0	0	0	0
19:46526945:G:A	6	2	8	6	2	1.0	1.0	0.0
19:47040516:G:A	11	1	33	32	1	1	1	0
19:47046196:C:T	540	268	621	325	296	1.0	1.0	0.0
19:47258389:G:C	27	13	45	20	25	1	1	0
19:47679530:C:T	2	0	2	2	0	1.0	1.0	0.0
19:47681217:C:T	5	3	9	2	7	1	0	1
19:47695418:A:G	3	2	3	1	2	1	0	1
19:47741312:G:A	0	0	0	0	0	0	0	0
19:47752547:A:G	184	89	235	118	117	1.0	1.0	0.0
19:48015984:C:G	0	0	0	0	0	0	0	0
19:48040649:G:C	0	0	0	0	0	0	0	0
19:48067815:T:G	7	4	8	4	4	1	0	1
19:48090334:G:C	0	0	0	0	0	0	0	0
19:48095566:A:G	1	1	12	0	12	12	0	12
19:48105341:C:G	2	1	3	1	2	1.5	0.5	1.0
19:48123347:G:A	0	0	0	0	0	0	0	0
19:48151296:G:T	9	2	9	7	2	1	1	0
19:48170201:G:A	2	2	4	0	4	2.0	0.0	2.0
19:48204144:G:T	0	0	0	0	0	0	0	0
19:48211896:T:C	19	11	19	8	11	1	0	1
19:48218923:C:T	15	5	38	21	17	1	1	0
19:48234449:A:T	37	15	43	25	18	1	1	0
19:48234507:A:G	60	39	69	25	44	1.0	0.0	1.0
19:48297081:A:G	0	0	0	0	0	0	0	0
19:48297534:A:G	0	0	0	0	0	0	0	0
19:48303720:G:A	1	0	4	4	0	4	4	0
19:48343389:C:T	6	3	12	8	4	1.0	0.5	0.5
19:48360129:C:T	59	31	93	40	53	1	0	1
19:48360179:G:A	22	10	75	45	30	3.0	1.5	0.0
19:48390418:C:T	4	2	5	2	3	1.0	0.5	0.5
19:48501294:C:T	0	0	0	0	0	0	0	0
19:48502972:G:A	0	0	0	0	0	0	0	0
19:48592808:C:T	0	0	0	0	0	0	0	0
19:48599142:C:T	0	0	0	0	0	0	0	0
19:48661695:A:G	0	0	0	0	0	0	0	0
19:48680448:G:A	1	0	1	1	0	1	1	0
19:48703160:A:G	0	0	0	0	0	0	0	0
19:48703205:C:T	1	0	1	1	0	1	1	0
19:48703346:C:T	1	0	1	1	0	1	1	0
19:48703417:G:A	0	0	0	0	0	0	0	0
19:48703728:G:A	1	1	1	0	1	1	0	1
19:48703949:A:G	0	0	0	0	0	0	0	0
19:48703998:ATT:GTC	0	0	0	0	0	0	0	0
19:48714854:G:T	0	0	0	0	0	0	0	0
19:48715345:C:T	0	0	0	0	0	0	0	0
19:48835841:T:C	6	5	11	5	6	1.0	0.0	1.0
19:48865586:T:C	0	0	0	0	0	0	0	0
19:48873829:T:C	66	32	110	52	58	1.0	1.0	0.0
19:48873985:G:C	95	42	163	94	69	1	1	0
19:48874062:A:G	77	45	122	53	69	1	0	1
19:48874179:G:C	78	42	112	50	62	1.0	0.0	1.0
19:48875737:A:G	125	65	157	77	80	1	1	1
19:48888147:C:T	0	0	0	0	0	0	0	0
19:48897377:C:T	0	0	0	0	0	0	0	0
19:48919250:G:T	45	26	51	21	30	1	0	1
19:48965830:T:C	3184	2888	19170	9801	9369	5.0	3.0	2.0
19:48970770:A:T	0	0	0	0	0	0	0	0
19:48982291:G:A	10	9	14	1	13	1.0	0.0	1.0
19:49016209:A:G	1	1	1	0	1	1	0	1
19:49016616:G:C	0	0	0	0	0	0	0	0
19:49024048:A:G	0	0	0	0	0	0	0	0
19:49057204:G:A	0	0	0	0	0	0	0	0
19:49070181:A:G	0	0	0	0	0	0	0	0
19:49158290:A:G	0	0	0	0	0	0	0	0
19:49446332:A:T	3	1	3	2	1	1	1	0
19:49447041:C:T	20	11	35	9	26	1.0	0.0	1.0
19:49451546:CCCAT:TCCAG	746	389	929	494	435	1.0	1.0	1.0
19:49636835:G:A	16	7	16	9	7	1.0	1.0	0.0
19:49850954:C:T	8	3	9	6	3	1.0	1.0	0.0
19:49857732:A:G	28	17	40	15	25	1.0	0.0	1.0
19:49971681:C:G	0	0	0	0	0	0	0	0
19:50257459:C:G	0	0	0	0	0	0	0	0
19:50454140:G:A	0	0	0	0	0	0	0	0
19:50464383:G:A	0	0	0	0	0	0	0	0
19:50480673:C:T	27	13	29	15	14	1	1	0
19:50656314:T:G	0	0	0	0	0	0	0	0
19:50858216:C:A	0	0	0	0	0	0	0	0
19:50858501:T:C	0	0	0	0	0	0	0	0
19:50859547:C:T	0	0	0	0	0	0	0	0
19:50982366:A:G	0	0	0	0	0	0	0	0
19:50983919:T:G	0	0	0	0	0	0	0	0
19:51027485:C:G	0	0	0	0	0	0	0	0
19:51081659:G:A	1	1	1	0	1	1	0	1
19:51225385:A:G	1	1	1	0	1	1	0	1
19:51333917:A:G	0	0	0	0	0	0	0	0
19:51340554:C:T	0	0	0	0	0	0	0	0
19:51341724:G:T	0	0	0	0	0	0	0	0
19:51342117:T:G	0	0	0	0	0	0	0	0
19:51347036:G:A	47	24	56	30	26	1	1	1
19:51354484:G:A	0	0	0	0	0	0	0	0
19:51403314:C:T	7	7	7	0	7	1	0	1
19:51413754:C:T	52	19	94	57	37	1.0	1.0	0.0
19:51414481:G:A	79	36	216	116	100	2	1	0
19:51414858:A:G	51	25	106	57	49	1	1	0
19:51414881:G:T	44	21	91	47	44	1.0	1.0	0.0
19:51416253:T:C	3	1	4	3	1	1	1	0
19:51416744:T:C	48	24	107	53	54	1.0	0.5	0.5
19:51417359:C:T	466	271	656	341	315	1.0	0.0	1.0
19:51481471:T:A	0	0	0	0	0	0	0	0
19:51499703:C:T	0	0	0	0	0	0	0	0
19:51589568:C:G	2	2	2	0	2	1.0	0.0	1.0
19:51627235:G:A	14	1	43	42	1	2.5	2.5	0.0
19:51627577:C:A	15	15	59	0	59	3	0	3
19:51629072:A:T	13	1	42	36	6	2	2	0
19:51645551:A:C	2	0	9	9	0	4.5	4.5	0.0
19:51719299:G:A	0	0	0	0	0	0	0	0
19:51746419:A:G	2	1	2	1	1	1.0	0.5	0.5
19:51746427:T:A	2	1	2	1	1	1.0	0.5	0.5
19:51746449:G:T	3	2	3	1	2	1	0	1
19:52511093:G:A	0	0	0	0	0	0	0	0
19:52516032:C:G	0	0	0	0	0	0	0	0
19:52553700:G:A	1	1	1	0	1	1	0	1
19:52595847:T:C	3	1	13	6	7	4	2	0
19:52597332:G:T	1	0	6	6	0	6	6	0
19:52618915:C:T	196	126	210	79	131	1.0	0.0	1.0
19:52618973:A:G	353	217	474	200	274	1	0	1
19:52706300:GG:AT	0	0	0	0	0	0	0	0
19:52760423:T:C	0	0	0	0	0	0	0	0
19:52840686:T:G	5	4	6	1	5	1	0	1
19:52841448:A:G	3	3	3	0	3	1	0	1
19:52841666:T:G	1	0	1	1	0	1	1	0
19:52906723:T:C	0	0	0	0	0	0	0	0
19:53108549:T:G	0	0	0	0	0	0	0	0
19:53109736:A:G	4	1	4	3	1	1.0	1.0	0.0
19:53224029:A:G	0	0	0	0	0	0	0	0
19:53224139:T:C	2	2	2	0	2	1.0	0.0	1.0
19:53224320:A:G	18	1	19	17	2	1.0	1.0	0.0
19:53224391:T:C	20	20	20	0	20	1.0	0.0	1.0
19:53237569:T:C	0	0	0	0	0	0	0	0
19:53237815:C:T	0	0	0	0	0	0	0	0
19:53237935:C:T	0	0	0	0	0	0	0	0
19:53258487:T:C	0	0	0	0	0	0	0	0
19:53267511:G:A	0	0	0	0	0	0	0	0
19:53284588:A:G	0	0	0	0	0	0	0	0
19:53315220:C:T	0	0	0	0	0	0	0	0
19:53315311:C:T	0	0	0	0	0	0	0	0
19:53315312:G:T	0	0	0	0	0	0	0	0
19:53315350:G:A	0	0	0	0	0	0	0	0
19:53315825:C:T	0	0	0	0	0	0	0	0
19:53315914:G:A	0	0	0	0	0	0	0	0
19:53315923:C:T	0	0	0	0	0	0	0	0
19:53381159:G:A	1	1	1	0	1	1	0	1
19:53382259:C:A	1	0	1	1	0	1	1	0
19:53386298:C:G	5	2	5	3	2	1	1	0
19:53408257:G:A	1	0	1	1	0	1	1	0
19:53454872:T:G	18	12	58	17	41	2.0	0.0	1.0
19:53456550:T:C	2	0	2	2	0	1.0	1.0	0.0
19:53486691:G:A	25	8	52	44	8	1	1	0
19:53490669:C:T	4	0	7	7	0	1.5	1.5	0.0
19:53491750:G:A	2	1	2	1	1	1.0	0.5	0.5
19:53772987:T:G	0	0	0	0	0	0	0	0
19:53773148:T:C	0	0	0	0	0	0	0	0
19:53775808:G:A	0	0	0	0	0	0	0	0
19:53775868:C:A	0	0	0	0	0	0	0	0
19:53793980:G:T	1	1	1	0	1	1	0	1
19:53804068:G:A	0	0	0	0	0	0	0	0
19:53824059:C:A	0	0	0	0	0	0	0	0
19:53824186:G:A	0	0	0	0	0	0	0	0
19:53882566:C:T	0	0	0	0	0	0	0	0
19:53891711:T:C	0	0	0	0	0	0	0	0
19:54103097:T:C	1	1	1	0	1	1	0	1
19:54106863:C:T	1466	857	2044	1033	1011	1.0	1.0	1.0
19:54121872:T:C	595	301	726	394	332	1	1	1
19:54122676:G:C	0	0	0	0	0	0	0	0
19:54161015:C:A	1	1	1	0	1	1	0	1
19:54173068:T:C	0	0	0	0	0	0	0	0
19:54193607:A:C	1	0	1	1	0	1	1	0
19:54219869:C:G	0	0	0	0	0	0	0	0
19:54252131:A:G	0	0	0	0	0	0	0	0
19:54355963:C:T	11	8	16	5	11	1	0	1
19:54457990:C:T	22	9	33	19	14	1.0	1.0	0.0
19:54533823:A:G	1	0	1	1	0	1	1	0
19:54543645:G:A	0	0	0	0	0	0	0	0
19:54664289:T:C	3	3	6	0	6	2	0	2
19:54666711:A:G	0	0	0	0	0	0	0	0
19:54667913:G:A	4	4	5	0	5	1.0	0.0	1.0
19:54697021:G:A	0	0	0	0	0	0	0	0
19:54710318:CC:TT	0	0	0	0	0	0	0	0
19:54710324:G:A	0	0	0	0	0	0	0	0
19:54735345:G:C	0	0	0	0	0	0	0	0
19:54735982:A:T	0	0	0	0	0	0	0	0
19:54752446:G:A	0	0	0	0	0	0	0	0
19:54766542:C:T	0	0	0	0	0	0	0	0
19:54767309:A:G	0	0	0	0	0	0	0	0
19:54767353:A:C	0	0	0	0	0	0	0	0
19:54814000:G:A	0	0	0	0	0	0	0	0
19:54853865:G:T	1	0	1	1	0	1	1	0
19:54970026:C:T	6	0	7	7	0	1.0	1.0	0.0
19:54974531:G:A	3	3	3	0	3	1	0	1
19:54982360:C:T	1	0	1	1	0	1	1	0
19:55014991:A:T	0	0	0	0	0	0	0	0
19:55015713:C:T	0	0	0	0	0	0	0	0
19:55018667:C:T	0	0	0	0	0	0	0	0
19:55027693:A:G	0	0	0	0	0	0	0	0
19:55032605:C:T	0	0	0	0	0	0	0	0
19:55048347:G:A	3	2	12	1	11	1	0	1
19:55056716:CG:TT	18	5	19	13	6	1.0	1.0	0.0
19:55076454:G:A	0	0	0	0	0	0	0	0
19:55082049:C:T	0	0	0	0	0	0	0	0
19:55149169:T:C	0	0	0	0	0	0	0	0
19:55191542:C:A	0	0	0	0	0	0	0	0
19:55197205:G:A	0	0	0	0	0	0	0	0
19:55202167:G:A	0	0	0	0	0	0	0	0
19:55203941:C:T	0	0	0	0	0	0	0	0
19:55203951:C:G	0	0	0	0	0	0	0	0
19:55228237:C:T	4	2	4	2	2	1.0	0.5	0.5
19:55228321:G:A	6	4	7	2	5	1.0	0.0	1.0
19:55228445:G:A	2	0	4	4	0	2.0	2.0	0.0
19:55245612:A:G	16	10	20	7	13	1.0	0.0	1.0
19:55279723:C:T	0	0	0	0	0	0	0	0
19:55312964:T:G	0	0	0	0	0	0	0	0
19:55312972:C:G	0	0	0	0	0	0	0	0
19:55321059:T:G	0	0	0	0	0	0	0	0
19:55344715:T:C	0	0	0	0	0	0	0	0
19:55403006:C:T	7	1	26	23	3	3	2	0
19:55486895:C:T	0	0	0	0	0	0	0	0
19:55498098:G:A	0	0	0	0	0	0	0	0
19:55500093:C:T	0	0	0	0	0	0	0	0
19:55531173:G:A	0	0	0	0	0	0	0	0
19:55649200:T:G	0	0	0	0	0	0	0	0
19:55651410:C:T	13	7	13	6	7	1	0	1
19:55669602:C:T	35	16	40	24	16	1	1	0
19:55763087:G:A	0	0	0	0	0	0	0	0
19:55810151:T:C	0	0	0	0	0	0	0	0
19:55858206:G:A	0	0	0	0	0	0	0	0
19:55881554:C:T	0	0	0	0	0	0	0	0
19:55999784:G:A	0	0	0	0	0	0	0	0
19:56027610:G:C	0	0	0	0	0	0	0	0
19:56053761:G:A	0	0	0	0	0	0	0	0
19:56182251:C:G	0	0	0	0	0	0	0	0
19:56190954:C:T	0	0	0	0	0	0	0	0
19:56192891:C:T	0	0	0	0	0	0	0	0
19:56205984:A:G	0	0	0	0	0	0	0	0
19:56244191:T:A	0	0	0	0	0	0	0	0
19:56424158:A:G	1	1	2	0	2	2	0	2
19:56442216:T:C	1	0	1	1	0	1	1	0
19:56442594:G:A	4	3	4	1	3	1.0	0.0	1.0
19:56550704:T:C	0	0	0	0	0	0	0	0
19:56578128:T:C	1	1	1	0	1	1	0	1
19:56621600:G:A	1	0	1	1	0	1	1	0
19:56779435:C:T	0	0	0	0	0	0	0	0
19:56823654:G:A	0	0	0	0	0	0	0	0
19:57248650:G:A	18	7	24	16	8	1.0	1.0	0.0
19:57248689:G:A	14	4	19	15	4	1.0	1.0	0.0
19:57253402:G:A	1	1	1	0	1	1	0	1
19:57254064:A:G	1	1	1	0	1	1	0	1
19:57317367:G:T	4	4	4	0	4	1.0	0.0	1.0
19:57317528:C:T	2	2	2	0	2	1.0	0.0	1.0
19:57320846:G:T	28	12	42	28	14	1.0	1.0	0.0
19:57326650:C:G	4	4	4	0	4	1.0	0.0	1.0
19:57329179:A:G	5	3	11	6	5	2	0	1
19:57353781:C:T	1	1	1	0	1	1	0	1
19:57356231:T:C	1	0	1	1	0	1	1	0
19:57398504:G:A	3	1	3	2	1	1	1	0
19:57435556:G:C	119	28	318	252	66	1	1	0
19:57472089:A:G	1	1	1	0	1	1	0	1
19:57474092:T:A	0	0	0	0	0	0	0	0
19:57474198:G:C	0	0	0	0	0	0	0	0
19:57474334:C:A	3	1	3	2	1	1	1	0
19:57476527:C:T	1	1	1	0	1	1	0	1
19:57491596:G:C	29	9	43	28	15	1	1	0
19:57492212:G:A	4	3	4	1	3	1.0	0.0	1.0
19:57492245:C:T	0	0	0	0	0	0	0	0
19:57492360:G:A	0	0	0	0	0	0	0	0
19:57492978:G:C	1	0	1	1	0	1	1	0
19:57493563:A:G	2	0	2	2	0	1.0	1.0	0.0
19:57547371:T:C	0	0	0	0	0	0	0	0
19:57606031:C:T	0	0	0	0	0	0	0	0
19:57620255:G:A	17	9	17	8	9	1	0	1
19:57640993:T:A	3	1	3	2	1	1	1	0
19:57641427:C:T	1	0	2	2	0	2	2	0
19:57641449:G:C	0	0	0	0	0	0	0	0
19:57641632:T:C	5	1	5	4	1	1	1	0
19:57641641:C:T	3	1	3	2	1	1	1	0
19:57701906:C:T	1	0	3	3	0	3	3	0
19:57702584:C:A	5	1	16	11	5	3	3	0
19:57830475:A:G	0	0	0	0	0	0	0	0
19:57841154:G:A	0	0	0	0	0	0	0	0
19:57850003:C:T	34	9	46	31	15	1.0	1.0	0.0
19:57860088:G:A	3	2	12	1	11	1	0	1
19:57874586:T:C	0	0	0	0	0	0	0	0
19:57941974:T:C	2	0	2	2	0	1.0	1.0	0.0
19:58002439:A:C	104	59	179	79	100	1.0	0.0	1.0
19:58045284:C:T	0	0	0	0	0	0	0	0
19:58045522:G:T	0	0	0	0	0	0	0	0
19:58067210:C:T	0	0	0	0	0	0	0	0
19:58084925:G:A	14	4	14	10	4	1.0	1.0	0.0
19:58206902:G:A	12	7	12	5	7	1.0	0.0	1.0
19:58338840:G:A	1	1	1	0	1	1	0	1
19:58357114:G:T	0	0	0	0	0	0	0	0
19:58368817:T:C	0	0	0	0	0	0	0	0
19:58393029:G:A	3263	3238	58933	27561	31372	15	7	8
19:58548362:G:A	36	16	41	24	17	1.0	1.0	0.0
20:277092:A:G	2	1	3	1	2	1.5	0.5	1.0
20:391328:T:C	11	5	11	6	5	1	1	0
20:396582:C:T	2	1	2	1	1	1.0	0.5	0.5
20:765454:G:A	0	0	0	0	0	0	0	0
20:874297:T:C	0	0	0	0	0	0	0	0
20:1310432:G:C	0	0	0	0	0	0	0	0
20:1312364:C:T	0	0	0	0	0	0	0	0
20:1312497:C:T	0	0	0	0	0	0	0	0
20:1370028:T:C	165	92	221	107	114	1	0	1
20:1370065:T:C	191	91	255	129	126	1	1	0
20:1445748:C:T	17	10	39	29	10	1	0	1
20:1477265:C:A	0	0	0	0	0	0	0	0
20:1478415:T:G	2	0	2	2	0	1.0	1.0	0.0
20:1557620:G:A	0	0	0	0	0	0	0	0
20:1566265:C:G	0	0	0	0	0	0	0	0
20:1570839:C:T	0	0	0	0	0	0	0	0
20:1571784:T:C	0	0	0	0	0	0	0	0
20:1578455:T:G	0	0	0	0	0	0	0	0
20:1619878:T:C	2	1	3	2	1	1.5	1.0	0.5
20:1636246:A:G	0	0	0	0	0	0	0	0
20:1649260:C:T	3	2	3	1	2	1	0	1
20:2309687:C:A	0	0	0	0	0	0	0	0
20:2637494:T:C	0	0	0	0	0	0	0	0
20:2653290:T:C	281	142	385	194	191	1	1	1
20:2758937:T:C	0	0	0	0	0	0	0	0
20:2816369:G:A	0	0	0	0	0	0	0	0
20:3015851:C:T	10	9	11	1	10	1.0	0.0	1.0
20:3044461:C:T	0	0	0	0	0	0	0	0
20:3110296:A:G	2	0	2	2	0	1.0	1.0	0.0
20:3110323:T:C	0	0	0	0	0	0	0	0
20:3147932:A:C	6	2	7	5	2	1.0	1.0	0.0
20:3166822:G:A	0	0	0	0	0	0	0	0
20:3213332:G:A	527	324	752	307	445	1	0	1
20:3228366:C:T	0	0	0	0	0	0	0	0
20:3234902:C:A	0	0	0	0	0	0	0	0
20:3255270:T:C	4	1	10	3	7	1.0	1.0	0.0
20:3294593:G:A	3	1	3	2	1	1	1	0
20:3304479:A:T	3	3	9	0	9	2	0	2
20:3535277:G:A	4	1	4	3	1	1.0	1.0	0.0
20:3535304:C:T	2	0	2	2	0	1.0	1.0	0.0
20:3584025:C:T	5	3	6	2	4	1	0	1
20:3644201:C:T	0	0	0	0	0	0	0	0
20:3701502:G:A	0	0	0	0	0	0	0	0
20:3778553:G:A	0	0	0	0	0	0	0	0
20:3778881:C:T	1	0	2	2	0	2	2	0
20:3803463:C:T	19	6	23	17	6	1	1	0
20:3857794:C:G	38	18	48	23	25	1.0	1.0	0.0
20:3862380:C:A	5	2	9	4	5	2	1	0
20:3865750:C:T	3	1	9	2	7	1	1	0
20:4177517:C:A	0	0	0	0	0	0	0	0
20:4182655:A:G	0	0	0	0	0	0	0	0
20:4725072:C:T	0	0	0	0	0	0	0	0
20:5292668:C:T	10	10	10	0	10	1.0	0.0	1.0
20:5292736:G:A	42	41	43	1	42	1.0	0.0	1.0
20:5302730:G:A	0	0	0	0	0	0	0	0
20:5501760:T:G	1	1	1	0	1	1	0	1
20:5923202:C:G	0	0	0	0	0	0	0	0
20:5923248:A:G	0	0	0	0	0	0	0	0
20:5923394:G:A	0	0	0	0	0	0	0	0
20:5928590:T:C	0	0	0	0	0	0	0	0
20:6084063:A:G	0	0	0	0	0	0	0	0
20:6085082:CTT:TTC	0	0	0	0	0	0	0	0
20:6119441:A:G	0	0	0	0	0	0	0	0
20:6213774:A:C	7	0	7	7	0	1	1	0
20:6778468:A:T	0	0	0	0	0	0	0	0
20:7982394:C:T	22	11	22	11	11	1.0	0.5	0.5
20:7999743:C:T	17	10	20	10	10	1	0	1
20:8757087:G:A	1	0	1	1	0	1	1	0
20:8774596:T:C	0	0	0	0	0	0	0	0
20:8790175:C:T	0	0	0	0	0	0	0	0
20:8792648:T:C	0	0	0	0	0	0	0	0
20:9539495:G:A	0	0	0	0	0	0	0	0
20:10049540:T:A	0	0	0	0	0	0	0	0
20:10049804:G:A	0	0	0	0	0	0	0	0
20:10051765:T:G	0	0	0	0	0	0	0	0
20:10349240:T:G	0	0	0	0	0	0	0	0
20:10639627:G:A	0	0	0	0	0	0	0	0
20:10639738:A:G	0	0	0	0	0	0	0	0
20:10652589:G:A	0	0	0	0	0	0	0	0
20:13073985:G:A	0	0	0	0	0	0	0	0
20:13091168:C:T	0	0	0	0	0	0	0	0
20:13766794:A:G	8	4	11	5	6	1.0	0.5	0.5
20:13849456:C:T	0	0	0	0	0	0	0	0
20:13849491:A:C	0	0	0	0	0	0	0	0
20:14849950:C:G	0	0	0	0	0	0	0	0
20:16429914:A:T	3	1	4	2	2	1	1	0
20:16506053:G:A	0	0	0	0	0	0	0	0
20:16512888:T:C	9	4	14	5	9	1	1	0
20:16748493:T:C	0	0	0	0	0	0	0	0
20:17494146:G:A	0	0	0	0	0	0	0	0
20:17494323:T:C	0	0	0	0	0	0	0	0
20:17498972:G:A	0	0	0	0	0	0	0	0
20:17517124:G:A	0	0	0	0	0	0	0	0
20:17735771:C:G	0	0	0	0	0	0	0	0
20:18315829:C:T	0	0	0	0	0	0	0	0
20:18316549:T:C	2	1	2	1	1	1.0	0.5	0.5
20:18412668:C:G	1	0	7	7	0	7	7	0
20:18433712:A:G	0	0	0	0	0	0	0	0
20:18465319:A:G	5	3	16	4	12	3	0	2
20:18504768:C:G	41	40	43	1	42	1	0	1
20:18542358:C:G	14	7	15	7	8	1.0	0.5	0.5
20:18830061:C:T	0	0	0	0	0	0	0	0
20:19280979:G:A	0	0	0	0	0	0	0	0
20:19580020:G:A	0	0	0	0	0	0	0	0
20:19654088:G:A	0	0	0	0	0	0	0	0
20:19654103:T:C	0	0	0	0	0	0	0	0
20:19970890:T:A	0	0	0	0	0	0	0	0
20:20025724:T:C	402	199	484	257	227	1.0	1.0	0.0
20:20052354:T:C	99	46	115	61	54	1	1	0
20:20052598:A:T	0	0	0	0	0	0	0	0
20:20052675:A:G	0	0	0	0	0	0	0	0
20:20164128:G:A	0	0	0	0	0	0	0	0
20:20512578:G:A	1	0	1	1	0	1	1	0
20:21166369:A:G	177	175	185	2	183	1	0	1
20:23036333:T:G	0	0	0	0	0	0	0	0
20:23036380:T:C	0	0	0	0	0	0	0	0
20:23036407:C:T	0	0	0	0	0	0	0	0
20:23354144:C:T	178	89	185	96	89	1.0	1.0	0.5
20:23440464:G:A	0	0	0	0	0	0	0	0
20:23443976:T:C	0	0	0	0	0	0	0	0
20:23444001:C:T	0	0	0	0	0	0	0	0
20:23451891:A:G	0	0	0	0	0	0	0	0
20:23566002:T:G	0	0	0	0	0	0	0	0
20:23605723:G:A	0	0	0	0	0	0	0	0
20:23750857:A:G	0	0	0	0	0	0	0	0
20:23989604:ACA:GCT	0	0	0	0	0	0	0	0
20:24959686:G:A	3	1	3	2	1	1	1	0
20:25775036:G:T	0	0	0	0	0	0	0	0
20:29101470:G:A	0	0	0	0	0	0	0	0
20:29321627:G:A	0	0	0	0	0	0	0	0
20:29416099:A:C	0	0	0	0	0	0	0	0
20:29641970:A:T	0	0	0	0	0	0	0	0
20:32029032:G:A	0	0	0	0	0	0	0	0
20:32189997:T:C	1	1	1	0	1	1	0	1
20:32208016:T:C	56	25	131	80	51	2.0	1.0	0.0
20:32436471:T:C	8	4	8	4	4	1.0	0.5	0.5
20:32601609:A:G	0	0	0	0	0	0	0	0
20:32798541:T:C	0	0	0	0	0	0	0	0
20:32798643:T:C	0	0	0	0	0	0	0	0
20:32878728:C:T	0	0	0	0	0	0	0	0
20:32906576:G:A	0	0	0	0	0	0	0	0
20:32917486:C:T	0	0	0	0	0	0	0	0
20:32999946:G:C	0	0	0	0	0	0	0	0
20:32999987:A:G	0	0	0	0	0	0	0	0
20:33002880:C:A	0	0	0	0	0	0	0	0
20:33021775:C:T	0	0	0	0	0	0	0	0
20:33064509:G:C	0	0	0	0	0	0	0	0
20:33309748:G:C	0	0	0	0	0	0	0	0
20:33965289:C:T	0	0	0	0	0	0	0	0
20:35560245:C:T	0	0	0	0	0	0	0	0
20:36839310:G:A	2	1	2	1	1	1.0	0.5	0.5
20:37112391:T:C	0	0	0	0	0	0	0	0
20:37141189:T:C	0	0	0	0	0	0	0	0
20:37141244:G:T	0	0	0	0	0	0	0	0
20:37155091:T:C	0	0	0	0	0	0	0	0
20:37236651:C:T	31	17	40	17	23	1	0	1
20:38213354:T:C	0	0	0	0	0	0	0	0
20:38217336:C:T	0	0	0	0	0	0	0	0
20:38304258:C:T	0	0	0	0	0	0	0	0
20:38304274:G:C	0	0	0	0	0	0	0	0
20:38318446:G:A	0	0	0	0	0	0	0	0
20:38350862:T:C	0	0	0	0	0	0	0	0
20:38360727:A:G	0	0	0	0	0	0	0	0
20:38376894:C:T	0	0	0	0	0	0	0	0
20:38433940:C:T	0	0	0	0	0	0	0	0
20:38754997:T:C	2	1	2	1	1	1.0	0.5	0.5
20:38918379:A:C	38	21	91	32	59	1.0	0.0	1.0
20:38952027:C:G	1	1	1	0	1	1	0	1
20:41997715:A:G	0	0	0	0	0	0	0	0
20:41997834:C:T	0	0	0	0	0	0	0	0
20:41998625:C:T	0	0	0	0	0	0	0	0
20:42085839:G:A	0	0	0	0	0	0	0	0
20:43460871:T:C	12	11	12	1	11	1.0	0.0	1.0
20:43570977:C:A	0	0	0	0	0	0	0	0
20:43636013:G:A	1	0	9	9	0	9	9	0
20:43702817:A:G	10	8	11	3	8	1.0	0.0	1.0
20:44114814:A:G	0	0	0	0	0	0	0	0
20:44938146:A:G	14	9	16	6	10	1.0	0.0	1.0
20:44939185:A:G	14	9	15	5	10	1.0	0.0	1.0
20:44943576:T:C	14	11	32	5	27	1.5	0.0	1.0
20:45000494:G:A	42	21	78	26	52	1.0	1.0	0.5
20:45094986:T:C	0	0	0	0	0	0	0	0
20:45110478:G:A	0	0	0	0	0	0	0	0
20:45174972:C:T	0	0	0	0	0	0	0	0
20:45175881:A:C	0	0	0	0	0	0	0	0
20:45207042:T:A	0	0	0	0	0	0	0	0
20:45208503:T:C	0	0	0	0	0	0	0	0
20:45222453:G:A	0	0	0	0	0	0	0	0
20:45545784:G:A	0	0	0	0	0	0	0	0
20:45555859:A:G	0	0	0	0	0	0	0	0
20:45610102:T:G	0	0	0	0	0	0	0	0
20:45722456:C:A	0	0	0	0	0	0	0	0
20:45788954:C:A	0	0	0	0	0	0	0	0
20:45789004:A:G	0	0	0	0	0	0	0	0
20:45789036:G:C	0	0	0	0	0	0	0	0
20:45890212:C:T	0	0	0	0	0	0	0	0
20:46464282:G:A	0	0	0	0	0	0	0	0
20:46588145:A:T	0	0	0	0	0	0	0	0
20:47089315:C:T	0	0	0	0	0	0	0	0
20:47636144:G:C	13	5	25	17	8	1	1	0
20:47736827:A:G	0	0	0	0	0	0	0	0
20:48639842:A:C	13	8	13	5	8	1	0	1
20:49513169:G:T	0	0	0	0	0	0	0	0
20:49636377:C:T	1	0	1	1	0	1	1	0
20:49642497:A:G	2	2	2	0	2	1.0	0.0	1.0
20:49830358:C:T	0	0	0	0	0	0	0	0
20:49905793:G:A	2	1	2	1	1	1.0	0.5	0.5
20:49908290:A:G	9	3	9	6	3	1	1	0
20:49983012:T:C	0	0	0	0	0	0	0	0
20:49983024:G:C	0	0	0	0	0	0	0	0
20:49984094:T:C	0	0	0	0	0	0	0	0
20:49984272:G:A	0	0	0	0	0	0	0	0
20:50278219:C:T	5	0	6	6	0	1	1	0
20:50597651:C:T	8	2	29	20	9	3.0	2.5	0.0
20:50602232:C:T	0	0	0	0	0	0	0	0
20:51475490:T:G	32	21	64	19	45	1.5	0.0	1.0
20:51619038:G:A	0	0	0	0	0	0	0	0
20:52089045:C:T	0	0	0	0	0	0	0	0
20:52110970:C:T	104	0	111	111	0	1.0	1.0	0.0
20:52153010:A:G	6	2	10	8	2	1.0	1.0	0.0
20:53581933:A:G	16	10	16	6	10	1.0	0.0	1.0
20:54058649:G:T	5	4	6	1	5	1	0	1
20:54058720:G:T	2	2	6	0	6	3.0	0.0	3.0
20:54169680:G:A	0	0	0	0	0	0	0	0
20:56386407:T:C	7	6	7	1	6	1	0	1
20:56453111:G:A	3	1	3	2	1	1	1	0
20:56458420:C:G	0	0	0	0	0	0	0	0
20:56458579:C:T	0	0	0	0	0	0	0	0
20:56458591:T:C	0	0	0	0	0	0	0	0
20:56458657:G:A	0	0	0	0	0	0	0	0
20:56497416:A:G	0	0	0	0	0	0	0	0
20:56513348:A:G	28	16	41	21	20	1.0	0.0	1.0
20:56533561:C:A	4	2	18	2	16	1.0	0.5	0.5
20:56536315:G:A	2	1	2	1	1	1.0	0.5	0.5
20:57225881:C:T	0	0	0	0	0	0	0	0
20:57374924:G:A	1	0	5	5	0	5	5	0
20:57524058:C:G	0	0	0	0	0	0	0	0
20:57562839:G:C	0	0	0	0	0	0	0	0
20:57564347:T:C	0	0	0	0	0	0	0	0
20:57604366:C:A	9	2	9	7	2	1	1	0
20:57607127:G:C	3	1	13	10	3	4	4	0
20:58160703:A:G	0	0	0	0	0	0	0	0
20:58445172:G:C	11	6	11	5	6	1	0	1
20:58840055:A:G	0	0	0	0	0	0	0	0
20:58903752:C:T	516	172	710	484	226	1.0	1.0	0.0
20:59254246:T:C	0	0	0	0	0	0	0	0
20:60001377:A:G	0	0	0	0	0	0	0	0
20:60308476:T:C	0	0	0	0	0	0	0	0
20:60308547:T:G	0	0	0	0	0	0	0	0
20:61928292:A:G	0	0	0	0	0	0	0	0
20:62137455:A:G	9	5	34	10	24	3	0	1
20:62163510:C:T	1	0	2	2	0	2	2	0
20:62312525:G:A	3	0	3	3	0	1	1	0
20:62318583:G:C	0	0	0	0	0	0	0	0
20:62322048:C:T	0	0	0	0	0	0	0	0
20:62345831:G:A	1	0	6	6	0	6	6	0
20:62346741:G:A	0	0	0	0	0	0	0	0
20:62352356:G:A	0	0	0	0	0	0	0	0
20:62388438:C:T	176	43	182	139	43	1.0	1.0	0.0
20:62410963:A:C	0	0	0	0	0	0	0	0
20:62414309:C:T	0	0	0	0	0	0	0	0
20:62473493:G:A	0	0	0	0	0	0	0	0
20:62671912:C:T	3	1	3	2	1	1	1	0
20:62812518:C:G	28	13	57	34	23	1.0	1.0	0.0
20:62813341:GAGAG:AAGAC	36	17	56	23	33	1.0	1.0	0.0
20:62828772:G:A	0	0	0	0	0	0	0	0
20:62832149:T:C	0	0	0	0	0	0	0	0
20:62836448:A:G	35	2	80	78	2	2	2	0
20:63305944:C:T	0	0	0	0	0	0	0	0
20:63314087:G:C	0	0	0	0	0	0	0	0
20:63343510:C:T	0	0	0	0	0	0	0	0
20:63344026:A:G	0	0	0	0	0	0	0	0
20:63344676:GTCCA:ATCCG	0	0	0	0	0	0	0	0
20:63345076:C:T	0	0	0	0	0	0	0	0
20:63345663:C:T	0	0	0	0	0	0	0	0
20:63345697:G:C	0	0	0	0	0	0	0	0
20:63345983:A:G	0	0	0	0	0	0	0	0
20:63349639:T:C	0	0	0	0	0	0	0	0
20:63351050:G:A	0	0	0	0	0	0	0	0
20:63439613:G:A	0	0	0	0	0	0	0	0
20:63494946:C:T	0	0	0	0	0	0	0	0
20:63555834:T:C	2	0	2	2	0	1.0	1.0	0.0
20:63559968:A:G	12	5	23	17	6	1.0	1.0	0.0
20:63560205:G:A	9	5	13	4	9	1	0	1
20:63562677:G:C	4	4	4	0	4	1.0	0.0	1.0
20:63563360:A:C	1	1	1	0	1	1	0	1
20:63563734:A:G	1	0	1	1	0	1	1	0
20:63697022:A:G	4	0	18	18	0	4.5	4.5	0.0
20:63741353:G:A	5	2	21	8	13	3	2	0
20:63741460:G:A	52	32	58	22	36	1.0	0.0	1.0
20:63747011:C:T	1	1	1	0	1	1	0	1
20:63775823:G:A	1	0	1	1	0	1	1	0
20:63963816:A:G	2	1	2	1	1	1.0	0.5	0.5
20:63966341:T:G	1	1	1	0	1	1	0	1
20:64083430:C:G	0	0	0	0	0	0	0	0
21:10485622:A:G	0	0	0	0	0	0	0	0
21:10602146:A:C	0	0	0	0	0	0	0	0
21:13384722:T:C	0	0	0	0	0	0	0	0
21:13527536:G:A	0	0	0	0	0	0	0	0
21:13544348:C:T	0	0	0	0	0	0	0	0
21:13938033:G:A	0	0	0	0	0	0	0	0
21:13958155:C:T	0	0	0	0	0	0	0	0
21:14109044:G:T	2	2	8	0	8	4.0	0.0	4.0
21:14186025:G:A	0	0	0	0	0	0	0	0
21:14299523:G:A	0	0	0	0	0	0	0	0
21:14299571:G:A	0	0	0	0	0	0	0	0
21:14966851:G:C	0	0	0	0	0	0	0	0
21:14967968:C:T	0	0	0	0	0	0	0	0
21:17518892:A:G	0	0	0	0	0	0	0	0
21:18398245:T:C	0	0	0	0	0	0	0	0
21:19244974:G:T	0	0	0	0	0	0	0	0
21:25592836:G:A	10	8	18	2	16	1.0	0.0	1.0
21:25592893:T:C	11	8	16	3	13	1	0	1
21:25597391:T:C	19	14	37	19	18	1	0	1
21:25606638:A:G	74	38	93	50	43	1.0	0.5	1.0
21:26468474:G:A	0	0	0	0	0	0	0	0
21:26468541:C:T	0	0	0	0	0	0	0	0
21:26480405:A:G	0	0	0	0	0	0	0	0
21:26840441:G:A	0	0	0	0	0	0	0	0
21:26843747:C:T	0	0	0	0	0	0	0	0
21:26844373:G:T	0	0	0	0	0	0	0	0
21:26965979:C:G	0	0	0	0	0	0	0	0
21:26966104:C:G	0	0	0	0	0	0	0	0
21:27420640:C:T	0	0	0	0	0	0	0	0
21:27421008:C:T	0	0	0	0	0	0	0	0
21:28883025:C:A	64	35	83	34	49	1.0	0.0	1.0
21:28887877:T:C	0	0	0	0	0	0	0	0
21:28966798:C:A	3	1	3	2	1	1	1	0
21:29034887:G:A	86	45	104	51	53	1.0	0.0	1.0
21:29036349:A:T	24	10	60	27	33	1.5	1.0	0.0
21:29326696:C:T	2	2	2	0	2	1.0	0.0	1.0
21:29342455:T:C	5	2	16	12	4	2	2	0
21:30289373:A:G	0	0	0	0	0	0	0	0
21:30337373:G:A	0	0	0	0	0	0	0	0
21:30371809:A:T	0	0	0	0	0	0	0	0
21:30501922:TG:CT	0	0	0	0	0	0	0	0
21:30541681:T:A	0	0	0	0	0	0	0	0
21:30592597:A:C	0	0	0	0	0	0	0	0
21:30881310:C:T	0	0	0	0	0	0	0	0
21:31038363:G:A	0	0	0	0	0	0	0	0
21:31452777:G:T	0	0	0	0	0	0	0	0
21:31452787:A:G	0	0	0	0	0	0	0	0
21:31995875:T:C	0	0	0	0	0	0	0	0
21:32321914:C:G	2	1	3	2	1	1.5	1.0	0.5
21:32347386:C:T	0	0	0	0	0	0	0	0
21:32377224:A:C	0	0	0	0	0	0	0	0
21:32383454:G:A	0	0	0	0	0	0	0	0
21:32794032:C:T	0	0	0	0	0	0	0	0
21:33241950:T:G	532	326	2077	778	1299	3.0	0.0	1.0
21:33268483:A:G	564	316	2503	1116	1387	4.0	0.0	1.0
21:33294071:A:G	5	2	25	23	2	5	5	0
21:33296442:A:G	38	13	134	88	46	3.0	1.0	0.0
21:33432659:T:C	20	8	35	22	13	1.0	1.0	0.0
21:33524806:C:T	9	5	11	5	6	1	0	1
21:33553954:C:T	57	34	70	30	40	1	0	1
21:33573415:T:C	58	25	92	56	36	1.0	1.0	0.0
21:33888177:T:C	0	0	0	0	0	0	0	0
21:34716366:A:G	0	0	0	0	0	0	0	0
21:36016532:T:C	0	0	0	0	0	0	0	0
21:36038179:T:C	1	1	1	0	1	1	0	1
21:36072399:G:A	1	1	1	0	1	1	0	1
21:36130652:G:T	22	3	24	21	3	1.0	1.0	0.0
21:36130724:C:T	13	0	14	14	0	1	1	0
21:36130748:G:C	8	0	8	8	0	1.0	1.0	0.0
21:36146284:G:A	8	2	15	13	2	1.0	1.0	0.0
21:36146408:G:A	4	2	12	8	4	2.5	1.0	0.5
21:36169681:C:G	0	0	0	0	0	0	0	0
21:36292203:G:A	25	15	33	12	21	1	0	1
21:36362142:G:A	1	0	1	1	0	1	1	0
21:36387659:C:T	7	5	7	2	5	1	0	1
21:36461453:G:A	0	0	0	0	0	0	0	0
21:36486624:A:G	0	0	0	0	0	0	0	0
21:37191385:G:C	94	46	117	61	56	1.0	1.0	0.0
21:37221271:C:G	3	2	5	1	4	1	0	1
21:37952931:C:T	0	0	0	0	0	0	0	0
21:39127709:G:A	0	0	0	0	0	0	0	0
21:39127809:G:T	0	0	0	0	0	0	0	0
21:39177540:T:C	1	0	1	1	0	1	1	0
21:39202379:A:G	8	6	13	7	6	1.0	0.0	1.0
21:39298534:G:C	156	81	214	109	105	1.0	0.0	1.0
21:39314094:C:T	2	1	2	1	1	1.0	0.5	0.5
21:39314152:G:C	1	0	1	1	0	1	1	0
21:39499884:T:C	1	0	1	1	0	1	1	0
21:39765580:G:C	0	0	0	0	0	0	0	0
21:39793535:C:A	0	0	0	0	0	0	0	0
21:39926067:C:T	0	0	0	0	0	0	0	0
21:41322943:G:A	0	0	0	0	0	0	0	0
21:41377862:G:A	28	14	34	18	16	1.0	0.5	0.5
21:41449186:T:C	15	5	17	12	5	1	1	0
21:41452806:G:A	8	3	11	8	3	1.0	1.0	0.0
21:41473447:G:A	0	0	0	0	0	0	0	0
21:41480570:C:T	0	0	0	0	0	0	0	0
21:41741645:G:A	0	0	0	0	0	0	0	0
21:41749197:C:G	0	0	0	0	0	0	0	0
21:41756639:T:G	0	0	0	0	0	0	0	0
21:41756672:A:G	0	0	0	0	0	0	0	0
21:41819616:A:G	0	0	0	0	0	0	0	0
21:41836143:C:T	3	1	5	4	1	1	1	0
21:41847151:C:T	1	0	1	1	0	1	1	0
21:41861658:C:A	0	0	0	0	0	0	0	0
21:41907747:A:G	0	0	0	0	0	0	0	0
21:41993622:C:T	0	0	0	0	0	0	0	0
21:42084118:T:C	0	0	0	0	0	0	0	0
21:42103744:G:C	0	0	0	0	0	0	0	0
21:42119183:G:A	0	0	0	0	0	0	0	0
21:42127763:G:A	0	0	0	0	0	0	0	0
21:42346451:G:A	0	0	0	0	0	0	0	0
21:42372556:T:C	0	0	0	0	0	0	0	0
21:42389975:C:T	0	0	0	0	0	0	0	0
21:42418534:G:A	0	0	0	0	0	0	0	0
21:42476033:C:T	0	0	0	0	0	0	0	0
21:43791051:G:A	0	0	0	0	0	0	0	0
21:43797678:T:C	7	5	9	2	7	1	0	1
21:44288394:C:T	0	0	0	0	0	0	0	0
21:44573942:C:T	0	0	0	0	0	0	0	0
21:44573974:T:C	0	0	0	0	0	0	0	0
21:44579839:T:C	0	0	0	0	0	0	0	0
21:44579876:G:C	0	0	0	0	0	0	0	0
21:44580407:G:A	0	0	0	0	0	0	0	0
21:44580521:C:T	0	0	0	0	0	0	0	0
21:44627501:C:T	0	0	0	0	0	0	0	0
21:44627716:A:G	0	0	0	0	0	0	0	0
21:44627793:T:C	0	0	0	0	0	0	0	0
21:44627940:C:T	0	0	0	0	0	0	0	0
21:44637474:AGT:GGA	0	0	0	0	0	0	0	0
21:44637500:AGCCCT:CCCCCA	0	0	0	0	0	0	0	0
21:44637631:A:C	0	0	0	0	0	0	0	0
21:44637794:G:C	0	0	0	0	0	0	0	0
21:44637803:A:C	0	0	0	0	0	0	0	0
21:44637889:G:A	0	0	0	0	0	0	0	0
21:44638041:C:T	0	0	0	0	0	0	0	0
21:44646847:C:T	0	0	0	0	0	0	0	0
21:44647263:C:T	0	0	0	0	0	0	0	0
21:44676314:A:G	0	0	0	0	0	0	0	0
21:44676814:A:G	0	0	0	0	0	0	0	0
21:44677087:A:C	0	0	0	0	0	0	0	0
21:44678005:A:G	0	0	0	0	0	0	0	0
21:44682024:C:T	0	0	0	0	0	0	0	0
21:44682100:C:T	0	0	0	0	0	0	0	0
21:44702416:A:C	0	0	0	0	0	0	0	0
21:44888835:C:A	25	12	36	17	19	1	1	0
21:44891863:C:T	20	11	23	12	11	1.0	0.0	1.0
21:45222053:G:A	0	0	0	0	0	0	0	0
21:45282907:A:G	0	0	0	0	0	0	0	0
21:45285706:G:A	23	13	24	11	13	1	0	1
21:45456259:C:T	0	0	0	0	0	0	0	0
21:45512414:G:A	0	0	0	0	0	0	0	0
21:45531642:A:G	0	0	0	0	0	0	0	0
21:45909438:T:C	0	0	0	0	0	0	0	0
21:45991017:T:C	0	0	0	0	0	0	0	0
21:45999606:G:A	0	0	0	0	0	0	0	0
21:46000847:G:A	0	0	0	0	0	0	0	0
21:46002498:C:T	0	0	0	0	0	0	0	0
21:46003593:G:A	0	0	0	0	0	0	0	0
21:46003595:C:T	0	0	0	0	0	0	0	0
21:46003722:C:T	0	0	0	0	0	0	0	0
21:46119046:G:A	0	0	0	0	0	0	0	0
21:46132216:A:G	1	0	1	1	0	1	1	0
21:46136879:C:T	1	0	2	2	0	2	2	0
21:46136895:C:T	1	0	2	2	0	2	2	0
21:46138559:G:C	0	0	0	0	0	0	0	0
21:46188666:G:A	0	0	0	0	0	0	0	0
21:46189664:A:G	6	4	7	3	4	1.0	0.0	1.0
21:46194529:A:G	2	0	2	2	0	1.0	1.0	0.0
21:46246418:A:G	4	2	4	2	2	1.0	0.5	0.5
21:46246830:G:T	13	5	13	8	5	1	1	0
21:46272617:T:C	5	2	8	5	3	1	1	0
21:46324213:G:T	17	7	75	47	28	3	1	0
21:46346199:T:G	6	4	20	6	14	2.5	0.0	1.5
21:46353263:C:T	0	0	0	0	0	0	0	0
21:46357148:G:A	5	5	6	0	6	1	0	1
21:46366609:A:G	1	1	1	0	1	1	0	1
21:46366902:C:G	2	1	2	1	1	1.0	0.5	0.5
21:46367087:T:C	1	0	1	1	0	1	1	0
21:46388764:C:T	2	0	3	3	0	1.5	1.5	0.0
21:46411395:G:A	2	2	2	0	2	1.0	0.0	1.0
21:46411595:A:G	0	0	0	0	0	0	0	0
21:46411704:CGAC:TGAT	1	1	1	0	1	1	0	1
21:46411931:G:A	0	0	0	0	0	0	0	0
21:46416208:T:C	11	4	55	34	21	5	2	0
21:46416292:A:C	7	2	39	25	14	7	1	0
21:46416302:A:G	7	2	38	25	13	6	1	0
21:46416481:T:G	0	0	0	0	0	0	0	0
21:46418209:A:G	3	1	4	2	2	1	1	0
21:46422019:T:C	1	1	1	0	1	1	0	1
21:46422027:A:G	1	1	1	0	1	1	0	1
21:46422075:C:T	1	1	1	0	1	1	0	1
21:46427786:C:T	2	1	2	1	1	1.0	0.5	0.5
21:46428436:G:A	1	0	1	1	0	1	1	0
21:46428545:G:A	2	0	2	2	0	1.0	1.0	0.0
21:46430570:G:C	1	1	1	0	1	1	0	1
21:46431882:G:A	2	1	3	2	1	1.5	1.0	0.5
21:46435963:A:G	1	0	1	1	0	1	1	0
21:46643564:C:G	749	392	1131	611	520	1	1	1
22:15562588:T:C	0	0	0	0	0	0	0	0
22:15562606:C:A	0	0	0	0	0	0	0	0
22:15613040:G:T	0	0	0	0	0	0	0	0
22:16574568:G:A	0	0	0	0	0	0	0	0
22:16692122:C:T	0	0	0	0	0	0	0	0
22:16694664:G:A	0	0	0	0	0	0	0	0
22:16695138:G:T	0	0	0	0	0	0	0	0
22:16784234:A:C	0	0	0	0	0	0	0	0
22:16857797:C:G	0	0	0	0	0	0	0	0
22:16857817:G:T	0	0	0	0	0	0	0	0
22:16858514:G:A	0	0	0	0	0	0	0	0
22:16858862:G:A	0	0	0	0	0	0	0	0
22:16859779:C:T	0	0	0	0	0	0	0	0
22:16933750:G:A	0	0	0	0	0	0	0	0
22:16965267:G:T	0	0	0	0	0	0	0	0
22:16970039:C:T	0	0	0	0	0	0	0	0
22:16970062:A:G	0	0	0	0	0	0	0	0
22:16988136:G:A	0	0	0	0	0	0	0	0
22:17181903:A:G	15	4	15	11	4	1	1	0
22:17188416:T:C	84	46	292	139	153	2.0	0.0	1.0
22:17199629:A:C	0	0	0	0	0	0	0	0
22:17209519:G:A	192	97	236	122	114	1.0	1.0	1.0
22:17209540:C:G	199	100	243	123	120	1	1	1
22:17541915:C:T	1	1	4	0	4	4	0	4
22:17872794:G:A	1	0	4	4	0	4	4	0
22:18167915:C:T	2	0	2	2	0	1.0	1.0	0.0
22:18370631:G:A	0	0	0	0	0	0	0	0
22:19911314:A:G	0	0	0	0	0	0	0	0
22:19919576:C:A	154	78	257	114	143	1.0	1.0	1.0
22:19919595:G:A	145	74	239	106	133	1	1	1
22:20483768:T:C	1	1	1	0	1	1	0	1
22:20667992:C:T	1	1	1	0	1	1	0	1
22:20690560:A:T	0	0	0	0	0	0	0	0
22:20712501:A:G	17	6	21	13	8	1	1	0
22:20733858:C:G	0	0	0	0	0	0	0	0
22:20787012:T:C	0	0	0	0	0	0	0	0
22:20859092:C:T	32	18	32	14	18	1.0	0.0	1.0
22:20859128:A:G	70	35	71	36	35	1.0	0.5	0.5
22:20995387:TC:AT	0	0	0	0	0	0	0	0
22:21000681:C:G	48	30	48	18	30	1.0	0.0	1.0
22:21023012:C:A	0	0	0	0	0	0	0	0
22:21183757:T:C	0	0	0	0	0	0	0	0
22:21629916:A:G	364	176	505	281	224	1.0	1.0	0.0
22:21671036:C:T	182	87	270	138	132	1.0	1.0	0.0
22:21957943:C:T	2	0	2	2	0	1.0	1.0	0.0
22:22196163:T:C	29	21	138	24	114	2	0	1
22:22215164:C:A	0	0	0	0	0	0	0	0
22:22306953:T:C	158	70	294	163	131	1.0	1.0	0.0
22:22369973:A:C	218	1	303	302	1	1.0	1.0	0.0
22:22915911:G:A	40	40	95	0	95	2.0	0.0	2.0
22:22919684:A:G	1	0	1	1	0	1	1	0
22:22922692:A:T	23	23	31	0	31	1	0	1
22:23765479:C:T	0	0	0	0	0	0	0	0
22:23895276:T:C	0	0	0	0	0	0	0	0
22:24183081:G:A	1	0	1	1	0	1	1	0
22:24183251:G:A	1	0	1	1	0	1	1	0
22:24687181:A:C	0	0	0	0	0	0	0	0
22:24687203:G:A	0	0	0	0	0	0	0	0
22:24687487:G:A	0	0	0	0	0	0	0	0
22:24687705:A:G	0	0	0	0	0	0	0	0
22:24687730:G:A	0	0	0	0	0	0	0	0
22:24687947:C:T	0	0	0	0	0	0	0	0
22:24748945:C:T	0	0	0	0	0	0	0	0
22:24749504:A:G	0	0	0	0	0	0	0	0
22:25041390:G:A	0	0	0	0	0	0	0	0
22:25174306:G:A	0	0	0	0	0	0	0	0
22:25181766:T:C	0	0	0	0	0	0	0	0
22:25203882:G:A	0	0	0	0	0	0	0	0
22:25205229:C:G	0	0	0	0	0	0	0	0
22:26466075:G:A	1	1	1	0	1	1	0	1
22:26536184:G:A	1	1	1	0	1	1	0	1
22:26540931:G:A	11	5	39	17	22	2	1	0
22:27982484:A:G	1	0	1	1	0	1	1	0
22:27993465:T:C	1	1	1	0	1	1	0	1
22:28029005:C:T	0	0	0	0	0	0	0	0
22:29263971:C:T	0	0	0	0	0	0	0	0
22:29311966:A:T	1	0	1	1	0	1	1	0
22:29489484:C:T	0	0	0	0	0	0	0	0
22:29489872:T:C	0	0	0	0	0	0	0	0
22:29512083:C:T	7	0	8	8	0	1	1	0
22:29517044:T:C	2	2	2	0	2	1.0	0.0	1.0
22:29517283:C:T	5	4	10	1	9	1	0	1
22:29564346:A:G	1	1	1	0	1	1	0	1
22:29570094:C:T	0	0	0	0	0	0	0	0
22:29802036:C:T	7	4	7	3	4	1	0	1
22:30622988:T:C	0	0	0	0	0	0	0	0
22:30906246:T:C	0	0	0	0	0	0	0	0
22:30937644:T:C	3	2	4	1	3	1	0	1
22:30958667:G:A	1	1	11	0	11	11	0	11
22:31095346:C:T	1	1	1	0	1	1	0	1
22:31105995:G:A	15	7	18	8	10	1	1	0
22:31713623:T:C	5	3	8	3	5	1	0	1
22:32191036:CGTGG:GGTGC	0	0	0	0	0	0	0	0
22:32193036:C:T	0	0	0	0	0	0	0	0
22:32193047:T:C	0	0	0	0	0	0	0	0
22:32193103:C:T	0	0	0	0	0	0	0	0
22:32194462:G:A	0	0	0	0	0	0	0	0
22:32272917:C:T	0	0	0	0	0	0	0	0
22:32363038:G:C	0	0	0	0	0	0	0	0
22:32395164:C:G	24	11	30	17	13	1.0	1.0	0.0
22:32435724:C:G	0	0	0	0	0	0	0	0
22:32479203:G:A	218	102	237	126	111	1.0	1.0	0.0
22:32491163:C:T	17	12	23	5	18	1	0	1
22:32857293:T:C	0	0	0	0	0	0	0	0
22:33274598:G:A	0	0	0	0	0	0	0	0
22:33604474:G:A	0	0	0	0	0	0	0	0
22:34589203:G:A	0	0	0	0	0	0	0	0
22:35264882:G:T	12	5	12	7	5	1.0	1.0	0.0
22:35502033:T:C	0	0	0	0	0	0	0	0
22:35610998:G:A	0	0	0	0	0	0	0	0
22:35611028:C:T	0	0	0	0	0	0	0	0
22:35727036:C:T	0	0	0	0	0	0	0	0
22:36141452:A:T	9	5	9	4	5	1	0	1
22:36141677:G:A	11	5	12	6	6	1	1	0
22:36160916:C:T	0	0	0	0	0	0	0	0
22:36191154:G:A	0	0	0	0	0	0	0	0
22:36191175:G:T	0	0	0	0	0	0	0	0
22:36191231:A:G	0	0	0	0	0	0	0	0
22:36191438:A:G	1	0	1	1	0	1	1	0
22:36191463:C:T	1	0	1	1	0	1	1	0
22:36191656:T:C	1	1	1	0	1	1	0	1
22:36195334:A:G	1	0	1	1	0	1	1	0
22:36227874:G:A	11	9	12	2	10	1	0	1
22:36233420:T:A	138	53	181	119	62	1.0	1.0	0.0
22:36288308:TGTGC:CGTGA	104	49	151	90	61	1.0	1.0	0.0
22:36292132:G:A	52	29	60	27	33	1.0	0.0	1.0
22:36861135:G:A	721	374	1044	535	509	1	1	1
22:36872215:C:T	0	0	0	0	0	0	0	0
22:36929791:C:T	2	1	3	1	2	1.5	0.5	1.0
22:37066886:G:A	0	0	0	0	0	0	0	0
22:37084757:C:T	0	0	0	0	0	0	0	0
22:37128579:G:T	0	0	0	0	0	0	0	0
22:37136401:G:A	0	0	0	0	0	0	0	0
22:37185382:G:C	2	1	4	1	3	2.0	0.5	1.5
22:37241613:G:C	3126	2736	19416	9980	9436	5.0	2.0	2.0
22:37282510:A:G	14	9	14	5	9	1.0	0.0	1.0
22:37282524:G:A	22	13	23	10	13	1.0	0.0	1.0
22:37303336:T:C	20	11	25	12	13	1.0	0.0	1.0
22:37374590:G:A	0	0	0	0	0	0	0	0
22:37510255:C:T	0	0	0	0	0	0	0	0
22:37568292:C:G	0	0	0	0	0	0	0	0
22:37701352:C:G	1	1	4	0	4	4	0	4
22:37723206:G:A	1	0	1	1	0	1	1	0
22:37725145:C:A	0	0	0	0	0	0	0	0
22:37733325:G:A	0	0	0	0	0	0	0	0
22:37734452:G:T	0	0	0	0	0	0	0	0
22:37768099:C:T	7	3	16	5	11	1	1	0
22:37809982:T:C	1	1	1	0	1	1	0	1
22:37855622:C:G	1412	856	2127	1043	1084	1.0	1.0	1.0
22:37927693:C:T	3	1	3	2	1	1	1	0
22:37945127:T:C	0	0	0	0	0	0	0	0
22:38067645:T:G	0	0	0	0	0	0	0	0
22:38071777:G:C	0	0	0	0	0	0	0	0
22:38074923:G:A	4	2	19	12	7	3.5	0.5	0.5
22:38426900:C:T	0	0	0	0	0	0	0	0
22:38481456:T:G	2	1	2	1	1	1.0	0.5	0.5
22:38673176:T:C	16	7	43	24	19	2.0	1.0	0.0
22:38782696:A:G	195	110	234	107	127	1	0	1
22:38826647:G:A	0	0	0	0	0	0	0	0
22:39044144:C:T	12	3	18	12	6	1.0	1.0	0.0
22:39045198:C:T	5	2	5	3	2	1	1	0
22:39049549:G:A	5	1	5	4	1	1	1	0
22:39052706:C:A	17	13	40	9	31	1	0	1
22:39517552:G:A	1	0	1	1	0	1	1	0
22:39662181:A:G	0	0	0	0	0	0	0	0
22:40021776:C:T	0	0	0	0	0	0	0	0
22:40021816:A:G	0	0	0	0	0	0	0	0
22:40156115:G:A	266	137	344	170	174	1.0	1.0	1.0
22:40679539:A:G	0	0	0	0	0	0	0	0
22:40679691:C:T	0	0	0	0	0	0	0	0
22:40827186:C:T	168	80	231	128	103	1.0	1.0	0.0
22:41064485:C:T	15	0	15	15	0	1	1	0
22:41074518:G:A	1	0	3	3	0	3	3	0
22:41075062:T:C	1	0	1	1	0	1	1	0
22:41152004:A:G	8	5	8	3	5	1.0	0.0	1.0
22:41155035:T:A	12	6	13	7	6	1.0	0.5	0.5
22:41189789:T:G	1	1	5	0	5	5	0	5
22:41214020:G:A	22	7	23	16	7	1.0	1.0	0.0
22:41217184:C:T	1	1	1	0	1	1	0	1
22:41256729:G:A	2	0	6	6	0	3.0	3.0	0.0
22:41330049:G:A	4	0	15	15	0	3.0	3.0	0.0
22:41356743:G:A	8	3	8	5	3	1.0	1.0	0.0
22:41437112:C:T	1	0	1	1	0	1	1	0
22:41578851:C:T	15	6	17	10	7	1	1	0
22:41676908:C:A	30	18	88	31	57	2.0	0.0	1.0
22:41699654:T:G	0	0	0	0	0	0	0	0
22:41763225:G:T	0	0	0	0	0	0	0	0
22:41940168:G:A	15	6	18	12	6	1	1	0
22:41958385:A:C	0	0	0	0	0	0	0	0
22:42020052:A:G	2	0	2	2	0	1.0	1.0	0.0
22:42032723:A:T	1	1	2	0	2	2	0	2
22:42077599:C:T	0	0	0	0	0	0	0	0
22:42141587:G:A	4	2	9	3	6	2.0	0.5	1.0
22:42142507:AG:GA	3	3	10	0	10	4	0	4
22:42151238:C:T	1	1	1	0	1	1	0	1
22:42152103:A:G	0	0	0	0	0	0	0	0
22:42152187:A:G	0	0	0	0	0	0	0	0
22:42153154:A:G	1	1	2	0	2	2	0	2
22:42213142:T:C	0	0	0	0	0	0	0	0
22:42574026:T:C	3	1	5	3	2	2	1	0
22:42575981:T:C	14	7	27	19	8	1.0	0.5	0.5
22:42636736:C:T	1907	1236	3807	1873	1934	1	1	1
22:42636864:G:T	1	0	3	3	0	3	3	0
22:42692965:C:T	0	0	0	0	0	0	0	0
22:42693843:T:C	0	0	0	0	0	0	0	0
22:42776483:G:A	1	1	1	0	1	1	0	1
22:42893467:G:A	69	38	73	33	40	1	0	1
22:43133308:G:C	2	2	4	0	4	2.0	0.0	2.0
22:43169849:C:T	0	0	0	0	0	0	0	0
22:43180898:G:A	7	1	7	6	1	1	1	0
22:43218310:C:G	0	0	0	0	0	0	0	0
22:43435076:C:T	0	0	0	0	0	0	0	0
22:43435136:C:T	0	0	0	0	0	0	0	0
22:43928847:CCCC:GCCT	0	0	0	0	0	0	0	0
22:43946236:A:G	0	0	0	0	0	0	0	0
22:43976752:C:T	16	11	19	6	13	1.0	0.0	1.0
22:43983942:T:C	7	5	10	2	8	1	0	1
22:43983958:A:G	8	6	11	2	9	1.0	0.0	1.0
22:43999571:T:C	0	0	0	0	0	0	0	0
22:44093988:T:C	571	327	1022	452	570	1	0	1
22:44094016:T:C	564	316	1010	470	540	1.0	1.0	1.0
22:44679858:T:C	0	0	0	0	0	0	0	0
22:44825543:A:T	0	0	0	0	0	0	0	0
22:44849050:C:T	0	0	0	0	0	0	0	0
22:45211974:G:A	12	4	13	9	4	1.0	1.0	0.0
22:45289121:A:G	0	0	0	0	0	0	0	0
22:45417807:G:A	0	0	0	0	0	0	0	0
22:45426029:C:T	0	0	0	0	0	0	0	0
22:45426055:G:A	0	0	0	0	0	0	0	0
22:45426076:C:G	0	0	0	0	0	0	0	0
22:45502250:A:T	0	0	0	0	0	0	0	0
22:45535382:C:T	0	0	0	0	0	0	0	0
22:45541269:C:T	0	0	0	0	0	0	0	0
22:46097972:C:T	16	8	34	18	16	1.0	0.5	0.5
22:46103240:G:C	5	3	6	3	3	1	0	1
22:46274049:A:G	18	4	20	16	4	1.0	1.0	0.0
22:46398608:G:A	4	1	8	6	2	2.0	1.5	0.0
22:46793781:C:G	20	8	23	14	9	1.0	1.0	0.0
22:46913351:C:T	7	2	20	16	4	3	2	0
22:46915588:G:A	0	0	0	0	0	0	0	0
22:47461788:T:C	0	0	0	0	0	0	0	0
22:47461802:T:G	0	0	0	0	0	0	0	0
22:49441098:C:T	2	0	3	3	0	1.5	1.5	0.0
22:49794101:G:A	7	3	10	7	3	1	1	0
22:49884994:C:T	0	0	0	0	0	0	0	0
22:49903787:T:C	8	4	8	4	4	1.0	0.5	0.5
22:49904240:T:C	3	3	10	0	10	3	0	3
22:49907828:T:C	5	2	8	6	2	1	1	0
22:49923401:T:C	2	1	10	1	9	5.0	0.5	4.5
22:49925522:A:G	96	3	145	142	3	1.0	1.0	0.0
22:50061535:T:C	0	0	0	0	0	0	0	0
22:50064097:A:G	0	0	0	0	0	0	0	0
22:50064115:G:A	0	0	0	0	0	0	0	0
22:50076841:TGAG:CGAA	0	0	0	0	0	0	0	0
22:50077414:C:A	0	0	0	0	0	0	0	0
22:50092072:A:T	0	0	0	0	0	0	0	0
22:50099472:C:T	0	0	0	0	0	0	0	0
22:50108237:C:T	0	0	0	0	0	0	0	0
22:50117257:A:C	0	0	0	0	0	0	0	0
22:50145772:A:C	0	0	0	0	0	0	0	0
22:50150767:C:A	0	0	0	0	0	0	0	0
22:50219995:T:C	7	4	13	3	10	1	0	1
22:50221169:C:T	10	5	10	5	5	1.0	0.5	0.5
22:50248899:C:A	0	0	0	0	0	0	0	0
22:50249166:A:G	17	13	23	4	19	1	0	1
22:50249919:A:G	94	47	202	90	112	1.0	1.0	0.5
22:50255460:G:A	0	0	0	0	0	0	0	0
22:50255868:A:G	0	0	0	0	0	0	0	0
22:50280822:A:G	0	0	0	0	0	0	0	0
22:50316219:T:C	0	0	0	0	0	0	0	0
22:50318919:G:A	0	0	0	0	0	0	0	0
22:50319041:T:C	0	0	0	0	0	0	0	0
22:50505734:G:A	12	4	14	9	5	1.0	1.0	0.0
22:50506827:A:G	339	169	446	238	208	1	1	0
22:50523779:T:G	13	7	30	13	17	1	0	1
22:50524353:C:G	294	165	1281	611	670	4.0	0.0	1.0
22:50528485:T:C	3	0	3	3	0	1	1	0
22:50530509:C:T	119	48	409	230	179	3	1	0
22:50571524:C:T	31	13	126	71	55	3	1	0
22:50582239:C:A	44	28	135	52	83	3.0	0.0	1.0
22:50604850:G:A	0	0	0	0	0	0	0	0
22:50625611:G:C	5	2	7	5	2	1	1	0
22:50714943:G:A	0	0	0	0	0	0	0	0
22:50754799:T:G	0	0	0	0	0	0	0	0
X:284193:T:C	6	3	6	3	3	1.0	0.5	0.5
X:290695:C:T	9	5	15	10	5	1	0	1
X:312225:C:A	6	4	10	6	4	1.0	0.0	1.0
X:312309:G:C	5	3	6	2	4	1	0	1
X:312875:G:A	13	3	17	13	4	1	1	0
X:338766:C:T	0	0	0	0	0	0	0	0
X:342008:G:A	1	1	1	0	1	1	0	1
X:644627:G:A	0	0	0	0	0	0	0	0
X:658808:G:A	0	0	0	0	0	0	0	0
X:1212602:G:C	0	0	0	0	0	0	0	0
X:1303975:G:A	0	0	0	0	0	0	0	0
X:1348511:A:C	3	3	9	0	9	2	0	2
X:1389431:G:A	322	174	367	178	189	1.0	0.0	1.0
X:1412872:C:G	5	5	5	0	5	1	0	1
X:1418988:C:T	12	4	14	10	4	1.0	1.0	0.0
X:1419060:C:T	10	9	14	1	13	1.0	0.0	1.0
X:1421813:A:G	5	3	17	14	3	1	0	1
X:1427899:G:A	10	2	10	8	2	1.0	1.0	0.0
X:1427949:A:G	7	4	10	3	7	1	0	1
X:1427983:A:G	8	3	11	8	3	1.0	1.0	0.0
X:1623288:G:A	0	0	0	0	0	0	0	0
X:2691676:G:T	11	5	20	10	10	1	1	0
X:2691942:T:C	0	0	0	0	0	0	0	0
X:2714441:C:T	1455	1055	2404	914	1490	1	0	1
X:2782116:G:A	0	0	0	0	0	0	0	0
X:2859944:C:T	0	0	0	0	0	0	0	0
X:2861529:A:G	0	0	0	0	0	0	0	0
X:2914701:G:C	0	0	0	0	0	0	0	0
X:2917996:G:C	0	0	0	0	0	0	0	0
X:2938114:C:T	0	0	0	0	0	0	0	0
X:3277068:C:T	0	0	0	0	0	0	0	0
X:3310055:C:T	0	0	0	0	0	0	0	0
X:3310103:C:G	0	0	0	0	0	0	0	0
X:3674684:G:A	47	12	63	46	17	1	1	0
X:3817691:G:A	5	3	5	2	3	1	0	1
X:3829331:C:T	9	9	9	0	9	1	0	1
X:3937738:T:C	0	0	0	0	0	0	0	0
X:5890830:A:C	0	0	0	0	0	0	0	0
X:5903745:G:A	0	0	0	0	0	0	0	0
X:8466326:C:T	0	0	0	0	0	0	0	0
X:9895072:A:G	0	0	0	0	0	0	0	0
X:11298622:C:T	0	0	0	0	0	0	0	0
X:13318940:C:T	0	0	0	0	0	0	0	0
X:13318996:C:T	0	0	0	0	0	0	0	0
X:13378884:C:T	1	0	4	4	0	4	4	0
X:14244742:G:A	1	1	1	0	1	1	0	1
X:14609022:T:C	0	0	0	0	0	0	0	0
X:14834643:G:C	0	0	0	0	0	0	0	0
X:15820243:C:T	29	18	39	15	24	1	0	1
X:16150344:T:C	0	0	0	0	0	0	0	0
X:16150554:T:C	0	0	0	0	0	0	0	0
X:16198933:A:G	0	0	0	0	0	0	0	0
X:16841505:G:A	10	4	10	6	4	1.0	1.0	0.0
X:16869532:C:T	70	65	84	6	78	1.0	0.0	1.0
X:18177591:C:T	0	0	0	0	0	0	0	0
X:18212595:A:C	0	0	0	0	0	0	0	0
X:18323914:G:A	0	0	0	0	0	0	0	0
X:19464358:C:T	0	0	0	0	0	0	0	0
X:20052928:T:C	0	0	0	0	0	0	0	0
X:20186343:G:T	20	20	64	0	64	2.5	0.0	2.5
X:22273489:C:A	0	0	0	0	0	0	0	0
X:22273615:C:T	0	0	0	0	0	0	0	0
X:23380097:T:C	0	0	0	0	0	0	0	0
X:23704718:A:G	7	7	7	0	7	1	0	1
X:24057745:A:G	828	585	1077	349	728	1.0	0.0	1.0
X:24363270:G:C	0	0	0	0	0	0	0	0
X:24364833:G:A	0	0	0	0	0	0	0	0
X:25029576:C:T	0	0	0	0	0	0	0	0
X:25646046:T:C	2	2	2	0	2	1.0	0.0	1.0
X:26139103:C:T	0	0	0	0	0	0	0	0
X:26139675:C:T	0	0	0	0	0	0	0	0
X:26161415:A:G	0	0	0	0	0	0	0	0
X:27461222:A:G	0	0	0	0	0	0	0	0
X:27747928:A:G	0	0	0	0	0	0	0	0
X:27748659:G:A	0	0	0	0	0	0	0	0
X:27821455:T:C	0	0	0	0	0	0	0	0
X:27821500:G:A	0	0	0	0	0	0	0	0
X:30218796:G:A	0	0	0	0	0	0	0	0
X:30218886:C:T	0	0	0	0	0	0	0	0
X:30242885:A:G	0	0	0	0	0	0	0	0
X:30243041:G:C	0	0	0	0	0	0	0	0
X:31679519:A:G	0	0	0	0	0	0	0	0
X:32362879:C:T	0	0	0	0	0	0	0	0
X:32485077:T:C	0	0	0	0	0	0	0	0
X:33041544:C:T	71	71	75	0	75	1	0	1
X:34147284:C:G	0	0	0	0	0	0	0	0
X:34656853:C:G	0	0	0	0	0	0	0	0
X:35802308:C:T	0	0	0	0	0	0	0	0
X:35802579:G:A	0	0	0	0	0	0	0	0
X:35802678:A:G	0	0	0	0	0	0	0	0
X:35803010:C:T	0	0	0	0	0	0	0	0
X:37990887:G:C	0	0	0	0	0	0	0	0
X:38073633:A:G	0	0	0	0	0	0	0	0
X:38108615:T:C	0	0	0	0	0	0	0	0
X:38160099:G:A	0	0	0	0	0	0	0	0
X:38161035:G:A	0	0	0	0	0	0	0	0
X:38299037:C:T	0	0	0	0	0	0	0	0
X:38367350:A:G	0	0	0	0	0	0	0	0
X:40073654:T:C	5	5	5	0	5	1	0	1
X:40591333:C:G	244	241	277	3	274	1.0	0.0	1.0
X:40597709:G:C	0	0	0	0	0	0	0	0
X:42098805:G:C	0	0	0	0	0	0	0	0
X:45983630:G:T	0	0	0	0	0	0	0	0
X:45983653:G:A	0	0	0	0	0	0	0	0
X:45983802:C:T	0	0	0	0	0	0	0	0
X:45983812:G:C	0	0	0	0	0	0	0	0
X:45983948:G:A	0	0	0	0	0	0	0	0
X:45984023:C:T	0	0	0	0	0	0	0	0
X:47448825:A:C	2	2	2	0	2	1.0	0.0	1.0
X:47448984:C:T	1	1	1	0	1	1	0	1
X:47624401:G:A	7	1	11	10	1	1	1	0
X:47803573:T:G	1	1	1	0	1	1	0	1
X:47803801:G:A	0	0	0	0	0	0	0	0
X:47841382:G:A	0	0	0	0	0	0	0	0
X:47841566:T:C	19	19	19	0	19	1	0	1
X:48266363:T:C	0	0	0	0	0	0	0	0
X:48296829:G:A	0	0	0	0	0	0	0	0
X:48301679:G:A	0	0	0	0	0	0	0	0
X:48301754:A:G	0	0	0	0	0	0	0	0
X:48303670:A:G	0	0	0	0	0	0	0	0
X:48304282:C:T	0	0	0	0	0	0	0	0
X:48894188:G:A	1120	5	1539	1534	5	1.0	1.0	0.0
X:48911594:G:T	12	0	48	48	0	2.5	2.5	0.0
X:48991085:T:C	8	0	12	12	0	1.0	1.0	0.0
X:49077625:C:A	5	0	5	5	0	1	1	0
X:49248248:C:T	14	0	15	15	0	1.0	1.0	0.0
X:51333166:C:T	0	0	0	0	0	0	0	0
X:53422619:G:A	48	11	62	44	18	1.0	1.0	0.0
X:53430674:C:T	1	1	1	0	1	1	0	1
X:53614686:T:C	7	0	14	14	0	1	1	0
X:55160988:G:A	29	29	44	0	44	1	0	1
X:55452866:G:A	9	9	9	0	9	1	0	1
X:55961502:G:A	1	0	2	2	0	2	2	0
X:57286924:T:C	18	18	20	0	20	1.0	0.0	1.0
X:57286949:C:T	20	20	22	0	22	1.0	0.0	1.0
X:57392766:C:T	0	0	0	0	0	0	0	0
X:57393245:C:A	0	0	0	0	0	0	0	0
X:57394129:A:G	0	0	0	0	0	0	0	0
X:57394767:G:A	0	0	0	0	0	0	0	0
X:57394875:G:A	0	0	0	0	0	0	0	0
X:57448699:T:C	5	0	6	6	0	1	1	0
X:66162843:T:C	0	0	0	0	0	0	0	0
X:66207198:T:C	0	0	0	0	0	0	0	0
X:66207282:A:G	0	0	0	0	0	0	0	0
X:69161944:C:T	7	0	7	7	0	1	1	0
X:69162918:C:T	145	145	150	0	150	1	0	1
X:69162993:G:A	246	0	255	255	0	1.0	1.0	0.0
X:70259092:T:G	0	0	0	0	0	0	0	0
X:70330248:T:C	0	0	0	0	0	0	0	0
X:70926625:G:C	0	0	0	0	0	0	0	0
X:70928221:G:A	0	0	0	0	0	0	0	0
X:71665966:C:T	0	0	0	0	0	0	0	0
X:71666574:C:T	0	0	0	0	0	0	0	0
X:71872554:A:C	0	0	0	0	0	0	0	0
X:72129903:G:A	0	0	0	0	0	0	0	0
X:72129924:T:C	0	0	0	0	0	0	0	0
X:72140354:A:G	0	0	0	0	0	0	0	0
X:72160003:C:T	54	0	54	54	0	1.0	1.0	0.0
X:72160031:G:A	57	0	57	57	0	1	1	0
X:72181757:G:A	6	6	6	0	6	1.0	0.0	1.0
X:72181764:C:A	16	16	16	0	16	1.0	0.0	1.0
X:72186451:T:C	1	0	1	1	0	1	1	0
X:72196871:C:T	811	2	1108	1106	2	1	1	0
X:72273841:C:T	1257	915	1994	688	1306	1	0	1
X:72329662:G:C	4	4	4	0	4	1.0	0.0	1.0
X:73844076:T:C	2	2	3	0	3	1.5	0.0	1.5
X:77682471:C:G	63	63	73	0	73	1	0	1
X:78763872:C:G	0	0	0	0	0	0	0	0
X:79171270:C:A	5	5	8	0	8	1	0	1
X:79171491:T:C	3	0	12	12	0	3	3	0
X:79323513:A:G	1	0	1	1	0	1	1	0
X:79323537:G:A	1	0	5	5	0	5	5	0
X:79323740:T:C	2	0	8	8	0	4.0	4.0	0.0
X:79324528:A:C	0	0	0	0	0	0	0	0
X:80443094:C:G	0	0	0	0	0	0	0	0
X:85964016:T:C	24	0	35	35	0	1.0	1.0	0.0
X:87425645:C:T	0	0	0	0	0	0	0	0
X:89922674:G:A	0	0	0	0	0	0	0	0
X:90112711:G:T	0	0	0	0	0	0	0	0
X:90112811:A:C	0	0	0	0	0	0	0	0
X:90113517:A:G	0	0	0	0	0	0	0	0
X:92460233:T:C	0	0	0	0	0	0	0	0
X:92676600:A:G	8	8	8	0	8	1.0	0.0	1.0
X:92676749:T:C	4	4	4	0	4	1.0	0.0	1.0
X:93222896:C:T	0	0	0	0	0	0	0	0
X:93288097:T:C	0	0	0	0	0	0	0	0
X:93288422:T:C	0	0	0	0	0	0	0	0
X:93672635:G:C	0	0	0	0	0	0	0	0
X:95974284:C:G	0	0	0	0	0	0	0	0
X:96884407:G:A	1	1	1	0	1	1	0	1
X:96884460:T:C	0	0	0	0	0	0	0	0
X:100635207:C:T	0	0	0	0	0	0	0	0
X:100987547:C:T	0	0	0	0	0	0	0	0
X:101140674:G:T	0	0	0	0	0	0	0	0
X:101235944:G:C	0	0	0	0	0	0	0	0
X:101277633:T:C	0	0	0	0	0	0	0	0
X:101490093:G:A	0	0	0	0	0	0	0	0
X:101841958:T:C	0	0	0	0	0	0	0	0
X:103500623:T:A	0	0	0	0	0	0	0	0
X:103587015:G:A	29	0	35	35	0	1	1	0
X:103587113:T:C	26	0	30	30	0	1.0	1.0	0.0
X:106978159:T:C	1	0	1	1	0	1	1	0
X:107070278:G:A	1	0	1	1	0	1	1	0
X:107132065:A:G	2	0	3	3	0	1.5	1.5	0.0
X:107153225:A:G	0	0	0	0	0	0	0	0
X:107429332:A:G	0	0	0	0	0	0	0	0
X:107794565:C:A	0	0	0	0	0	0	0	0
X:107840845:A:C	1	0	1	1	0	1	1	0
X:112455385:T:C	1	0	1	1	0	1	1	0
X:115190633:G:A	0	0	0	0	0	0	0	0
X:116108422:G:C	0	0	0	0	0	0	0	0
X:116437825:T:A	0	0	0	0	0	0	0	0
X:116694070:G:C	0	0	0	0	0	0	0	0
X:116963541:C:T	0	0	0	0	0	0	0	0
X:118387375:G:A	7	7	11	0	11	1	0	1
X:118394093:G:A	5	5	10	0	10	1	0	1
X:118394179:C:T	2	2	4	0	4	2.0	0.0	2.0
X:118432819:C:T	2	2	6	0	6	3.0	0.0	3.0
X:119379837:T:C	0	0	0	0	0	0	0	0
X:119544401:G:A	23	0	30	30	0	1	1	0
X:119759091:C:A	29	1	39	38	1	1	1	0
X:119759174:T:C	18	1	27	26	1	1.0	1.0	0.0
X:120875125:T:C	0	0	0	0	0	0	0	0
X:121204228:G:A	0	0	0	0	0	0	0	0
X:123117143:G:T	0	0	0	0	0	0	0	0
X:123514603:T:C	15	0	15	15	0	1	1	0
X:129746638:T:C	0	0	0	0	0	0	0	0
X:130013397:G:A	0	0	0	0	0	0	0	0
X:130149545:A:G	41	0	48	48	0	1	1	0
X:130495494:G:A	8	0	9	9	0	1.0	1.0	0.0
X:131084634:G:A	0	0	0	0	0	0	0	0
X:131274771:G:A	0	0	0	0	0	0	0	0
X:131276991:A:G	0	0	0	0	0	0	0	0
X:131281844:T:C	0	0	0	0	0	0	0	0
X:131544493:A:G	0	0	0	0	0	0	0	0
X:131544870:A:C	0	0	0	0	0	0	0	0
X:132055477:C:T	0	0	0	0	0	0	0	0
X:132078614:C:T	0	0	0	0	0	0	0	0
X:132094243:C:G	0	0	0	0	0	0	0	0
X:132100705:G:A	0	0	0	0	0	0	0	0
X:133027645:C:T	0	0	0	0	0	0	0	0
X:133303309:G:A	0	0	0	0	0	0	0	0
X:133304844:C:A	0	0	0	0	0	0	0	0
X:134566600:A:G	0	0	0	0	0	0	0	0
X:135022091:G:C	0	0	0	0	0	0	0	0
X:135051967:T:A	239	0	254	254	0	1	1	0
X:135360587:T:C	0	0	0	0	0	0	0	0
X:135434439:G:A	0	0	0	0	0	0	0	0
X:135435009:G:C	0	0	0	0	0	0	0	0
X:136345353:G:A	0	0	0	0	0	0	0	0
X:136874211:G:A	63	0	77	77	0	1	1	0
X:136874303:G:C	61	0	98	98	0	1	1	0
X:136874347:C:G	58	0	107	107	0	1.0	1.0	0.0
X:136876571:C:A	69	0	178	178	0	2	2	0
X:136877960:C:T	89	0	131	131	0	1	1	0
X:138985040:A:G	0	0	0	0	0	0	0	0
X:139551121:A:G	0	0	0	0	0	0	0	0
X:140713739:C:G	0	0	0	0	0	0	0	0
X:140784312:T:C	0	0	0	0	0	0	0	0
X:141626101:A:G	0	0	0	0	0	0	0	0
X:141626121:A:G	0	0	0	0	0	0	0	0
X:141895341:G:A	0	0	0	0	0	0	0	0
X:141906091:C:A	0	0	0	0	0	0	0	0
X:141906119:C:T	0	0	0	0	0	0	0	0
X:141906127:C:G	0	0	0	0	0	0	0	0
X:141906621:C:G	0	0	0	0	0	0	0	0
X:141906633:T:C	0	0	0	0	0	0	0	0
X:141906731:C:G	0	0	0	0	0	0	0	0
X:143712125:G:A	0	0	0	0	0	0	0	0
X:143884366:G:T	7	4	7	3	4	1	0	1
X:146620012:T:G	0	0	0	0	0	0	0	0
X:146620061:C:T	0	0	0	0	0	0	0	0
X:149534015:C:T	0	0	0	0	0	0	0	0
X:149716563:T:C	0	0	0	0	0	0	0	0
X:149884953:G:A	0	0	0	0	0	0	0	0
X:149946171:G:A	0	0	0	0	0	0	0	0
X:151181177:A:G	0	0	0	0	0	0	0	0
X:151923654:C:G	0	0	0	0	0	0	0	0
X:151923748:A:G	0	0	0	0	0	0	0	0
X:151969707:A:C	0	0	0	0	0	0	0	0
X:152652814:A:T	0	0	0	0	0	0	0	0
X:152727846:C:T	0	0	0	0	0	0	0	0
X:152728157:GT:CA	0	0	0	0	0	0	0	0
X:152737049:A:G	0	0	0	0	0	0	0	0
X:152767196:C:A	0	0	0	0	0	0	0	0
X:152767216:G:A	0	0	0	0	0	0	0	0
X:153344650:G:C	0	0	0	0	0	0	0	0
X:153345527:T:C	26	26	31	0	31	1.0	0.0	1.0
X:153347654:C:T	1	1	1	0	1	1	0	1
X:153506051:C:T	0	0	0	0	0	0	0	0
X:153558270:G:C	0	0	0	0	0	0	0	0
X:153662433:A:G	1	0	1	1	0	1	1	0
X:153687503:G:C	0	0	0	0	0	0	0	0
X:153770343:G:A	0	0	0	0	0	0	0	0
X:153776964:G:A	0	0	0	0	0	0	0	0
X:153780357:C:T	0	0	0	0	0	0	0	0
X:153784080:A:G	0	0	0	0	0	0	0	0
X:153841503:G:A	0	0	0	0	0	0	0	0
X:153913475:G:A	34	31	52	3	49	1.0	0.0	1.0
X:153941584:G:T	18	18	24	0	24	1.0	0.0	1.0
X:153950388:G:A	17	0	24	24	0	1	1	0
X:153954214:C:T	10	9	17	1	16	1.0	0.0	1.0
X:153982271:C:T	4	4	4	0	4	1.0	0.0	1.0
X:153982294:A:G	2	2	2	0	2	1.0	0.0	1.0
X:153982503:C:T	1	1	1	0	1	1	0	1
X:154019032:G:A	3	0	4	4	0	1	1	0
X:154154701:A:G	0	0	0	0	0	0	0	0
X:154156437:T:C	0	0	0	0	0	0	0	0
X:154351080:A:G	6	6	6	0	6	1.0	0.0	1.0
X:154398308:A:C	16	16	16	0	16	1.0	0.0	1.0
X:154398397:G:A	69	69	79	0	79	1	0	1
X:154405018:C:G	32	32	38	0	38	1.0	0.0	1.0
X:154412069:T:C	6	6	7	0	7	1.0	0.0	1.0
X:154421474:C:G	6	6	8	0	8	1.0	0.0	1.0
X:154428737:G:A	82	82	95	0	95	1.0	0.0	1.0
X:154438830:T:C	496	495	609	1	608	1.0	0.0	1.0
X:154450358:C:T	1	1	3	0	3	3	0	3
X:154652556:C:A	0	0	0	0	0	0	0	0
X:154930010:G:C	0	0	0	0	0	0	0	0
X:155277884:G:T	0	0	0	0	0	0	0	0
X:155774618:A:G	0	0	0	0	0	0	0	0
