Variant	Num_Cells	Num_Alt_Cells	Total_Coverage	Ref_Count	Alt_Count	Median_Coverage	Median_Ref	Median_Alt
chr1:187485:G:A	43	0	43	43	0	1	1	0
chr1:946247:G:A	70	26	97	45	52	1.0	1.0	0.0
chr1:946550:G:A	1	0	1	1	0	1	1	0
chr1:964409:G:A	4	2	6	2	4	1.5	0.5	1.0
chr1:965125:G:C	7	5	11	2	9	2	0	2
chr1:973858:G:C	4	2	6	2	4	1.5	0.5	1.0
chr1:978938:C:G	0	0	0	0	0	0	0	0
chr1:1179288:G:A	0	0	0	0	0	0	0	0
chr1:1197893:T:C	0	0	0	0	0	0	0	0
chr1:1203533:T:C	1	0	1	1	0	1	1	0
chr1:1203822:T:C	1	0	1	1	0	1	1	0
chr1:1212042:C:T	2	0	2	2	0	1.0	1.0	0.0
chr1:1217733:G:A	8	2	10	6	4	1.0	1.0	0.0
chr1:1244152:C:T	1	1	2	0	2	2	0	2
chr1:1312114:T:C	165	85	254	80	174	2	0	2
chr1:1313807:G:A	143	70	215	73	142	1	1	0
chr1:1395346:A:G	17	10	27	8	19	2	0	2
chr1:1402457:A:G	41	18	60	24	36	1	1	0
chr1:1407232:G:C	874	483	1532	495	1037	2.0	1.0	2.0
chr1:1485073:G:C	12	5	17	7	10	1.0	1.0	0.0
chr1:1534218:CG:GC	46	26	73	21	52	2.0	0.0	2.0
chr1:1616547:T:C	53	31	84	22	62	2	0	2
chr1:1623412:T:C	1	0	1	1	0	1	1	0
chr1:1627515:C:T	1	1	2	0	2	2	0	2
chr1:1703565:T:C	54	33	89	21	68	2.0	0.0	2.0
chr1:1704180:T:C	11	6	17	5	12	2	0	2
chr1:1704310:C:A	29	18	49	11	38	2	0	2
chr1:1704605:G:A	23	12	34	11	23	1	0	1
chr1:1704835:C:T	11	5	16	6	10	1	1	0
chr1:1732412:G:C	1	0	1	1	0	1	1	0
chr1:1732422:G:A	1	0	1	1	0	1	1	0
chr1:1734736:C:T	23	0	23	23	0	1	1	0
chr1:1753033:C:T	107	56	168	55	113	2	0	2
chr1:1754601:G:T	87	40	132	49	83	1	1	0
chr1:1756186:T:C	9	6	15	3	12	2	0	2
chr1:1757074:G:T	8	4	12	4	8	1.5	0.5	1.0
chr1:1915143:A:G	0	0	0	0	0	0	0	0
chr1:1915326:G:A	0	0	0	0	0	0	0	0
chr1:1916417:G:T	0	0	0	0	0	0	0	0
chr1:1916670:G:C	0	0	0	0	0	0	0	0
chr1:1917295:A:G	0	0	0	0	0	0	0	0
chr1:1918090:A:G	0	0	0	0	0	0	0	0
chr1:1918989:A:G	0	0	0	0	0	0	0	0
chr1:1922670:A:G	0	0	0	0	0	0	0	0
chr1:1926870:T:C	0	0	0	0	0	0	0	0
chr1:1930142:C:A	0	0	0	0	0	0	0	0
chr1:1930143:C:T	0	0	0	0	0	0	0	0
chr1:1942075:A:G	0	0	0	0	0	0	0	0
chr1:1942086:T:C	0	0	0	0	0	0	0	0
chr1:1944419:CA:GG	0	0	0	0	0	0	0	0
chr1:1955580:A:G	0	0	0	0	0	0	0	0
chr1:2024923:G:A	0	0	0	0	0	0	0	0
chr1:2025598:T:C	0	0	0	0	0	0	0	0
chr1:2104824:G:A	0	0	0	0	0	0	0	0
chr1:2144121:T:G	4	2	6	2	4	1.5	0.5	1.0
chr1:2144131:T:C	4	2	6	2	4	1.5	0.5	1.0
chr1:2321320:A:G	1	0	1	1	0	1	1	0
chr1:2391602:T:C	5	2	7	3	4	1	1	0
chr1:2499178:C:T	4	3	7	1	6	2.0	0.0	2.0
chr1:2502461:C:T	0	0	0	0	0	0	0	0
chr1:2512975:G:A	7	2	9	5	4	1	1	0
chr1:2521130:T:C	7	2	9	5	4	1	1	0
chr1:2556714:A:G	430	246	716	200	516	2.0	0.0	2.0
chr1:2559766:C:T	36	18	55	19	36	2.0	0.5	1.0
chr1:2563346:G:A	471	273	793	215	578	2	0	2
chr1:2592766:C:T	1	1	2	0	2	2	0	2
chr1:2595307:A:G	0	0	0	0	0	0	0	0
chr1:2604174:C:A	0	0	0	0	0	0	0	0
chr1:2609830:A:G	0	0	0	0	0	0	0	0
chr1:2629443:G:A	0	0	0	0	0	0	0	0
chr1:2629464:T:G	0	0	0	0	0	0	0	0
chr1:2641760:A:G	2	0	2	2	0	1.0	1.0	0.0
chr1:3022425:G:A	0	0	0	0	0	0	0	0
chr1:3385157:C:T	1	0	1	1	0	1	1	0
chr1:3412699:C:T	0	0	0	0	0	0	0	0
chr1:3490537:C:T	24	13	38	12	26	2.0	0.0	2.0
chr1:3505333:A:G	8	3	11	5	6	1.0	1.0	0.0
chr1:3510787:A:G	9	3	12	6	6	1	1	0
chr1:3512044:G:A	8	6	14	2	12	2.0	0.0	2.0
chr1:3627623:C:T	120	59	182	62	120	1.5	1.0	0.0
chr1:3682336:G:A	0	0	0	0	0	0	0	0
chr1:3682346:C:T	0	0	0	0	0	0	0	0
chr1:3727521:G:A	0	0	0	0	0	0	0	0
chr1:3816218:T:C	1	0	1	1	0	1	1	0
chr1:3829293:T:C	7	1	8	6	2	1	1	0
chr1:3836572:A:T	31	16	48	16	32	2	0	2
chr1:3857566:A:G	21	5	26	16	10	1	1	0
chr1:3857574:T:C	21	6	27	15	12	1	1	0
chr1:3869625:G:A	15	10	25	5	20	2	0	2
chr1:3869681:G:A	15	5	20	10	10	1	1	0
chr1:3890824:G:A	115	54	171	61	110	1	1	0
chr1:3892762:C:T	8	6	16	2	14	2.0	0.0	2.0
chr1:5877031:T:C	0	0	0	0	0	0	0	0
chr1:6085305:A:G	0	0	0	0	0	0	0	0
chr1:6589168:T:G	79	42	121	38	83	2	0	2
chr1:6601997:G:A	1	0	1	1	0	1	1	0
chr1:6621684:C:T	22	11	35	11	24	1.5	0.5	1.0
chr1:6645814:G:C	12	4	16	8	8	1.0	1.0	0.0
chr1:7809988:T:C	4	2	6	2	4	1.5	0.5	1.0
chr1:7820623:T:G	0	0	0	0	0	0	0	0
chr1:7827433:T:C	0	0	0	0	0	0	0	0
chr1:7830057:T:C	0	0	0	0	0	0	0	0
chr1:7837073:A:G	0	0	0	0	0	0	0	0
chr1:8330153:G:A	0	0	0	0	0	0	0	0
chr1:8344033:C:T	0	0	0	0	0	0	0	0
chr1:8358584:C:A	10	5	15	5	10	1.5	0.5	1.0
chr1:8358590:T:C	9	4	13	5	8	1	1	0
chr1:8361032:C:T	0	0	0	0	0	0	0	0
chr1:8361143:T:C	0	0	0	0	0	0	0	0
chr1:8949347:C:T	0	0	0	0	0	0	0	0
chr1:8949385:A:C	0	0	0	0	0	0	0	0
chr1:8957145:A:G	0	0	0	0	0	0	0	0
chr1:8970905:C:T	0	0	0	0	0	0	0	0
chr1:8974362:G:A	0	0	0	0	0	0	0	0
chr1:9263851:G:A	3	2	5	1	4	2	0	2
chr1:9356092:G:A	0	0	0	0	0	0	0	0
chr1:9356287:C:T	0	0	0	0	0	0	0	0
chr1:9610776:C:T	0	0	0	0	0	0	0	0
chr1:10103130:C:T	3	2	5	1	4	2	0	2
chr1:10258594:C:G	4	2	6	2	4	1.5	0.5	1.0
chr1:10361820:A:G	2	1	3	1	2	1.5	0.5	1.0
chr1:10375266:C:A	2	2	4	0	4	2.0	0.0	2.0
chr1:10399722:G:A	5	3	8	2	6	2	0	2
chr1:10400428:T:C	169	86	268	92	176	2	1	2
chr1:10413139:C:T	160	81	252	88	164	2.0	1.0	2.0
chr1:10419621:G:A	1	0	1	1	0	1	1	0
chr1:10648085:A:G	2	0	2	2	0	1.0	1.0	0.0
chr1:10649210:C:T	0	0	0	0	0	0	0	0
chr1:10649252:C:G	0	0	0	0	0	0	0	0
chr1:10649384:C:T	0	0	0	0	0	0	0	0
chr1:10654237:G:C	0	0	0	0	0	0	0	0
chr1:10665441:G:A	4	2	6	2	4	1.5	0.5	1.0
chr1:11068597:G:A	3	2	5	1	4	2	0	2
chr1:11072160:G:A	46	18	64	28	36	1.0	1.0	0.0
chr1:11081130:C:G	36	14	50	22	28	1.0	1.0	0.0
chr1:11121270:C:T	7	3	10	4	6	1	1	0
chr1:11130589:G:A	5	3	8	2	6	2	0	2
chr1:11228701:G:A	3	2	5	1	4	2	0	2
chr1:11241657:A:G	2	1	3	1	2	1.5	0.5	1.0
chr1:11501536:G:A	1	0	1	1	0	1	1	0
chr1:11519413:G:A	0	0	0	0	0	0	0	0
chr1:11675784:C:A	17	6	23	11	12	1	1	0
chr1:11676994:G:C	7	3	10	4	6	1	1	0
chr1:11680755:A:C	24	5	35	21	14	1.0	1.0	0.0
chr1:11711931:A:G	0	0	0	0	0	0	0	0
chr1:11719712:G:A	0	0	0	0	0	0	0	0
chr1:11796321:G:A	5	1	6	4	2	1	1	0
chr1:11922487:T:C	3	2	5	1	4	2	0	2
chr1:11923149:A:G	24	11	35	13	22	1.0	1.0	0.0
chr1:11949898:C:T	4	1	5	3	2	1.0	1.0	0.0
chr1:11964178:C:T	3	1	4	2	2	1	1	0
chr1:12011623:A:G	6	3	9	3	6	1.5	0.5	1.0
chr1:12022277:A:T	281	145	434	142	292	2	0	2
chr1:12022404:C:T	282	145	434	142	292	2.0	0.0	2.0
chr1:12029944:T:C	57	26	84	31	53	1	1	0
chr1:12031153:T:C	0	0	0	0	0	0	0	0
chr1:12188885:A:G	128	69	203	65	138	2.0	0.0	2.0
chr1:12191751:T:G	0	0	0	0	0	0	0	0
chr1:12279562:A:T	1	1	2	0	2	2	0	2
chr1:12341811:A:C	1	0	1	1	0	1	1	0
chr1:12578936:C:T	0	0	0	0	0	0	0	0
chr1:12580622:C:T	0	0	0	0	0	0	0	0
chr1:12719558:C:T	0	0	0	0	0	0	0	0
chr1:12719616:C:T	0	0	0	0	0	0	0	0
chr1:12725527:T:G	0	0	0	0	0	0	0	0
chr1:12760937:C:T	0	0	0	0	0	0	0	0
chr1:12777320:C:T	0	0	0	0	0	0	0	0
chr1:12793254:A:C	0	0	0	0	0	0	0	0
chr1:12794279:C:T	0	0	0	0	0	0	0	0
chr1:12794395:T:C	0	0	0	0	0	0	0	0
chr1:12794781:T:G	0	0	0	0	0	0	0	0
chr1:12795729:A:C	0	0	0	0	0	0	0	0
chr1:12795997:G:A	0	0	0	0	0	0	0	0
chr1:12838849:C:T	0	0	0	0	0	0	0	0
chr1:12838922:CACT:GACA	0	0	0	0	0	0	0	0
chr1:12838930:G:A	0	0	0	0	0	0	0	0
chr1:13392000:A:G	0	0	0	0	0	0	0	0
chr1:13392079:T:C	0	0	0	0	0	0	0	0
chr1:13418237:C:G	0	0	0	0	0	0	0	0
chr1:13475857:T:C	0	0	0	0	0	0	0	0
chr1:13475969:G:A	0	0	0	0	0	0	0	0
chr1:13778796:G:A	53	34	88	20	68	2	0	2
chr1:13779427:G:A	37	24	61	13	48	2	0	2
chr1:13816508:A:G	22	12	34	10	24	2.0	0.0	2.0
chr1:15056111:G:A	0	0	0	0	0	0	0	0
chr1:15112494:G:A	0	0	0	0	0	0	0	0
chr1:15168614:A:G	0	0	0	0	0	0	0	0
chr1:15219581:G:A	0	0	0	0	0	0	0	0
chr1:15289626:C:T	0	0	0	0	0	0	0	0
chr1:15289643:G:A	0	0	0	0	0	0	0	0
chr1:15382044:A:G	0	0	0	0	0	0	0	0
chr1:15397347:G:A	0	0	0	0	0	0	0	0
chr1:15463518:G:A	0	0	0	0	0	0	0	0
chr1:15465931:C:G	1	1	2	0	2	2	0	2
chr1:15467418:G:A	3	2	5	1	4	2	0	2
chr1:15506048:T:C	42	20	62	22	40	1.0	1.0	0.0
chr1:15507865:A:G	0	0	0	0	0	0	0	0
chr1:15518120:A:G	59	31	90	28	62	2	0	2
chr1:15565920:A:C	10	6	15	4	11	1.5	0.0	1.5
chr1:15577823:C:T	90	57	155	35	120	2.0	0.0	2.0
chr1:15579006:G:A	87	56	151	33	118	2	0	2
chr1:15583249:C:T	79	51	138	30	108	2	0	2
chr1:15633482:C:T	12	9	21	3	18	2.0	0.0	2.0
chr1:15660052:T:C	5	1	6	4	2	1	1	0
chr1:15717906:G:A	1	0	1	1	0	1	1	0
chr1:15718592:C:T	4	3	9	1	8	2.0	0.0	2.0
chr1:15770439:C:T	0	0	0	0	0	0	0	0
chr1:15943928:C:G	17	6	25	11	14	1	1	0
chr1:16053748:A:G	0	0	0	0	0	0	0	0
chr1:16053757:C:T	0	0	0	0	0	0	0	0
chr1:16058680:G:A	0	0	0	0	0	0	0	0
chr1:16125272:G:A	0	0	0	0	0	0	0	0
chr1:16138178:G:A	0	0	0	0	0	0	0	0
chr1:16148628:CAGC:TAGT	0	0	0	0	0	0	0	0
chr1:16206003:G:A	40	21	62	20	42	2.0	0.5	2.0
chr1:16251413:G:C	24	13	37	11	26	2.0	0.0	2.0
chr1:16294688:C:T	28	15	43	13	30	2.0	0.0	2.0
chr1:16405015:C:G	8	6	14	2	12	2.0	0.0	2.0
chr1:16409832:G:A	1	1	2	0	2	2	0	2
chr1:16421937:C:T	1	0	1	1	0	1	1	0
chr1:16451770:G:T	1	1	2	0	2	2	0	2
chr1:16648142:T:C	1	1	2	0	2	2	0	2
chr1:16648374:G:C	0	0	0	0	0	0	0	0
chr1:16648477:C:T	0	0	0	0	0	0	0	0
chr1:16648507:C:T	0	0	0	0	0	0	0	0
chr1:16649698:C:T	2	0	2	2	0	1.0	1.0	0.0
chr1:16759339:G:T	0	0	0	0	0	0	0	0
chr1:16922005:A:G	1	1	2	0	2	2	0	2
chr1:16940041:G:C	1	0	1	1	0	1	1	0
chr1:16975285:A:G	0	0	0	0	0	0	0	0
chr1:16977094:C:T	0	0	0	0	0	0	0	0
chr1:16986248:C:T	28	18	46	10	36	2.0	0.0	2.0
chr1:16986662:G:A	2	1	3	1	2	1.5	0.5	1.0
chr1:16986848:G:A	20	13	33	7	26	2.0	0.0	2.0
chr1:16987159:C:T	15	9	24	6	18	2	0	2
chr1:16988207:C:T	12	5	17	7	10	1.0	1.0	0.0
chr1:16988447:G:A	10	6	16	4	12	2.0	0.0	2.0
chr1:16992516:G:A	4	2	6	2	4	1.5	0.5	1.0
chr1:17068985:G:A	0	0	0	0	0	0	0	0
chr1:17069026:G:A	0	0	0	0	0	0	0	0
chr1:17070208:T:C	0	0	0	0	0	0	0	0
chr1:17075621:G:T	0	0	0	0	0	0	0	0
chr1:17075640:T:C	0	0	0	0	0	0	0	0
chr1:17075664:G:A	0	0	0	0	0	0	0	0
chr1:17075760:C:T	0	0	0	0	0	0	0	0
chr1:17079314:G:A	0	0	0	0	0	0	0	0
chr1:17082746:G:A	0	0	0	0	0	0	0	0
chr1:17086626:A:C	0	0	0	0	0	0	0	0
chr1:17092529:G:A	0	0	0	0	0	0	0	0
chr1:17223626:G:A	0	0	0	0	0	0	0	0
chr1:17239874:G:A	0	0	0	0	0	0	0	0
chr1:17271160:C:T	0	0	0	0	0	0	0	0
chr1:17274670:C:T	0	0	0	0	0	0	0	0
chr1:17282953:G:T	0	0	0	0	0	0	0	0
chr1:17331039:G:A	0	0	0	0	0	0	0	0
chr1:17331121:T:C	0	0	0	0	0	0	0	0
chr1:17334004:G:C	0	0	0	0	0	0	0	0
chr1:17336167:T:C	0	0	0	0	0	0	0	0
chr1:17336210:G:C	0	0	0	0	0	0	0	0
chr1:17342068:G:A	0	0	0	0	0	0	0	0
chr1:17342393:A:G	0	0	0	0	0	0	0	0
chr1:17634850:C:T	2	2	4	0	4	2.0	0.0	2.0
chr1:17654689:A:C	4	2	6	2	4	1.5	0.5	1.0
chr1:17656064:G:A	5	4	9	2	7	2	0	2
chr1:17696870:C:T	17	6	23	11	12	1	1	0
chr1:17697014:T:C	19	8	27	11	16	1	1	0
chr1:17697195:A:G	21	9	30	12	18	1	1	0
chr1:18378368:A:G	0	0	0	0	0	0	0	0
chr1:18481403:C:G	0	0	0	0	0	0	0	0
chr1:18481459:C:A	0	0	0	0	0	0	0	0
chr1:18481798:C:A	0	0	0	0	0	0	0	0
chr1:18481971:T:A	0	0	0	0	0	0	0	0
chr1:18482032:A:C	0	0	0	0	0	0	0	0
chr1:18483402:A:T	0	0	0	0	0	0	0	0
chr1:18700745:A:G	0	0	0	0	0	0	0	0
chr1:18840335:A:G	0	0	0	0	0	0	0	0
chr1:18854521:G:C	0	0	0	0	0	0	0	0
chr1:18854588:A:C	0	0	0	0	0	0	0	0
chr1:18854899:T:C	0	0	0	0	0	0	0	0
chr1:18857583:A:G	0	0	0	0	0	0	0	0
chr1:18875434:C:T	3	2	5	1	4	2	0	2
chr1:18875462:A:G	3	1	4	2	2	1	1	0
chr1:18876423:T:C	3	1	4	2	2	1	1	0
chr1:18876432:T:C	3	1	4	2	2	1	1	0
chr1:19268643:C:T	1	0	1	1	0	1	1	0
chr1:19270926:G:T	0	0	0	0	0	0	0	0
chr1:19282760:T:C	4	3	7	1	6	2.0	0.0	2.0
chr1:19284747:T:C	2	1	3	1	2	1.5	0.5	1.0
chr1:19325569:G:A	29	13	43	17	26	1	1	0
chr1:19448998:A:G	6	2	8	4	4	1.0	1.0	0.0
chr1:19978364:G:A	0	0	0	0	0	0	0	0
chr1:19978433:G:A	0	0	0	0	0	0	0	0
chr1:19978572:C:T	0	0	0	0	0	0	0	0
chr1:20084839:C:T	0	0	0	0	0	0	0	0
chr1:20330331:A:G	0	0	0	0	0	0	0	0
chr1:20336445:A:G	0	0	0	0	0	0	0	0
chr1:20345468:G:A	0	0	0	0	0	0	0	0
chr1:20354225:G:A	0	0	0	0	0	0	0	0
chr1:20589208:A:C	0	0	0	0	0	0	0	0
chr1:20618562:C:T	0	0	0	0	0	0	0	0
chr1:20650507:A:C	15	9	24	6	18	2	0	2
chr1:20653080:C:T	2	0	2	2	0	1.0	1.0	0.0
chr1:20698408:C:T	0	0	0	0	0	0	0	0
chr1:20704549:T:C	0	0	0	0	0	0	0	0
chr1:20715601:G:A	0	0	0	0	0	0	0	0
chr1:21247229:G:A	25	14	39	11	28	2	0	2
chr1:21470728:A:G	1	1	2	0	2	2	0	2
chr1:21563142:T:C	0	0	0	0	0	0	0	0
chr1:21614062:C:T	0	0	0	0	0	0	0	0
chr1:21649796:C:T	0	0	0	0	0	0	0	0
chr1:21823442:T:C	15	4	20	12	8	1	1	0
chr1:21823625:C:T	14	4	19	11	8	1.0	1.0	0.0
chr1:21828352:A:G	6	1	7	5	2	1.0	1.0	0.0
chr1:21836909:G:A	0	0	0	0	0	0	0	0
chr1:21847933:T:G	0	0	0	0	0	0	0	0
chr1:21864961:G:A	0	0	0	0	0	0	0	0
chr1:21887547:G:A	0	0	0	0	0	0	0	0
chr1:22005918:A:G	0	0	0	0	0	0	0	0
chr1:22526387:G:C	6	3	9	3	6	1.5	0.5	1.0
chr1:22589260:T:C	0	0	0	0	0	0	0	0
chr1:22593411:C:T	0	0	0	0	0	0	0	0
chr1:22601772:A:G	0	0	0	0	0	0	0	0
chr1:22953931:G:T	0	0	0	0	0	0	0	0
chr1:23091660:C:T	1	0	1	1	0	1	1	0
chr1:23092768:G:A	1	0	1	1	0	1	1	0
chr1:23092881:G:T	1	0	1	1	0	1	1	0
chr1:23092890:C:T	1	0	1	1	0	1	1	0
chr1:23093362:T:C	7	0	7	7	0	1	1	0
chr1:23436956:G:A	0	0	0	0	0	0	0	0
chr1:23438799:C:T	0	0	0	0	0	0	0	0
chr1:23521037:C:T	1	0	1	1	0	1	1	0
chr1:23757004:C:T	17	5	23	13	10	1	1	0
chr1:23854472:T:C	47	15	62	32	30	1	1	0
chr1:23865582:A:G	45	31	76	14	62	2	0	2
chr1:23868258:G:C	42	29	71	13	58	2.0	0.0	2.0
chr1:23868283:G:A	40	27	67	13	54	2.0	0.0	2.0
chr1:23874672:G:A	89	41	130	48	82	1	1	0
chr1:23967872:A:T	20	10	30	10	20	1.5	0.5	1.0
chr1:24057329:T:C	0	0	0	0	0	0	0	0
chr1:24064241:C:T	0	0	0	0	0	0	0	0
chr1:24080045:G:A	0	0	0	0	0	0	0	0
chr1:24080157:G:A	0	0	0	0	0	0	0	0
chr1:24081924:C:T	0	0	0	0	0	0	0	0
chr1:24082275:T:C	0	0	0	0	0	0	0	0
chr1:24082701:C:T	0	0	0	0	0	0	0	0
chr1:24086669:T:C	0	0	0	0	0	0	0	0
chr1:24089580:G:C	0	0	0	0	0	0	0	0
chr1:24092278:T:C	0	0	0	0	0	0	0	0
chr1:24093006:A:G	0	0	0	0	0	0	0	0
chr1:24094984:G:A	0	0	0	0	0	0	0	0
chr1:24095460:C:G	0	0	0	0	0	0	0	0
chr1:24108105:T:C	0	0	0	0	0	0	0	0
chr1:24120724:G:A	0	0	0	0	0	0	0	0
chr1:24121594:G:A	0	0	0	0	0	0	0	0
chr1:24344928:A:G	0	0	0	0	0	0	0	0
chr1:24379623:G:A	4	2	6	2	4	1.5	0.5	1.0
chr1:24383915:A:G	9	5	14	4	10	2	0	2
chr1:24466127:T:A	29	18	47	11	36	2	0	2
chr1:24533127:G:A	95	42	137	53	84	1	1	0
chr1:24533175:G:A	94	42	136	52	84	1.0	1.0	0.0
chr1:24535214:G:A	34	20	54	14	40	2.0	0.0	2.0
chr1:25420665:T:C	0	0	0	0	0	0	0	0
chr1:25805163:G:A	0	0	0	0	0	0	0	0
chr1:25811771:T:C	0	0	0	0	0	0	0	0
chr1:25814082:C:A	0	0	0	0	0	0	0	0
chr1:25823532:C:T	5	2	7	3	4	1	1	0
chr1:25826267:A:G	3	2	5	1	4	2	0	2
chr1:25990892:G:A	0	0	0	0	0	0	0	0
chr1:26031165:C:A	0	0	0	0	0	0	0	0
chr1:26031176:G:A	0	0	0	0	0	0	0	0
chr1:26039058:C:T	0	0	0	0	0	0	0	0
chr1:26058512:T:C	0	0	0	0	0	0	0	0
chr1:26121956:A:G	5	5	10	0	10	2	0	2
chr1:26122358:T:C	5	5	10	0	10	2	0	2
chr1:26161449:A:G	0	0	0	0	0	0	0	0
chr1:26169964:C:T	444	230	733	244	489	2.0	1.0	2.0
chr1:26170160:T:C	456	234	749	254	495	2.0	1.0	2.0
chr1:26170379:A:G	24	18	42	6	36	2.0	0.0	2.0
chr1:26177545:G:A	1	1	2	0	2	2	0	2
chr1:26190776:A:G	0	0	0	0	0	0	0	0
chr1:26191400:C:T	0	0	0	0	0	0	0	0
chr1:26198029:G:A	0	0	0	0	0	0	0	0
chr1:26199948:A:G	0	0	0	0	0	0	0	0
chr1:26202630:G:C	0	0	0	0	0	0	0	0
chr1:26255600:G:A	6	3	9	3	6	1.5	0.5	1.0
chr1:26328717:C:T	3	1	4	2	2	1	1	0
chr1:26336871:C:T	0	0	0	0	0	0	0	0
chr1:26338477:C:T	0	0	0	0	0	0	0	0
chr1:26343953:G:T	0	0	0	0	0	0	0	0
chr1:26344118:C:T	0	0	0	0	0	0	0	0
chr1:26364683:C:A	0	0	0	0	0	0	0	0
chr1:26426501:T:C	0	0	0	0	0	0	0	0
chr1:26460136:G:A	30	16	46	14	32	2.0	0.0	2.0
chr1:26913602:C:T	0	0	0	0	0	0	0	0
chr1:26952030:G:A	7	6	13	1	12	2	0	2
chr1:26952062:G:A	7	6	13	1	12	2	0	2
chr1:27154266:A:G	29	11	40	18	22	1	1	0
chr1:27360975:G:T	0	0	0	0	0	0	0	0
chr1:27362142:G:A	0	0	0	0	0	0	0	0
chr1:27382648:A:G	0	0	0	0	0	0	0	0
chr1:27549971:C:A	0	0	0	0	0	0	0	0
chr1:27830816:A:C	30	23	53	7	46	2.0	0.0	2.0
chr1:27882794:A:G	26	6	32	20	12	1.0	1.0	0.0
chr1:27955695:C:T	1	1	2	0	2	2	0	2
chr1:28096336:C:T	0	0	0	0	0	0	0	0
chr1:28236165:A:G	1675	901	3341	1242	2099	2	1	2
chr1:28236573:C:T	40	12	52	28	24	1.0	1.0	0.0
chr1:28237741:A:G	71	22	96	52	44	1	1	0
chr1:28237768:A:G	123	22	148	104	44	1	1	0
chr1:28863085:C:T	0	0	0	0	0	0	0	0
chr1:29112504:T:A	20	7	28	14	14	1.0	1.0	0.0
chr1:29148829:C:T	207	98	317	120	197	2	1	0
chr1:29148882:C:G	207	98	315	120	195	2	1	0
chr1:29317816:C:T	0	0	0	0	0	0	0	0
chr1:30715242:C:T	2	1	3	1	2	1.5	0.5	1.0
chr1:30716054:A:G	3	2	5	1	4	2	0	2
chr1:30733790:C:T	2085	1231	4338	1411	2927	2	1	2
chr1:30735195:C:T	2051	1203	4204	1372	2832	2	1	2
chr1:30742517:T:C	1918	1114	3828	1232	2596	2.0	1.0	2.0
chr1:31413986:T:C	0	0	0	0	0	0	0	0
chr1:31425840:C:T	1	1	2	0	2	2	0	2
chr1:31619303:C:T	0	0	0	0	0	0	0	0
chr1:31619609:G:A	0	0	0	0	0	0	0	0
chr1:31626924:A:G	0	0	0	0	0	0	0	0
chr1:31630664:A:G	168	80	251	89	162	1.0	1.0	0.0
chr1:31662352:G:A	0	0	0	0	0	0	0	0
chr1:31665562:C:G	0	0	0	0	0	0	0	0
chr1:31692773:T:C	0	0	0	0	0	0	0	0
chr1:31698605:T:G	0	0	0	0	0	0	0	0
chr1:31699894:G:T	0	0	0	0	0	0	0	0
chr1:31731046:C:G	0	0	0	0	0	0	0	0
chr1:31756312:G:A	0	0	0	0	0	0	0	0
chr1:32394199:C:A	147	66	217	81	136	1	1	0
chr1:32770025:G:A	0	0	0	0	0	0	0	0
chr1:32770188:C:T	0	0	0	0	0	0	0	0
chr1:33367264:A:G	0	0	0	0	0	0	0	0
chr1:33494462:A:G	0	0	0	0	0	0	0	0
chr1:33605925:C:T	0	0	0	0	0	0	0	0
chr1:33864466:A:C	0	0	0	0	0	0	0	0
chr1:34757744:G:A	0	0	0	0	0	0	0	0
chr1:34794360:A:G	0	0	0	0	0	0	0	0
chr1:34794601:G:A	0	0	0	0	0	0	0	0
chr1:35850970:A:C	1	0	1	1	0	1	1	0
chr1:36088072:A:G	0	0	0	0	0	0	0	0
chr1:36088235:A:C	0	0	0	0	0	0	0	0
chr1:36097557:C:A	0	0	0	0	0	0	0	0
chr1:36097923:G:A	0	0	0	0	0	0	0	0
chr1:36137342:C:T	15	6	21	9	12	1	1	0
chr1:36286551:C:T	792	416	1346	454	892	2.0	1.0	2.0
chr1:36286832:C:T	796	417	1353	459	894	2.0	1.0	2.0
chr1:36322287:G:A	75	31	109	45	64	1	1	0
chr1:36355326:G:A	43	19	62	24	38	1	1	0
chr1:36422101:C:T	0	0	0	0	0	0	0	0
chr1:36422861:A:G	1	1	2	0	2	2	0	2
chr1:36423404:G:A	1	1	2	0	2	2	0	2
chr1:36455770:G:T	19	2	21	17	4	1	1	0
chr1:36458042:G:C	0	0	0	0	0	0	0	0
chr1:37554146:C:T	464	229	731	261	470	2.0	1.0	0.0
chr1:37581461:C:G	41	21	62	20	42	2	0	2
chr1:37612628:A:G	5	4	11	1	10	2	0	2
chr1:37683404:G:A	9	3	12	6	6	1	1	0
chr1:37761414:A:T	0	0	0	0	0	0	0	0
chr1:37931697:C:T	19	10	29	9	20	2	0	2
chr1:37945773:G:A	13	5	18	8	10	1	1	0
chr1:37969450:C:T	147	42	193	109	84	1	1	0
chr1:37997832:C:T	34	26	64	8	56	2.0	0.0	2.0
chr1:39448691:G:C	7	4	11	3	8	2	0	2
chr1:39561792:G:A	8	5	13	3	10	2.0	0.0	2.0
chr1:39663394:G:A	2	2	4	0	4	2.0	0.0	2.0
chr1:39683970:G:T	0	0	0	0	0	0	0	0
chr1:39684484:G:A	0	0	0	0	0	0	0	0
chr1:39764664:C:G	1	0	1	1	0	1	1	0
chr1:39883459:G:A	43	23	66	20	46	2	0	2
chr1:39962915:G:T	1	1	2	0	2	2	0	2
chr1:40236559:A:G	25	13	38	12	26	2	0	2
chr1:40307477:T:C	461	248	747	239	508	2	0	2
chr1:40312128:T:G	2	0	2	2	0	1.0	1.0	0.0
chr1:40495777:T:C	5	2	7	3	4	1	1	0
chr1:40514887:G:A	15	3	19	13	6	1	1	0
chr1:40515558:G:A	16	12	30	4	26	2.0	0.0	2.0
chr1:40641940:C:G	0	0	0	0	0	0	0	0
chr1:40758336:C:T	15	5	20	10	10	1	1	0
chr1:40770909:C:A	194	121	322	78	244	2.0	0.0	2.0
chr1:41018108:G:T	0	0	0	0	0	0	0	0
chr1:41028550:G:T	3	2	5	1	4	2	0	2
chr1:41580942:G:T	3	2	5	1	4	2	0	2
chr1:41584384:G:T	1	0	1	1	0	1	1	0
chr1:42414845:T:C	0	0	0	0	0	0	0	0
chr1:42450056:C:G	5	5	10	0	10	2	0	2
chr1:42577032:C:T	9	3	13	7	6	1	1	0
chr1:42830447:G:A	4	0	4	4	0	1.0	1.0	0.0
chr1:42830502:C:T	4	4	8	0	8	2.0	0.0	2.0
chr1:42830524:C:T	4	4	8	0	8	2.0	0.0	2.0
chr1:42834992:T:C	0	0	0	0	0	0	0	0
chr1:43243257:G:A	1	0	1	1	0	1	1	0
chr1:43439615:C:T	0	0	0	0	0	0	0	0
chr1:44139047:TT:GC	0	0	0	0	0	0	0	0
chr1:45329412:G:A	45	21	68	25	43	1	1	0
chr1:45499668:T:C	16	3	19	13	6	1.0	1.0	0.0
chr1:45566635:G:A	767	395	1278	448	830	2	1	2
chr1:45620207:C:G	5	3	8	2	6	2	0	2
chr1:45620405:C:T	4	2	6	2	4	1.5	0.5	1.0
chr1:45620657:C:T	3	1	4	2	2	1	1	0
chr1:45621140:G:A	0	0	0	0	0	0	0	0
chr1:45621241:C:T	0	0	0	0	0	0	0	0
chr1:45621905:G:A	1	1	2	0	2	2	0	2
chr1:45623553:C:G	0	0	0	0	0	0	0	0
chr1:45628355:A:G	109	56	168	54	114	2	0	2
chr1:45729703:T:C	47	27	75	21	54	2	0	2
chr1:46031037:A:G	1	1	2	0	2	2	0	2
chr1:46032703:A:G	3	1	4	2	2	1	1	0
chr1:46511165:C:T	0	0	0	0	0	0	0	0
chr1:46652517:G:T	17	3	22	14	8	1	1	0
chr1:46665201:A:G	0	0	0	0	0	0	0	0
chr1:46673147:T:G	0	0	0	0	0	0	0	0
chr1:46673431:C:T	0	0	0	0	0	0	0	0
chr1:48298747:C:T	0	0	0	0	0	0	0	0
chr1:48436880:G:A	0	0	0	0	0	0	0	0
chr1:48758912:G:T	100	52	152	48	104	2.0	0.0	2.0
chr1:51361249:T:C	47	22	69	25	44	1	1	0
chr1:51408279:G:A	74	36	111	39	72	1.0	1.0	0.0
chr1:52402167:C:G	0	0	0	0	0	0	0	0
chr1:52784978:G:A	2	1	3	1	2	1.5	0.5	1.0
chr1:52854602:G:T	0	0	0	0	0	0	0	0
chr1:52881598:A:T	1	1	2	0	2	2	0	2
chr1:52899304:A:G	0	0	0	0	0	0	0	0
chr1:53069806:G:A	0	0	0	0	0	0	0	0
chr1:53142461:C:A	0	0	0	0	0	0	0	0
chr1:53213557:A:G	16	9	25	7	18	2.0	0.0	2.0
chr1:53216027:T:G	271	142	429	136	293	2	0	2
chr1:53218249:C:G	2	2	4	0	4	2.0	0.0	2.0
chr1:54133040:G:A	0	0	0	0	0	0	0	0
chr1:54136674:G:A	0	0	0	0	0	0	0	0
chr1:54179186:C:T	1	0	1	1	0	1	1	0
chr1:54195477:C:T	4	4	8	0	8	2.0	0.0	2.0
chr1:54225194:G:A	12	5	17	7	10	1.0	1.0	0.0
chr1:54653471:A:G	0	0	0	0	0	0	0	0
chr1:54653616:G:C	0	0	0	0	0	0	0	0
chr1:54653842:T:G	0	0	0	0	0	0	0	0
chr1:54670856:T:C	0	0	0	0	0	0	0	0
chr1:54674111:C:T	0	0	0	0	0	0	0	0
chr1:54701169:C:T	0	0	0	0	0	0	0	0
chr1:54702209:G:T	0	0	0	0	0	0	0	0
chr1:54758458:T:C	1	0	1	1	0	1	1	0
chr1:54759078:C:A	1	0	1	1	0	1	1	0
chr1:54801172:C:T	2	1	3	1	2	1.5	0.5	1.0
chr1:54806101:A:G	0	0	0	0	0	0	0	0
chr1:54807907:G:T	0	0	0	0	0	0	0	0
chr1:54841634:G:A	0	0	0	0	0	0	0	0
chr1:54852435:C:T	1	0	1	1	0	1	1	0
chr1:54853335:T:C	0	0	0	0	0	0	0	0
chr1:54854229:A:G	0	0	0	0	0	0	0	0
chr1:55008589:G:A	0	0	0	0	0	0	0	0
chr1:55008652:A:C	0	0	0	0	0	0	0	0
chr1:55052188:C:G	0	0	0	0	0	0	0	0
chr1:55052210:C:G	0	0	0	0	0	0	0	0
chr1:56912476:GC:TT	0	0	0	0	0	0	0	0
chr1:56912525:T:C	0	0	0	0	0	0	0	0
chr1:56917642:G:C	0	0	0	0	0	0	0	0
chr1:58631496:C:T	0	0	0	0	0	0	0	0
chr1:58631500:C:T	0	0	0	0	0	0	0	0
chr1:58682254:T:C	59	38	98	22	76	2	0	2
chr1:59321678:T:G	68	37	108	32	76	2.0	0.0	2.0
chr1:59378799:G:A	134	57	192	78	114	1.0	1.0	0.0
chr1:61277488:G:A	0	0	0	0	0	0	0	0
chr1:61404111:G:A	0	0	0	0	0	0	0	0
chr1:62114219:G:T	25	14	39	11	28	2	0	2
chr1:62114235:C:T	25	10	35	15	20	1	1	0
chr1:62128921:C:T	4	4	8	0	8	2.0	0.0	2.0
chr1:62206874:G:A	0	0	0	0	0	0	0	0
chr1:62207365:T:C	0	0	0	0	0	0	0	0
chr1:62209947:C:T	0	0	0	0	0	0	0	0
chr1:62210220:A:G	0	0	0	0	0	0	0	0
chr1:63531962:A:T	40	23	63	17	46	2.0	0.0	2.0
chr1:63648630:T:C	63	30	95	33	62	1	1	0
chr1:63659697:C:T	65	33	101	33	68	2	0	2
chr1:64159159:A:G	56	34	90	22	68	2.0	0.0	2.0
chr1:64177594:C:T	4	1	5	3	2	1.0	1.0	0.0
chr1:64244208:A:G	0	0	0	0	0	0	0	0
chr1:64777783:A:G	0	0	0	0	0	0	0	0
chr1:65392462:G:A	0	0	0	0	0	0	0	0
chr1:65395004:A:C	0	0	0	0	0	0	0	0
chr1:65421330:A:C	38	16	57	23	34	1.0	1.0	0.0
chr1:65570758:A:G	3	1	4	2	2	1	1	0
chr1:65592830:A:G	3	1	4	2	2	1	1	0
chr1:65623018:C:A	0	0	0	0	0	0	0	0
chr1:65636574:G:A	0	0	0	0	0	0	0	0
chr1:66643594:G:C	0	0	0	0	0	0	0	0
chr1:66676992:T:C	0	0	0	0	0	0	0	0
chr1:67686002:C:T	8	5	15	3	12	2.0	0.0	2.0
chr1:68159195:C:T	0	0	0	0	0	0	0	0
chr1:72274951:G:A	0	0	0	0	0	0	0	0
chr1:74748706:G:C	8	4	12	4	8	1.5	0.5	1.0
chr1:75156931:C:T	0	0	0	0	0	0	0	0
chr1:75206691:A:G	4	0	4	4	0	1.0	1.0	0.0
chr1:75733100:G:A	23	8	33	15	18	1	1	0
chr1:75744250:T:C	0	0	0	0	0	0	0	0
chr1:75932287:C:T	0	0	0	0	0	0	0	0
chr1:76700150:G:C	0	0	0	0	0	0	0	0
chr1:77811292:G:A	1	0	1	1	0	1	1	0
chr1:77926761:G:A	2	1	3	1	2	1.5	0.5	1.0
chr1:78492806:C:T	0	0	0	0	0	0	0	0
chr1:78891675:G:C	0	0	0	0	0	0	0	0
chr1:81502277:T:C	0	0	0	0	0	0	0	0
chr1:81502835:A:G	0	0	0	0	0	0	0	0
chr1:81503386:A:T	0	0	0	0	0	0	0	0
chr1:83906377:G:A	0	0	0	0	0	0	0	0
chr1:84398573:G:C	0	0	0	0	0	0	0	0
chr1:84414697:T:C	0	0	0	0	0	0	0	0
chr1:84479306:A:G	257	144	414	122	292	2	0	2
chr1:84544211:A:G	3	2	5	1	4	2	0	2
chr1:84563394:C:T	170	86	259	88	171	2.0	0.5	1.5
chr1:84565947:G:A	166	84	253	85	168	2.0	0.5	2.0
chr1:84574145:G:A	36	15	51	21	30	1.0	1.0	0.0
chr1:84574272:G:A	206	101	312	109	203	1.5	1.0	0.0
chr1:85258645:C:T	217	113	338	112	226	2	1	2
chr1:85267691:C:T	304	163	488	150	338	2.0	0.0	2.0
chr1:85276238:G:C	535	220	808	344	464	1	1	0
chr1:86124899:A:G	0	0	0	0	0	0	0	0
chr1:86125265:A:G	0	0	0	0	0	0	0	0
chr1:86354584:C:T	15	9	24	6	18	2	0	2
chr1:86386938:A:G	281	135	435	157	278	2	1	0
chr1:86434649:T:C	0	0	0	0	0	0	0	0
chr1:86434689:C:G	0	0	0	0	0	0	0	0
chr1:86447582:C:T	0	0	0	0	0	0	0	0
chr1:86455221:A:G	0	0	0	0	0	0	0	0
chr1:86482292:A:T	0	0	0	0	0	0	0	0
chr1:88805891:T:C	30	11	36	20	16	1.0	1.0	0.0
chr1:89009135:A:G	7	3	10	4	6	1	1	0
chr1:89013391:C:T	18	9	29	9	20	1.5	0.5	1.0
chr1:89114258:T:C	394	216	650	199	451	2.0	0.0	2.0
chr1:89117007:G:C	373	207	623	187	436	2	0	2
chr1:89171895:G:A	0	0	0	0	0	0	0	0
chr1:89381813:G:T	0	0	0	0	0	0	0	0
chr1:89381852:C:T	0	0	0	0	0	0	0	0
chr1:89381885:A:G	0	0	0	0	0	0	0	0
chr1:89582689:C:T	6	3	9	3	6	1.5	0.5	1.0
chr1:90940142:G:A	88	42	131	47	84	1.0	1.0	0.0
chr1:92180464:G:A	3	1	4	2	2	1	1	0
chr1:92181666:A:G	2	0	2	2	0	1.0	1.0	0.0
chr1:92513875:G:A	0	0	0	0	0	0	0	0
chr1:94008289:T:C	0	0	0	0	0	0	0	0
chr1:94008772:T:C	0	0	0	0	0	0	0	0
chr1:94010832:C:G	0	0	0	0	0	0	0	0
chr1:94177975:T:C	0	0	0	0	0	0	0	0
chr1:94827449:A:G	0	0	0	0	0	0	0	0
chr1:94864816:G:A	0	0	0	0	0	0	0	0
chr1:100110377:G:A	19	8	27	11	16	1	1	0
chr1:101238976:G:T	11	9	20	2	18	2	0	2
chr1:102886895:A:G	0	0	0	0	0	0	0	0
chr1:107573249:C:T	2	0	2	2	0	1.0	1.0	0.0
chr1:107642679:C:G	4	3	7	1	6	2.0	0.0	2.0
chr1:108628124:C:T	0	0	0	0	0	0	0	0
chr1:108722407:G:T	0	0	0	0	0	0	0	0
chr1:108730834:A:G	0	0	0	0	0	0	0	0
chr1:108796239:G:C	83	39	122	45	77	1	1	0
chr1:108823664:C:T	0	0	0	0	0	0	0	0
chr1:108827293:G:T	0	0	0	0	0	0	0	0
chr1:108834448:C:A	0	0	0	0	0	0	0	0
chr1:108852483:C:T	0	0	0	0	0	0	0	0
chr1:108897593:G:A	0	0	0	0	0	0	0	0
chr1:108924236:G:A	16	5	21	11	10	1.0	1.0	0.0
chr1:108943574:A:G	72	37	112	35	77	1.5	0.0	1.5
chr1:109094607:C:G	92	44	146	50	96	1.5	1.0	0.0
chr1:109161739:A:G	0	0	0	0	0	0	0	0
chr1:109164639:G:A	4	2	6	2	4	1.5	0.5	1.0
chr1:109258723:C:T	0	0	0	0	0	0	0	0
chr1:109548660:C:T	393	196	619	213	406	2	1	0
chr1:109606352:C:T	2	0	2	2	0	1.0	1.0	0.0
chr1:109713407:C:T	0	0	0	0	0	0	0	0
chr1:109713598:A:C	0	0	0	0	0	0	0	0
chr1:109714906:A:T	0	0	0	0	0	0	0	0
chr1:109751367:A:G	0	0	0	0	0	0	0	0
chr1:110039158:T:G	3	2	5	1	4	2	0	2
chr1:110195674:G:A	0	0	0	0	0	0	0	0
chr1:110222913:C:G	1	0	1	1	0	1	1	0
chr1:110339822:A:G	36	16	53	21	32	1.0	1.0	0.0
chr1:110407817:C:T	24	14	41	11	30	2.0	0.0	2.0
chr1:110456232:G:A	0	0	0	0	0	0	0	0
chr1:110518047:T:C	0	0	0	0	0	0	0	0
chr1:110518440:T:C	0	0	0	0	0	0	0	0
chr1:110899207:C:T	1998	1092	4078	1528	2550	2.0	1.0	2.0
chr1:111184247:G:A	80	38	121	43	78	1.0	1.0	0.0
chr1:111230946:G:C	0	0	0	0	0	0	0	0
chr1:111230978:A:G	0	0	0	0	0	0	0	0
chr1:111996439:A:G	0	0	0	0	0	0	0	0
chr1:112449076:T:C	30	10	40	20	20	1.0	1.0	0.0
chr1:112698089:G:A	21	11	32	10	22	2	0	2
chr1:112913924:A:T	5	3	8	2	6	2	0	2
chr1:113653873:A:G	0	0	0	0	0	0	0	0
chr1:113900413:C:G	11	5	16	6	10	1	1	0
chr1:113905767:C:T	3	0	3	3	0	1	1	0
chr1:113907040:T:C	1	0	1	1	0	1	1	0
chr1:113962378:G:A	9	6	16	4	12	2	0	2
chr1:113973095:G:A	14	5	19	9	10	1.0	1.0	0.0
chr1:114137688:G:A	0	0	0	0	0	0	0	0
chr1:115768346:T:C	0	0	0	0	0	0	0	0
chr1:115992231:C:T	7	2	9	5	4	1	1	0
chr1:116066564:G:A	1	0	1	1	0	1	1	0
chr1:116133414:A:C	0	0	0	0	0	0	0	0
chr1:116579508:T:C	5	2	7	3	4	1	1	0
chr1:116768525:C:A	9	4	13	5	8	1	1	0
chr1:117018196:A:G	5	4	9	1	8	2	0	2
chr1:117018307:C:A	5	4	9	1	8	2	0	2
chr1:117060534:G:T	118	64	186	56	130	2.0	0.0	2.0
chr1:117113466:A:G	2	2	4	0	4	2.0	0.0	2.0
chr1:117118132:C:T	0	0	0	0	0	0	0	0
chr1:117368060:G:A	94	37	138	58	80	1.0	1.0	0.0
chr1:119381101:T:C	0	0	0	0	0	0	0	0
chr1:119514535:C:T	0	0	0	0	0	0	0	0
chr1:119711922:G:C	34	28	64	6	58	2.0	0.0	2.0
chr1:119742923:G:A	39	6	46	34	12	1	1	0
chr1:120069392:G:A	6	4	10	2	8	2.0	0.0	2.0
chr1:120449388:GA:AG	4	4	10	0	10	2.0	0.0	2.0
chr1:120449395:C:G	4	0	5	5	0	1.0	1.0	0.0
chr1:121096208:G:A	0	0	0	0	0	0	0	0
chr1:121118494:C:T	0	0	0	0	0	0	0	0
chr1:121374827:A:G	3	3	6	0	6	2	0	2
chr1:145872200:A:G	1	0	1	1	0	1	1	0
chr1:145872788:G:C	0	0	0	0	0	0	0	0
chr1:145872994:T:C	0	0	0	0	0	0	0	0
chr1:145873487:G:A	0	0	0	0	0	0	0	0
chr1:145898994:C:T	0	0	0	0	0	0	0	0
chr1:145927267:T:A	98	52	150	46	104	2.0	0.0	2.0
chr1:147242742:C:G	100	64	171	39	132	2.0	0.0	2.0
chr1:147242777:G:C	101	65	173	39	134	2	0	2
chr1:147287641:C:G	53	25	78	28	50	1	1	0
chr1:147620166:C:T	1	0	1	1	0	1	1	0
chr1:147624993:G:A	4	1	5	3	2	1.0	1.0	0.0
chr1:147647471:G:A	15	9	24	6	18	2	0	2
chr1:148149222:A:G	0	0	0	0	0	0	0	0
chr1:148149391:G:C	0	0	0	0	0	0	0	0
chr1:149934520:T:C	0	0	0	0	0	0	0	0
chr1:149935366:G:A	0	0	0	0	0	0	0	0
chr1:150553930:C:T	0	0	0	0	0	0	0	0
chr1:150558072:C:G	0	0	0	0	0	0	0	0
chr1:150579566:G:A	464	265	776	218	558	2.0	0.0	2.0
chr1:150706557:G:A	0	0	0	0	0	0	0	0
chr1:150755063:G:A	1740	975	3331	1139	2192	2.0	1.0	2.0
chr1:150836413:C:G	31	18	49	13	36	2	0	2
chr1:150963804:C:G	3	1	4	2	2	1	1	0
chr1:150966095:G:A	117	63	182	57	125	2	0	2
chr1:150968149:T:G	94	44	139	51	88	1.0	1.0	0.0
chr1:150986360:A:G	5	1	6	4	2	1	1	0
chr1:151142541:G:A	0	0	0	0	0	0	0	0
chr1:151286567:C:T	4	2	6	2	4	1.5	0.5	1.0
chr1:151287067:G:A	4	2	6	2	4	1.5	0.5	1.0
chr1:151369227:G:A	0	0	0	0	0	0	0	0
chr1:151540326:G:T	17	10	28	8	20	2	0	2
chr1:151662327:G:A	1	1	2	0	2	2	0	2
chr1:151763100:T:C	303	142	453	174	279	1	1	0
chr1:151837828:G:C	1	1	2	0	2	2	0	2
chr1:152085318:G:C	0	0	0	0	0	0	0	0
chr1:152107347:C:G	0	0	0	0	0	0	0	0
chr1:152107513:T:G	0	0	0	0	0	0	0	0
chr1:152109445:G:C	0	0	0	0	0	0	0	0
chr1:152220349:C:T	0	0	0	0	0	0	0	0
chr1:152220810:G:T	0	0	0	0	0	0	0	0
chr1:152313650:A:G	0	0	0	0	0	0	0	0
chr1:152511653:G:A	0	0	0	0	0	0	0	0
chr1:152515503:C:T	0	0	0	0	0	0	0	0
chr1:152515587:C:T	0	0	0	0	0	0	0	0
chr1:152686995:T:G	0	0	0	0	0	0	0	0
chr1:152687003:G:A	0	0	0	0	0	0	0	0
chr1:152719598:G:C	0	0	0	0	0	0	0	0
chr1:152719996:A:C	0	0	0	0	0	0	0	0
chr1:152720036:G:A	0	0	0	0	0	0	0	0
chr1:152720112:A:G	0	0	0	0	0	0	0	0
chr1:152720305:G:T	0	0	0	0	0	0	0	0
chr1:152759698:T:C	0	0	0	0	0	0	0	0
chr1:152760091:G:A	0	0	0	0	0	0	0	0
chr1:152787599:A:G	0	0	0	0	0	0	0	0
chr1:152805098:G:A	0	0	0	0	0	0	0	0
chr1:152805392:A:G	0	0	0	0	0	0	0	0
chr1:152805432:C:T	0	0	0	0	0	0	0	0
chr1:152805488:G:A	0	0	0	0	0	0	0	0
chr1:152910134:A:G	0	0	0	0	0	0	0	0
chr1:152910506:C:G	0	0	0	0	0	0	0	0
chr1:152911132:G:A	0	0	0	0	0	0	0	0
chr1:152911204:A:G	0	0	0	0	0	0	0	0
chr1:152911235:G:C	0	0	0	0	0	0	0	0
chr1:152911635:G:A	0	0	0	0	0	0	0	0
chr1:152972118:C:T	0	0	0	0	0	0	0	0
chr1:153149834:G:A	0	0	0	0	0	0	0	0
chr1:153297886:C:G	0	0	0	0	0	0	0	0
chr1:153360697:A:T	0	0	0	0	0	0	0	0
chr1:153373787:A:G	0	0	0	0	0	0	0	0
chr1:153390629:T:C	0	0	0	0	0	0	0	0
chr1:153438346:C:A	0	0	0	0	0	0	0	0
chr1:153607688:G:C	0	0	0	0	0	0	0	0
chr1:153614832:C:T	8	0	8	8	0	1.0	1.0	0.0
chr1:153615864:C:T	8	8	18	0	18	2.0	0.0	2.0
chr1:153631636:G:A	5	1	6	4	2	1	1	0
chr1:153941208:C:A	2	0	2	2	0	1.0	1.0	0.0
chr1:153960489:C:T	133	76	213	59	154	2	0	2
chr1:153982198:T:C	3	1	4	2	2	1	1	0
chr1:154263181:G:A	39	19	58	20	38	1	1	0
chr1:154321199:G:A	0	0	0	0	0	0	0	0
chr1:154323116:C:T	0	0	0	0	0	0	0	0
chr1:154323600:T:C	0	0	0	0	0	0	0	0
chr1:154324336:C:T	0	0	0	0	0	0	0	0
chr1:154331500:T:C	17	8	25	9	16	1	1	0
chr1:154343958:C:T	3	1	4	2	2	1	1	0
chr1:154348466:A:G	4	2	6	2	4	1.5	0.5	1.0
chr1:154349187:C:T	5	3	8	2	6	2	0	2
chr1:154378597:T:C	0	0	0	0	0	0	0	0
chr1:154772331:C:G	0	0	0	0	0	0	0	0
chr1:154945876:G:A	114	65	182	50	132	2.0	0.0	2.0
chr1:154946604:C:T	178	82	273	111	162	1.0	1.0	0.0
chr1:155016481:A:G	9	6	15	3	12	2	0	2
chr1:155054395:G:T	26	13	39	13	26	1.5	0.5	1.0
chr1:155061442:C:T	7	3	10	4	6	1	1	0
chr1:155260340:C:T	296	145	457	159	298	1.5	1.0	0.0
chr1:155261754:T:G	30	15	45	15	30	1.5	0.5	1.0
chr1:155290559:A:G	0	0	0	0	0	0	0	0
chr1:155290592:G:T	0	0	0	0	0	0	0	0
chr1:155321640:C:T	1	0	1	1	0	1	1	0
chr1:155859720:C:T	109	48	158	62	96	1	1	0
chr1:155933617:C:T	91	40	133	51	82	1	1	0
chr1:156041653:T:C	16	11	27	5	22	2.0	0.0	2.0
chr1:156137743:C:T	60	38	154	44	110	2.0	1.0	2.0
chr1:156176427:C:T	64	32	96	32	64	1.5	0.5	1.0
chr1:156298971:G:A	0	0	0	0	0	0	0	0
chr1:156377340:G:A	0	0	0	0	0	0	0	0
chr1:156381908:G:A	0	0	0	0	0	0	0	0
chr1:156384502:A:G	0	0	0	0	0	0	0	0
chr1:156384575:A:G	0	0	0	0	0	0	0	0
chr1:156404464:C:T	3	2	5	1	4	2	0	2
chr1:156477111:T:C	11	6	17	5	12	2	0	2
chr1:156480927:G:A	21	13	34	8	26	2	0	2
chr1:156480948:G:A	21	8	29	13	16	1	1	0
chr1:156530177:T:C	0	0	0	0	0	0	0	0
chr1:156548587:G:A	0	0	0	0	0	0	0	0
chr1:156556595:C:G	0	0	0	0	0	0	0	0
chr1:156582056:A:G	12	2	14	10	4	1.0	1.0	0.0
chr1:156596042:G:C	19	9	27	10	17	1	1	0
chr1:156647022:C:G	0	0	0	0	0	0	0	0
chr1:156652460:G:A	0	0	0	0	0	0	0	0
chr1:156669961:G:A	0	0	0	0	0	0	0	0
chr1:156670364:G:A	0	0	0	0	0	0	0	0
chr1:156670886:G:A	0	0	0	0	0	0	0	0
chr1:156671745:C:T	0	0	0	0	0	0	0	0
chr1:156723343:C:T	64	37	103	29	74	2.0	0.0	2.0
chr1:156743766:G:A	40	23	63	17	46	2.0	0.0	2.0
chr1:156815190:T:C	1	1	2	0	2	2	0	2
chr1:156815825:G:A	0	0	0	0	0	0	0	0
chr1:156858662:C:A	0	0	0	0	0	0	0	0
chr1:156876441:G:A	0	0	0	0	0	0	0	0
chr1:156879203:C:T	0	0	0	0	0	0	0	0
chr1:156910398:C:A	0	0	0	0	0	0	0	0
chr1:157059342:T:C	0	0	0	0	0	0	0	0
chr1:157060488:T:C	0	0	0	0	0	0	0	0
chr1:157092572:G:A	0	0	0	0	0	0	0	0
chr1:157092904:G:T	0	0	0	0	0	0	0	0
chr1:157092947:C:G	0	0	0	0	0	0	0	0
chr1:157597961:A:G	0	0	0	0	0	0	0	0
chr1:157678581:T:G	15	3	18	12	6	1	1	0
chr1:157768584:G:C	37	17	54	20	34	1	1	0
chr1:157802090:C:T	40	18	58	22	36	1.0	1.0	0.0
chr1:158177156:T:C	0	0	0	0	0	0	0	0
chr1:158256877:C:T	0	0	0	0	0	0	0	0
chr1:158354635:A:G	0	0	0	0	0	0	0	0
chr1:158398751:A:G	0	0	0	0	0	0	0	0
chr1:158399056:T:C	0	0	0	0	0	0	0	0
chr1:158677732:A:G	0	0	0	0	0	0	0	0
chr1:158718106:C:T	0	0	0	0	0	0	0	0
chr1:158754747:T:C	0	0	0	0	0	0	0	0
chr1:158766655:C:T	0	0	0	0	0	0	0	0
chr1:158844029:A:G	56	35	93	21	72	2.0	0.0	2.0
chr1:159199851:T:C	0	0	0	0	0	0	0	0
chr1:159205403:A:G	0	0	0	0	0	0	0	0
chr1:159440067:A:G	0	0	0	0	0	0	0	0
chr1:159440550:T:A	0	0	0	0	0	0	0	0
chr1:159535507:C:T	0	0	0	0	0	0	0	0
chr1:159809120:G:A	0	0	0	0	0	0	0	0
chr1:159809193:T:C	0	0	0	0	0	0	0	0
chr1:159855177:G:C	3	1	4	2	2	1	1	0
chr1:159927336:C:T	1	1	2	0	2	2	0	2
chr1:159932736:T:C	0	0	0	0	0	0	0	0
chr1:160155085:G:A	0	0	0	0	0	0	0	0
chr1:160164415:C:T	0	0	0	0	0	0	0	0
chr1:160190695:C:T	0	0	0	0	0	0	0	0
chr1:160339874:T:G	295	156	470	149	321	2	0	2
chr1:160424115:A:G	0	0	0	0	0	0	0	0
chr1:160425147:A:C	0	0	0	0	0	0	0	0
chr1:160425213:G:A	0	0	0	0	0	0	0	0
chr1:160801971:C:A	97	54	154	44	110	2	0	2
chr1:160823652:A:G	77	43	122	37	85	2	0	2
chr1:160823770:A:G	78	43	124	38	86	2.0	0.0	2.0
chr1:160827894:A:G	86	46	136	44	92	2.0	0.0	2.0
chr1:160881378:T:A	0	0	0	0	0	0	0	0
chr1:160950651:A:G	1	0	1	1	0	1	1	0
chr1:160998819:G:A	80	44	125	37	88	2.0	0.0	2.0
chr1:161001178:G:A	14	6	20	8	12	1.0	1.0	0.0
chr1:161001225:G:C	18	6	24	12	12	1.0	1.0	0.0
chr1:161021085:TCCC:CACT	54	28	82	26	56	2.0	0.0	2.0
chr1:161021116:G:A	49	22	71	27	44	1	1	0
chr1:161041527:A:G	2	1	3	1	2	1.5	0.5	1.0
chr1:161041565:G:C	2	1	3	1	2	1.5	0.5	1.0
chr1:161051367:G:C	174	97	275	77	198	2.0	0.0	2.0
chr1:161163031:C:A	11	6	17	5	12	2	0	2
chr1:161193247:T:C	0	0	0	0	0	0	0	0
chr1:161215268:G:T	39	19	64	20	44	1	1	0
chr1:161525687:A:T	1	1	2	0	2	2	0	2
chr1:161526095:T:C	1	1	2	0	2	2	0	2
chr1:161595689:G:A	12	3	15	9	6	1.0	1.0	0.0
chr1:161607879:G:A	12	6	18	6	12	1.5	0.5	1.0
chr1:161630004:C:T	0	0	0	0	0	0	0	0
chr1:161631042:G:T	0	0	0	0	0	0	0	0
chr1:161707180:A:G	0	0	0	0	0	0	0	0
chr1:161710468:G:A	12	6	18	6	12	1.5	0.5	1.0
chr1:161713346:G:A	1687	1067	3523	977	2546	2	1	2
chr1:161725849:G:T	12	7	19	5	14	2.0	0.0	2.0
chr1:161726992:G:C	55	37	92	18	74	2	0	2
chr1:161751917:C:T	157	92	260	70	190	2	0	2
chr1:161958537:A:G	39	27	67	13	54	2	0	2
chr1:161983610:G:A	0	0	0	0	0	0	0	0
chr1:161997891:A:G	0	0	0	0	0	0	0	0
chr1:162343945:C:T	0	0	0	0	0	0	0	0
chr1:162365262:C:T	0	0	0	0	0	0	0	0
chr1:162397281:C:T	0	0	0	0	0	0	0	0
chr1:162854763:G:A	0	0	0	0	0	0	0	0
chr1:162855667:C:A	0	0	0	0	0	0	0	0
chr1:165249555:G:A	0	0	0	0	0	0	0	0
chr1:165408315:G:A	0	0	0	0	0	0	0	0
chr1:166849329:A:G	16	12	28	4	24	2.0	0.0	2.0
chr1:166989364:T:C	0	0	0	0	0	0	0	0
chr1:166989473:T:G	0	0	0	0	0	0	0	0
chr1:167125926:G:C	0	0	0	0	0	0	0	0
chr1:167126528:G:A	0	0	0	0	0	0	0	0
chr1:167126644:G:A	0	0	0	0	0	0	0	0
chr1:167128502:C:A	0	0	0	0	0	0	0	0
chr1:167848401:A:G	0	0	0	0	0	0	0	0
chr1:167856247:T:C	0	0	0	0	0	0	0	0
chr1:168056007:T:C	13	0	13	13	0	1	1	0
chr1:168056024:A:G	13	0	13	13	0	1	1	0
chr1:168056162:G:C	13	0	13	13	0	1	1	0
chr1:168056171:A:G	13	0	13	13	0	1	1	0
chr1:168313023:T:A	7	1	8	6	2	1	1	0
chr1:169529737:T:C	1	1	2	0	2	2	0	2
chr1:169541142:G:A	0	0	0	0	0	0	0	0
chr1:169541286:A:G	0	0	0	0	0	0	0	0
chr1:169542317:T:C	4	1	5	3	2	1.0	1.0	0.0
chr1:169542496:T:C	4	2	6	2	4	1.5	0.5	1.0
chr1:169542517:T:C	4	2	6	2	4	1.5	0.5	1.0
chr1:169546488:C:T	2	2	4	0	4	2.0	0.0	2.0
chr1:169550656:G:A	2	2	4	0	4	2.0	0.0	2.0
chr1:169704697:G:A	805	412	1351	479	872	2	1	2
chr1:169708568:A:G	815	413	1365	489	876	2	1	2
chr1:169725777:A:G	0	0	0	0	0	0	0	0
chr1:169727805:G:A	4	2	6	2	4	1.5	0.5	1.0
chr1:169793666:T:G	66	35	101	31	70	2.0	0.0	2.0
chr1:170552235:G:A	12	3	16	10	6	1.0	1.0	0.0
chr1:170959530:T:C	15	5	19	10	9	1	1	0
chr1:171209013:A:G	0	0	0	0	0	0	0	0
chr1:171514578:A:C	617	294	979	363	616	1	1	0
chr1:171540188:G:A	56	31	87	25	62	2.0	0.0	2.0
chr1:171541900:C:G	55	24	79	31	48	1	1	0
chr1:171545592:C:G	36	17	53	19	34	1.0	1.0	0.0
chr1:171557431:G:A	13	5	18	8	10	1	1	0
chr1:171587026:G:C	159	120	284	42	242	2	0	2
chr1:171670579:T:C	0	0	0	0	0	0	0	0
chr1:171987663:C:T	3	3	6	0	6	2	0	2
chr1:172589384:A:G	5	1	6	4	2	1	1	0
chr1:173487878:C:T	1129	626	2000	639	1361	2	1	2
chr1:173839539:G:A	7	4	11	3	8	2	0	2
chr1:173938674:C:T	15	6	21	9	12	1	1	0
chr1:174219147:G:A	329	154	503	187	316	1	1	0
chr1:175098444:T:C	0	0	0	0	0	0	0	0
chr1:175123538:C:T	0	0	0	0	0	0	0	0
chr1:175128728:G:A	0	0	0	0	0	0	0	0
chr1:175147116:C:G	0	0	0	0	0	0	0	0
chr1:175330165:T:C	0	0	0	0	0	0	0	0
chr1:175355515:A:G	0	0	0	0	0	0	0	0
chr1:175406333:C:A	0	0	0	0	0	0	0	0
chr1:175406547:T:C	0	0	0	0	0	0	0	0
chr1:175406666:T:C	0	0	0	0	0	0	0	0
chr1:176840232:C:T	0	0	0	0	0	0	0	0
chr1:177023417:A:G	0	0	0	0	0	0	0	0
chr1:177023540:C:T	0	0	0	0	0	0	0	0
chr1:177278718:C:G	0	0	0	0	0	0	0	0
chr1:177933252:C:A	1	1	2	0	2	2	0	2
chr1:177933253:G:A	1	0	2	2	0	2	2	0
chr1:177936334:C:A	1	1	2	0	2	2	0	2
chr1:178514096:G:A	0	0	0	0	0	0	0	0
chr1:178520843:T:G	0	0	0	0	0	0	0	0
chr1:179351443:A:G	17	12	29	5	24	2	0	2
chr1:179882939:T:C	125	70	198	58	140	2	0	2
chr1:179917990:G:A	54	28	86	28	58	2.0	1.0	2.0
chr1:180084023:A:C	34	24	58	10	48	2.0	0.0	2.0
chr1:180271375:T:C	0	0	0	0	0	0	0	0
chr1:180984717:A:G	25	9	36	16	20	1	1	0
chr1:181049122:G:A	38	19	57	19	38	1.5	0.5	1.0
chr1:181732663:T:A	0	0	0	0	0	0	0	0
chr1:181737549:C:T	0	0	0	0	0	0	0	0
chr1:181755974:T:C	0	0	0	0	0	0	0	0
chr1:182057678:G:C	0	0	0	0	0	0	0	0
chr1:182057887:C:T	0	0	0	0	0	0	0	0
chr1:182385715:A:G	105	5	114	104	10	1	1	0
chr1:182385911:A:G	23	0	25	25	0	1	1	0
chr1:182387264:A:G	187	8	205	189	16	1	1	0
chr1:182399943:G:A	0	0	0	0	0	0	0	0
chr1:182400098:A:G	0	0	0	0	0	0	0	0
chr1:182575446:C:T	5	3	8	2	6	2	0	2
chr1:182582202:A:C	36	21	58	16	42	2.0	0.0	2.0
chr1:182585422:C:T	34	19	54	16	38	2.0	0.0	2.0
chr1:182586901:A:G	33	18	52	16	36	2	0	2
chr1:182604281:C:T	2	0	2	2	0	1.0	1.0	0.0
chr1:182952932:G:T	0	0	0	0	0	0	0	0
chr1:183136399:T:C	1	0	1	1	0	1	1	0
chr1:183136570:G:A	2	0	2	2	0	1.0	1.0	0.0
chr1:183215481:C:T	0	0	0	0	0	0	0	0
chr1:183218468:C:T	0	0	0	0	0	0	0	0
chr1:183223169:T:G	0	0	0	0	0	0	0	0
chr1:183232835:G:C	0	0	0	0	0	0	0	0
chr1:183237438:G:A	0	0	0	0	0	0	0	0
chr1:183243413:T:G	0	0	0	0	0	0	0	0
chr1:183635770:A:G	141	71	219	73	146	2	1	1
chr1:183647791:T:C	0	0	0	0	0	0	0	0
chr1:183647970:A:G	0	0	0	0	0	0	0	0
chr1:183648131:C:G	0	0	0	0	0	0	0	0
chr1:183940583:G:A	0	0	0	0	0	0	0	0
chr1:184708330:G:A	3	0	3	3	0	1	1	0
chr1:184831931:T:C	0	0	0	0	0	0	0	0
chr1:186015385:T:C	0	0	0	0	0	0	0	0
chr1:186057342:T:C	0	0	0	0	0	0	0	0
chr1:186081285:A:G	0	0	0	0	0	0	0	0
chr1:186132407:A:G	0	0	0	0	0	0	0	0
chr1:192247100:A:G	0	0	0	0	0	0	0	0
chr1:192352059:C:T	0	0	0	0	0	0	0	0
chr1:193105381:A:G	127	77	213	55	158	2	0	2
chr1:196673103:G:A	0	0	0	0	0	0	0	0
chr1:196741786:T:C	0	0	0	0	0	0	0	0
chr1:196907328:A:G	0	0	0	0	0	0	0	0
chr1:196977645:T:C	0	0	0	0	0	0	0	0
chr1:197061891:C:T	0	0	0	0	0	0	0	0
chr1:197101685:T:C	0	0	0	0	0	0	0	0
chr1:197122407:A:T	0	0	0	0	0	0	0	0
chr1:197477572:G:T	0	0	0	0	0	0	0	0
chr1:197735587:C:T	9	5	14	4	10	2	0	2
chr1:197905819:T:C	12	7	19	5	14	2.0	0.0	2.0
chr1:198319579:A:G	7	3	10	4	6	1	1	0
chr1:200553438:G:C	0	0	0	0	0	0	0	0
chr1:201043469:G:A	0	0	0	0	0	0	0	0
chr1:201069559:A:G	0	0	0	0	0	0	0	0
chr1:201077947:A:G	0	0	0	0	0	0	0	0
chr1:201077983:A:G	0	0	0	0	0	0	0	0
chr1:201083182:AGA:TGC	0	0	0	0	0	0	0	0
chr1:201197307:T:C	0	0	0	0	0	0	0	0
chr1:201206146:A:G	0	0	0	0	0	0	0	0
chr1:201211017:GAGA:AAGG	0	0	0	0	0	0	0	0
chr1:201211025:A:G	0	0	0	0	0	0	0	0
chr1:201218636:T:C	0	0	0	0	0	0	0	0
chr1:201225991:C:T	0	0	0	0	0	0	0	0
chr1:201365254:G:A	1	0	1	1	0	1	1	0
chr1:201381855:C:T	0	0	0	0	0	0	0	0
chr1:201891888:C:G	1	1	2	0	2	2	0	2
chr1:201899205:C:T	0	0	0	0	0	0	0	0
chr1:201965450:G:A	185	92	294	104	190	2	1	0
chr1:201999954:G:A	64	33	101	31	70	2.0	0.0	2.0
chr1:202001620:G:A	3	1	5	3	2	2	1	0
chr1:202005584:G:C	70	32	103	39	64	1.0	1.0	0.0
chr1:202161263:G:T	1	1	2	0	2	2	0	2
chr1:202214180:C:T	0	0	0	0	0	0	0	0
chr1:202307366:C:T	2	1	3	1	2	1.5	0.5	1.0
chr1:202335740:T:C	132	71	204	63	141	2.0	0.0	2.0
chr1:202445215:G:A	1	1	2	0	2	2	0	2
chr1:202596820:G:A	1	1	2	0	2	2	0	2
chr1:202605656:G:A	0	0	0	0	0	0	0	0
chr1:202729218:G:T	4	2	6	2	4	1.5	0.5	1.0
chr1:202733925:G:A	6	5	11	1	10	2.0	0.0	2.0
chr1:202736327:G:C	7	3	10	4	6	1	1	0
chr1:202741605:C:G	10	6	16	4	12	2.0	0.0	2.0
chr1:202746156:G:A	7	3	10	4	6	1	1	0
chr1:202748900:A:G	4	3	7	1	6	2.0	0.0	2.0
chr1:202749074:G:A	5	3	8	2	6	2	0	2
chr1:202919819:T:C	39	20	59	19	40	2	0	2
chr1:203055639:C:T	0	0	0	0	0	0	0	0
chr1:203059243:G:T	0	0	0	0	0	0	0	0
chr1:203063794:C:T	0	0	0	0	0	0	0	0
chr1:203183673:T:C	0	0	0	0	0	0	0	0
chr1:203486970:T:C	0	0	0	0	0	0	0	0
chr1:203739644:C:T	1	0	1	1	0	1	1	0
chr1:203739906:A:G	0	0	0	0	0	0	0	0
chr1:203773994:G:A	21	8	29	13	16	1	1	0
chr1:203774525:C:T	18	7	25	11	14	1.0	1.0	0.0
chr1:203799200:T:C	6	3	9	3	6	1.5	0.5	1.0
chr1:203800404:G:A	27	11	38	16	22	1	1	0
chr1:203849845:C:A	29	19	48	10	38	2	0	2
chr1:204202962:G:A	0	0	0	0	0	0	0	0
chr1:204229081:A:G	0	0	0	0	0	0	0	0
chr1:204230486:C:T	0	0	0	0	0	0	0	0
chr1:204261453:G:A	0	0	0	0	0	0	0	0
chr1:204268288:C:T	0	0	0	0	0	0	0	0
chr1:205009515:C:A	1	0	1	1	0	1	1	0
chr1:205009576:G:A	1	0	1	1	0	1	1	0
chr1:205066327:A:G	0	0	0	0	0	0	0	0
chr1:205069603:C:T	0	0	0	0	0	0	0	0
chr1:205083811:G:A	2	0	2	2	0	1.0	1.0	0.0
chr1:205084091:C:T	1	0	1	1	0	1	1	0
chr1:205256329:G:A	0	0	0	0	0	0	0	0
chr1:205269147:A:G	0	0	0	0	0	0	0	0
chr1:205269402:C:T	0	0	0	0	0	0	0	0
chr1:205271123:C:T	0	0	0	0	0	0	0	0
chr1:205303798:C:T	25	12	37	13	24	1	1	0
chr1:205303855:C:G	25	12	37	13	24	1	1	0
chr1:205304014:G:C	22	11	33	11	22	1.5	0.5	1.0
chr1:205531415:T:C	0	0	0	0	0	0	0	0
chr1:205592244:C:T	8	4	11	4	7	1.0	0.5	0.5
chr1:205599085:C:T	0	0	0	0	0	0	0	0
chr1:205620446:C:T	22	8	32	14	18	1.0	1.0	0.0
chr1:205775010:G:T	142	64	210	82	128	1.0	1.0	0.0
chr1:205798757:G:A	3	2	5	1	4	2	0	2
chr1:205810103:G:A	6	3	9	3	6	1.5	0.5	1.0
chr1:205832744:A:G	4	0	4	4	0	1.0	1.0	0.0
chr1:206012565:A:G	0	0	0	0	0	0	0	0
chr1:206013858:A:G	0	0	0	0	0	0	0	0
chr1:206101757:A:G	15	1	16	14	2	1	1	0
chr1:206474804:T:G	0	0	0	0	0	0	0	0
chr1:206595698:T:C	6	2	8	4	4	1.0	1.0	0.0
chr1:206842612:T:C	0	0	0	0	0	0	0	0
chr1:206901560:T:C	0	0	0	0	0	0	0	0
chr1:206914090:C:T	1533	919	3016	907	2109	2	1	2
chr1:206935771:C:T	0	0	0	0	0	0	0	0
chr1:206937591:T:C	0	0	0	0	0	0	0	0
chr1:206967095:C:T	0	0	0	0	0	0	0	0
chr1:206970205:C:T	1	1	2	0	2	2	0	2
chr1:207062609:G:A	0	0	0	0	0	0	0	0
chr1:207126725:G:A	0	0	0	0	0	0	0	0
chr1:207131555:T:C	0	0	0	0	0	0	0	0
chr1:207609362:A:G	0	0	0	0	0	0	0	0
chr1:207708212:A:G	0	0	0	0	0	0	0	0
chr1:207717521:T:C	0	0	0	0	0	0	0	0
chr1:207767846:G:T	21	10	30	11	19	1	1	0
chr1:208034494:G:A	0	0	0	0	0	0	0	0
chr1:208096748:C:T	0	0	0	0	0	0	0	0
chr1:208216741:G:C	0	0	0	0	0	0	0	0
chr1:208217124:C:T	0	0	0	0	0	0	0	0
chr1:208217909:C:T	0	0	0	0	0	0	0	0
chr1:209615169:G:A	0	0	0	0	0	0	0	0
chr1:209625908:A:G	0	0	0	0	0	0	0	0
chr1:209634627:G:A	0	0	0	0	0	0	0	0
chr1:209638541:T:G	0	0	0	0	0	0	0	0
chr1:209650009:G:A	0	0	0	0	0	0	0	0
chr1:209759986:A:G	285	122	423	172	251	1	1	0
chr1:209760195:A:G	291	125	432	174	258	1	1	0
chr1:209837179:G:A	11	10	21	1	20	2	0	2
chr1:211278125:T:C	57	24	81	33	48	1	1	0
chr1:211663447:T:C	0	0	0	0	0	0	0	0
chr1:212414864:C:G	128	64	195	65	130	2.0	0.5	1.0
chr1:212625635:A:G	0	0	0	0	0	0	0	0
chr1:212625738:A:G	0	0	0	0	0	0	0	0
chr1:212626607:C:T	0	0	0	0	0	0	0	0
chr1:212738494:T:C	259	125	394	142	252	1	1	0
chr1:212836127:A:G	4	4	8	0	8	2.0	0.0	2.0
chr1:212858367:C:T	20	9	29	11	18	1.0	1.0	0.0
chr1:212858606:G:C	17	7	24	10	14	1	1	0
chr1:213051377:T:C	191	93	285	100	185	1	1	0
chr1:214464829:C:T	0	0	0	0	0	0	0	0
chr1:214657274:A:G	0	0	0	0	0	0	0	0
chr1:214663767:C:G	0	0	0	0	0	0	0	0
chr1:215675245:T:C	0	0	0	0	0	0	0	0
chr1:215786825:T:G	0	0	0	0	0	0	0	0
chr1:216519327:C:T	0	0	0	0	0	0	0	0
chr1:217631425:A:G	8	5	13	3	10	2.0	0.0	2.0
chr1:219173874:T:C	86	43	136	44	92	2.0	0.5	1.0
chr1:219609937:T:A	0	0	0	0	0	0	0	0
chr1:219968728:C:T	70	39	111	31	80	2.0	0.0	2.0
chr1:221739466:T:C	48	35	85	14	71	2.0	0.0	2.0
chr1:222943130:GAG:AAT	57	28	86	30	56	2	1	0
chr1:223111186:A:G	0	0	0	0	0	0	0	0
chr1:223394461:G:A	0	0	0	0	0	0	0	0
chr1:223544122:A:G	0	0	0	0	0	0	0	0
chr1:223545156:A:C	0	0	0	0	0	0	0	0
chr1:223625884:G:T	0	0	0	0	0	0	0	0
chr1:224175668:A:T	0	0	0	0	0	0	0	0
chr1:224294382:C:T	31	17	48	14	34	2	0	2
chr1:224398256:A:C	1	0	1	1	0	1	1	0
chr1:225345982:A:G	0	0	0	0	0	0	0	0
chr1:225423959:C:T	167	82	257	87	170	1	1	0
chr1:225831952:G:A	32	28	59	4	55	2.0	0.0	2.0
chr1:225862909:C:A	38	17	55	21	34	1.0	1.0	0.0
chr1:225886863:T:G	0	0	0	0	0	0	0	0
chr1:225887908:G:A	0	0	0	0	0	0	0	0
chr1:225920617:C:T	372	219	622	172	450	2.0	0.0	2.0
chr1:226385663:A:G	69	39	109	31	78	2	0	2
chr1:226402132:T:C	3	3	6	0	6	2	0	2
chr1:226735563:G:A	11	5	16	6	10	1	1	0
chr1:226735804:G:T	9	3	12	6	6	1	1	0
chr1:226736237:A:C	10	3	13	7	6	1.0	1.0	0.0
chr1:226881976:T:C	25	12	37	13	24	1	1	0
chr1:226882036:C:T	26	13	39	13	26	1.5	0.5	1.0
chr1:226883824:C:T	21	12	33	9	24	2	0	2
chr1:226982597:A:G	2	1	3	1	2	1.5	0.5	1.0
chr1:226984589:C:T	53	16	69	37	32	1	1	0
chr1:226986509:T:C	57	18	76	40	36	1	1	0
chr1:226994222:C:T	0	0	0	0	0	0	0	0
chr1:227029074:C:T	0	0	0	0	0	0	0	0
chr1:227732360:T:G	93	51	148	46	102	2	0	2
chr1:227732402:G:A	106	54	164	56	108	2.0	1.0	2.0
chr1:227732746:C:T	15	5	20	10	10	1	1	0
chr1:227735217:A:C	81	45	131	41	90	2	0	2
chr1:227747743:A:G	115	54	169	61	108	1	1	0
chr1:227775790:G:T	5	2	7	3	4	1	1	0
chr1:227816138:C:T	0	0	0	0	0	0	0	0
chr1:227925462:A:G	1	0	1	1	0	1	1	0
chr1:228102142:C:T	241	121	375	128	247	2	1	1
chr1:228102275:A:G	103	49	156	56	100	1	1	0
chr1:228174981:G:A	3	3	6	0	6	2	0	2
chr1:228211781:C:G	0	0	0	0	0	0	0	0
chr1:228211918:G:C	0	0	0	0	0	0	0	0
chr1:228212065:T:C	0	0	0	0	0	0	0	0
chr1:228214346:A:G	2	1	3	1	2	1.5	0.5	1.0
chr1:228214420:A:G	2	1	3	1	2	1.5	0.5	1.0
chr1:228214807:C:T	2	1	3	1	2	1.5	0.5	1.0
chr1:228219559:G:A	0	0	0	0	0	0	0	0
chr1:228224526:TG:CA	0	0	0	0	0	0	0	0
chr1:228224607:G:A	0	0	0	0	0	0	0	0
chr1:228243394:A:G	0	0	0	0	0	0	0	0
chr1:228245516:A:G	0	0	0	0	0	0	0	0
chr1:228246694:T:C	0	0	0	0	0	0	0	0
chr1:228246766:T:C	0	0	0	0	0	0	0	0
chr1:228273358:G:A	0	0	0	0	0	0	0	0
chr1:228273428:A:G	0	0	0	0	0	0	0	0
chr1:228276547:T:G	0	0	0	0	0	0	0	0
chr1:228276575:T:C	0	0	0	0	0	0	0	0
chr1:228277645:A:G	0	0	0	0	0	0	0	0
chr1:228283678:G:C	0	0	0	0	0	0	0	0
chr1:228292581:A:G	0	0	0	0	0	0	0	0
chr1:228294309:C:T	1	1	2	0	2	2	0	2
chr1:228294868:G:A	1	0	1	1	0	1	1	0
chr1:228307089:G:A	0	0	0	0	0	0	0	0
chr1:228315976:A:G	0	0	0	0	0	0	0	0
chr1:228316771:T:C	0	0	0	0	0	0	0	0
chr1:228316969:C:T	0	0	0	0	0	0	0	0
chr1:228317967:C:G	0	0	0	0	0	0	0	0
chr1:228317998:T:C	0	0	0	0	0	0	0	0
chr1:228321726:A:G	0	0	0	0	0	0	0	0
chr1:228333272:C:G	1	1	2	0	2	2	0	2
chr1:228338964:T:C	1	1	2	0	2	2	0	2
chr1:228340862:C:G	1	1	2	0	2	2	0	2
chr1:228360200:C:T	2	1	3	1	2	1.5	0.5	1.0
chr1:228372293:C:T	0	0	0	0	0	0	0	0
chr1:228372999:T:C	0	0	0	0	0	0	0	0
chr1:228494048:C:T	14	8	22	6	16	2.0	0.0	2.0
chr1:228511776:T:C	0	0	0	0	0	0	0	0
chr1:229325277:C:T	13	8	23	5	18	2	0	2
chr1:229495987:T:C	20	10	30	10	20	1.5	0.5	1.0
chr1:229499774:A:G	27	18	45	9	36	2	0	2
chr1:229547517:G:A	23	10	34	14	20	1	1	0
chr1:229594705:G:A	14	4	18	10	8	1.0	1.0	0.0
chr1:229602423:T:G	15	6	21	9	12	1	1	0
chr1:229602489:G:A	15	6	20	9	11	1	1	0
chr1:229636946:T:G	1	1	2	0	2	2	0	2
chr1:229654301:A:G	13	8	21	5	16	2	0	2
chr1:229659323:T:G	4	3	7	1	6	2.0	0.0	2.0
chr1:230249191:T:C	69	32	101	37	64	1	1	0
chr1:230279402:G:A	153	44	209	117	92	1	1	0
chr1:230678922:A:G	19	14	33	5	28	2	0	2
chr1:230759594:C:A	0	0	0	0	0	0	0	0
chr1:230780514:C:T	0	0	0	0	0	0	0	0
chr1:230787567:C:T	0	0	0	0	0	0	0	0
chr1:230906986:T:A	19	7	26	12	14	1	1	0
chr1:231241060:G:C	121	61	191	63	128	2	0	2
chr1:231352778:C:T	15	7	22	8	14	1	1	0
chr1:231767264:C:T	0	0	0	0	0	0	0	0
chr1:231818355:C:T	0	0	0	0	0	0	0	0
chr1:232008852:A:T	0	0	0	0	0	0	0	0
chr1:232009141:A:G	0	0	0	0	0	0	0	0
chr1:232986045:G:A	3	1	4	2	2	1	1	0
chr1:232986381:C:T	12	8	20	4	16	2.0	0.0	2.0
chr1:233262967:C:T	0	0	0	0	0	0	0	0
chr1:233379188:G:A	0	0	0	0	0	0	0	0
chr1:233379229:G:T	0	0	0	0	0	0	0	0
chr1:233379325:C:T	0	0	0	0	0	0	0	0
chr1:233379356:T:G	0	0	0	0	0	0	0	0
chr1:233379667:G:A	0	0	0	0	0	0	0	0
chr1:234373513:G:C	131	75	212	58	154	2	0	2
chr1:234393806:C:T	18	6	24	12	12	1.0	1.0	0.0
chr1:234608504:G:A	47	26	74	22	52	2	0	2
chr1:235777150:C:T	0	0	0	0	0	0	0	0
chr1:235809135:T:C	13	8	21	5	16	2	0	2
chr1:235809567:T:C	14	10	24	4	20	2.0	0.0	2.0
chr1:236012039:T:C	0	0	0	0	0	0	0	0
chr1:236045473:C:T	0	0	0	0	0	0	0	0
chr1:236048738:G:A	0	0	0	0	0	0	0	0
chr1:236538910:A:G	10	4	14	6	8	1.0	1.0	0.0
chr1:236539074:G:C	9	3	12	6	6	1	1	0
chr1:236543052:A:C	0	0	0	0	0	0	0	0
chr1:236543071:A:G	0	0	0	0	0	0	0	0
chr1:236543125:G:A	0	0	0	0	0	0	0	0
chr1:236548023:T:C	6	2	8	4	4	1.0	1.0	0.0
chr1:236553659:C:T	6	2	8	4	4	1.0	1.0	0.0
chr1:236555320:T:C	6	2	8	4	4	1.0	1.0	0.0
chr1:236558310:G:A	4	1	5	3	2	1.0	1.0	0.0
chr1:236583143:C:T	9	3	12	6	6	1	1	0
chr1:236585133:G:A	15	5	20	10	10	1	1	0
chr1:236585205:T:C	13	4	17	9	8	1	1	0
chr1:236586326:C:T	17	7	24	10	14	1	1	0
chr1:236603147:T:A	18	10	28	8	20	2.0	0.0	2.0
chr1:236604030:A:G	96	47	151	51	100	1.5	1.0	0.0
chr1:236891269:A:G	3	2	5	1	4	2	0	2
chr1:236895444:C:A	6	2	8	4	4	1.0	1.0	0.0
chr1:236895451:C:T	6	2	8	4	4	1.0	1.0	0.0
chr1:236895528:C:T	6	2	8	4	4	1.0	1.0	0.0
chr1:237548497:A:G	0	0	0	0	0	0	0	0
chr1:237614714:C:T	0	0	0	0	0	0	0	0
chr1:237614782:G:A	0	0	0	0	0	0	0	0
chr1:237648589:C:T	0	0	0	0	0	0	0	0
chr1:240207329:C:G	0	0	0	0	0	0	0	0
chr1:240329434:G:A	0	0	0	0	0	0	0	0
chr1:241744515:T:C	0	0	0	0	0	0	0	0
chr1:242524088:G:A	69	57	102	15	87	1	0	1
chr1:243256127:T:A	364	179	558	197	361	1.0	1.0	0.0
chr1:243308160:C:T	31	9	40	22	18	1	1	0
chr1:243330605:A:T	38	23	61	15	46	2.0	0.0	2.0
chr1:244552664:G:A	1	0	1	1	0	1	1	0
chr1:244864047:C:T	700	367	1190	399	791	2.0	1.0	2.0
chr1:245540828:G:C	0	0	0	0	0	0	0	0
chr1:245858639:T:C	71	28	99	43	56	1	1	0
chr1:246327136:TAACA:CAACG	20	10	30	10	20	1.5	0.5	1.0
chr1:246988255:A:G	0	0	0	0	0	0	0	0
chr1:246999356:C:T	0	0	0	0	0	0	0	0
chr1:247424175:G:A	0	0	0	0	0	0	0	0
chr1:247424751:C:T	0	0	0	0	0	0	0	0
chr1:247451594:A:C	0	0	0	0	0	0	0	0
chr1:247491691:T:C	0	0	0	0	0	0	0	0
chr1:247491973:T:C	0	0	0	0	0	0	0	0
chr1:247531647:G:C	0	0	0	0	0	0	0	0
chr1:247531656:G:A	0	0	0	0	0	0	0	0
chr1:247588717:G:C	0	0	0	0	0	0	0	0
chr1:247606290:C:T	0	0	0	0	0	0	0	0
chr1:247606450:A:G	0	0	0	0	0	0	0	0
chr1:247712113:A:G	0	0	0	0	0	0	0	0
chr1:247712281:G:C	0	0	0	0	0	0	0	0
chr1:247712306:C:G	0	0	0	0	0	0	0	0
chr1:247840994:A:G	0	0	0	0	0	0	0	0
chr1:247841312:G:A	0	0	0	0	0	0	0	0
chr1:247841385:C:G	0	0	0	0	0	0	0	0
chr1:247841473:C:T	0	0	0	0	0	0	0	0
chr1:247841546:G:C	0	0	0	0	0	0	0	0
chr1:247841575:C:T	0	0	0	0	0	0	0	0
chr1:247841756:G:A	0	0	0	0	0	0	0	0
chr1:247896121:C:T	0	0	0	0	0	0	0	0
chr1:247896154:G:A	0	0	0	0	0	0	0	0
chr1:247896401:T:A	0	0	0	0	0	0	0	0
chr1:247896410:T:C	0	0	0	0	0	0	0	0
chr1:247921132:G:A	0	0	0	0	0	0	0	0
chr1:247921209:T:C	0	0	0	0	0	0	0	0
chr1:247921523:C:T	0	0	0	0	0	0	0	0
chr1:247949325:T:C	0	0	0	0	0	0	0	0
chr1:247949613:A:G	0	0	0	0	0	0	0	0
chr1:247965627:G:A	0	0	0	0	0	0	0	0
chr1:247965938:G:A	0	0	0	0	0	0	0	0
chr1:248061444:G:T	0	0	0	0	0	0	0	0
chr1:248387708:G:A	0	0	0	0	0	0	0	0
chr1:248442141:G:T	0	0	0	0	0	0	0	0
chr1:248453872:A:G	0	0	0	0	0	0	0	0
chr1:248453880:C:T	0	0	0	0	0	0	0	0
chr1:248681658:T:C	0	0	0	0	0	0	0	0
chr1:248681796:C:T	0	0	0	0	0	0	0	0
chr1:248682055:G:T	0	0	0	0	0	0	0	0
chr1:248682110:G:A	0	0	0	0	0	0	0	0
chr1:248682157:C:T	0	0	0	0	0	0	0	0
chr2:676457:G:C	3	2	5	1	4	2	0	2
chr2:677213:G:A	10	3	13	7	6	1.0	1.0	0.0
chr2:1173095:C:A	0	0	0	0	0	0	0	0
chr2:1209110:C:T	0	0	0	0	0	0	0	0
chr2:1267458:A:G	0	0	0	0	0	0	0	0
chr2:1414420:C:G	0	0	0	0	0	0	0	0
chr2:1648888:G:A	0	0	0	0	0	0	0	0
chr2:1660882:A:G	0	0	0	0	0	0	0	0
chr2:1839196:T:C	0	0	0	0	0	0	0	0
chr2:1840880:C:T	0	0	0	0	0	0	0	0
chr2:1889361:C:T	0	0	0	0	0	0	0	0
chr2:1943142:A:G	0	0	0	0	0	0	0	0
chr2:3388524:A:G	83	45	132	39	93	2	0	2
chr2:3671102:C:T	0	0	0	0	0	0	0	0
chr2:9374788:C:T	0	0	0	0	0	0	0	0
chr2:9475906:A:G	12	8	20	4	16	2.0	0.0	2.0
chr2:9493008:T:G	5	3	8	2	6	2	0	2
chr2:9494727:A:G	30	15	45	15	30	1.5	0.5	1.0
chr2:9843557:G:T	119	79	204	44	160	2	0	2
chr2:9913283:C:T	3	3	6	0	6	2	0	2
chr2:9919641:G:T	22	12	35	11	24	2.0	0.0	2.0
chr2:10048522:A:T	16	5	21	11	10	1.0	1.0	0.0
chr2:10577680:C:T	22	14	38	8	30	2.0	0.0	2.0
chr2:10768767:A:G	1	0	1	1	0	1	1	0
chr2:11133333:C:T	1	0	1	1	0	1	1	0
chr2:11580860:G:A	0	0	0	0	0	0	0	0
chr2:11585821:T:C	0	0	0	0	0	0	0	0
chr2:11596179:G:A	0	0	0	0	0	0	0	0
chr2:11634198:G:A	0	0	0	0	0	0	0	0
chr2:11784824:T:C	0	0	0	0	0	0	0	0
chr2:15591874:A:G	44	26	70	18	52	2.0	0.0	2.0
chr2:15607269:C:T	88	43	132	46	86	1.0	1.0	0.0
chr2:17515306:C:T	0	0	0	0	0	0	0	0
chr2:17517411:A:G	0	0	0	0	0	0	0	0
chr2:20204188:C:T	0	0	0	0	0	0	0	0
chr2:20624738:C:T	55	26	81	29	52	1	1	0
chr2:20624799:C:T	55	28	83	27	56	2	0	2
chr2:20638558:G:A	56	30	86	26	60	2.0	0.0	2.0
chr2:21002628:A:G	0	0	0	0	0	0	0	0
chr2:21028042:G:A	0	0	0	0	0	0	0	0
chr2:21041028:G:A	0	0	0	0	0	0	0	0
chr2:21137711:A:G	0	0	0	0	0	0	0	0
chr2:23642390:T:C	3	1	4	2	2	1	1	0
chr2:23703363:C:T	3	0	3	3	0	1	1	0
chr2:23926569:G:A	175	90	269	88	181	2	1	2
chr2:24022843:C:G	0	0	0	0	0	0	0	0
chr2:24023305:C:T	0	0	0	0	0	0	0	0
chr2:24208315:C:T	20	17	37	3	34	2.0	0.0	2.0
chr2:24216179:A:G	5	2	7	3	4	1	1	0
chr2:24752089:C:T	11	6	17	5	12	2	0	2
chr2:24799729:A:G	19	9	28	10	18	1	1	0
chr2:24918669:A:G	0	0	0	0	0	0	0	0
chr2:24971872:G:A	83	34	118	50	68	1	1	0
chr2:25161456:G:C	582	286	957	335	622	2.0	1.0	0.0
chr2:25246633:C:T	7	3	10	4	6	1	1	0
chr2:25419425:T:C	9	5	14	4	10	2	0	2
chr2:25742173:G:A	2	1	3	1	2	1.5	0.5	1.0
chr2:25954329:A:G	0	0	0	0	0	0	0	0
chr2:26127267:G:T	2	1	2	1	1	1.0	0.5	0.5
chr2:26176345:G:A	0	0	0	0	0	0	0	0
chr2:26280007:T:C	433	221	682	232	450	2	1	2
chr2:26311382:T:C	0	0	0	0	0	0	0	0
chr2:26311933:G:A	0	0	0	0	0	0	0	0
chr2:26313431:C:G	0	0	0	0	0	0	0	0
chr2:26313826:C:T	1	0	1	1	0	1	1	0
chr2:26576025:A:T	0	0	0	0	0	0	0	0
chr2:26576163:G:A	0	0	0	0	0	0	0	0
chr2:26577554:G:A	0	0	0	0	0	0	0	0
chr2:26579524:A:T	0	0	0	0	0	0	0	0
chr2:27026385:C:T	7	4	11	3	8	2	0	2
chr2:27771730:G:T	123	60	186	66	120	2	1	0
chr2:28411923:G:A	0	0	0	0	0	0	0	0
chr2:28778825:A:G	132	77	211	55	156	2.0	0.0	2.0
chr2:28869813:T:C	172	86	266	90	176	2.0	1.0	1.0
chr2:28869984:G:T	173	87	268	90	178	2	1	2
chr2:28998174:C:T	0	0	0	0	0	0	0	0
chr2:29017194:A:G	0	0	0	0	0	0	0	0
chr2:29017917:A:G	0	0	0	0	0	0	0	0
chr2:29051854:A:G	0	0	0	0	0	0	0	0
chr2:29133701:G:C	12	5	17	7	10	1.0	1.0	0.0
chr2:29193500:G:C	0	0	0	0	0	0	0	0
chr2:29193615:T:C	0	0	0	0	0	0	0	0
chr2:30158639:T:C	1357	733	2462	838	1624	2	1	2
chr2:30459604:A:T	5	2	7	3	4	1	1	0
chr2:30753192:C:T	0	0	0	0	0	0	0	0
chr2:30912318:G:T	10	3	13	7	6	1.0	1.0	0.0
chr2:31177122:C:T	0	0	0	0	0	0	0	0
chr2:31197277:C:T	2	1	3	1	2	1.5	0.5	1.0
chr2:31339546:C:T	0	0	0	0	0	0	0	0
chr2:31366000:G:A	0	0	0	0	0	0	0	0
chr2:31383804:G:A	0	0	0	0	0	0	0	0
chr2:31387835:C:T	0	0	0	0	0	0	0	0
chr2:31580756:C:T	0	0	0	0	0	0	0	0
chr2:32250040:G:A	3	1	4	2	2	1	1	0
chr2:32251321:T:G	2	1	3	1	2	1.5	0.5	1.0
chr2:32758413:G:A	41	25	66	16	50	2	0	2
chr2:33187010:G:A	0	0	0	0	0	0	0	0
chr2:33539219:T:C	42	29	72	14	58	2.0	0.0	2.0
chr2:36513500:C:G	0	0	0	0	0	0	0	0
chr2:36583443:T:C	76	26	103	51	52	1.0	1.0	0.0
chr2:37231568:G:A	422	205	665	245	420	2.0	1.0	0.0
chr2:37267448:A:G	34	19	53	15	38	2.0	0.0	2.0
chr2:37290902:G:C	24	12	36	12	24	1.5	0.5	1.0
chr2:38074448:C:T	0	0	0	0	0	0	0	0
chr2:38482426:A:G	4	4	8	0	8	2.0	0.0	2.0
chr2:38582020:C:T	0	0	0	0	0	0	0	0
chr2:39280276:T:A	0	0	0	0	0	0	0	0
chr2:39704085:T:C	0	0	0	0	0	0	0	0
chr2:42169582:A:G	400	185	607	231	376	1.0	1.0	0.0
chr2:42361055:T:C	20	8	28	12	16	1.0	1.0	0.0
chr2:42763196:T:G	1	0	1	1	0	1	1	0
chr2:42767365:G:C	4	2	6	2	4	1.5	0.5	1.0
chr2:42788579:T:C	17	3	20	14	6	1	1	0
chr2:42792590:A:G	16	2	18	14	4	1.0	1.0	0.0
chr2:43225195:G:A	91	50	143	41	102	2	0	2
chr2:43225479:C:T	96	52	151	45	106	2.0	0.0	2.0
chr2:43225654:C:G	101	54	160	48	112	2	0	2
chr2:43675372:G:C	0	0	0	0	0	0	0	0
chr2:43675927:A:G	0	0	0	0	0	0	0	0
chr2:43676215:T:C	0	0	0	0	0	0	0	0
chr2:43676344:T:C	0	0	0	0	0	0	0	0
chr2:43699804:T:A	0	0	0	0	0	0	0	0
chr2:43704037:T:C	0	0	0	0	0	0	0	0
chr2:43774046:C:T	11	1	12	10	2	1	1	0
chr2:43774077:C:T	23	2	25	21	4	1	1	0
chr2:43776871:T:C	27	2	29	25	4	1	1	0
chr2:43839035:T:G	0	0	0	0	0	0	0	0
chr2:43844604:A:G	0	0	0	0	0	0	0	0
chr2:43872294:C:A	0	0	0	0	0	0	0	0
chr2:43874431:A:G	0	0	0	0	0	0	0	0
chr2:43877786:T:C	0	0	0	0	0	0	0	0
chr2:43896620:G:A	17	7	24	10	14	1	1	0
chr2:43982338:C:T	228	109	342	123	219	1.0	1.0	0.0
chr2:44275649:A:C	1	0	1	1	0	1	1	0
chr2:44320435:G:A	6	6	12	0	12	2.0	0.0	2.0
chr2:44321474:T:C	0	0	0	0	0	0	0	0
chr2:45413235:C:A	15	7	22	8	14	1	1	0
chr2:45418373:C:T	15	7	22	8	14	1	1	0
chr2:46512018:A:G	18	9	27	9	18	1.5	0.5	1.0
chr2:46759577:C:G	28	14	42	14	28	1.5	0.5	1.0
chr2:46760000:G:A	5	5	10	0	10	2	0	2
chr2:47073911:C:G	8	5	13	3	10	2.0	0.0	2.0
chr2:47155203:G:T	0	0	0	0	0	0	0	0
chr2:47373967:T:C	0	0	0	0	0	0	0	0
chr2:47783419:C:A	34	20	57	15	42	2.0	0.0	2.0
chr2:47790942:A:G	32	19	51	13	38	2.0	0.0	2.0
chr2:47798625:C:T	18	6	24	12	12	1.0	1.0	0.0
chr2:48375113:C:T	37	16	53	21	32	1	1	0
chr2:48454729:C:G	62	29	91	34	57	1.0	1.0	0.0
chr2:48582490:G:T	0	0	0	0	0	0	0	0
chr2:48595242:G:A	0	0	0	0	0	0	0	0
chr2:48962782:C:T	0	0	0	0	0	0	0	0
chr2:48963902:C:T	0	0	0	0	0	0	0	0
chr2:49154446:C:T	0	0	0	0	0	0	0	0
chr2:50829574:C:A	0	0	0	0	0	0	0	0
chr2:53728713:C:T	69	31	102	38	64	1	1	0
chr2:53808310:A:G	65	30	98	38	60	1	1	0
chr2:53808371:G:C	65	36	106	30	76	2	0	2
chr2:53854786:T:G	2	2	3	0	3	1.5	0.0	1.5
chr2:53888767:A:G	9	6	17	3	14	2	0	2
chr2:53892888:A:T	13	5	18	8	10	1	1	0
chr2:53908292:G:C	3	2	5	1	4	2	0	2
chr2:54631056:G:C	12	5	17	7	10	1.0	1.0	0.0
chr2:54631116:G:T	12	5	17	7	10	1.0	1.0	0.0
chr2:54644382:C:T	7	4	11	3	8	2	0	2
chr2:54928414:C:T	1	1	2	0	2	2	0	2
chr2:54959257:A:C	2	0	2	2	0	1.0	1.0	0.0
chr2:54973664:T:G	35	17	52	18	34	1	1	0
chr2:54973902:C:T	27	13	40	14	26	1	1	0
chr2:55177658:G:A	3	0	3	3	0	1	1	0
chr2:55254186:T:A	71	36	109	35	74	2	0	2
chr2:55317600:T:C	51	26	78	26	52	2	0	2
chr2:55617309:T:C	503	277	820	250	570	2	0	2
chr2:55672907:C:G	63	32	96	32	64	2	1	2
chr2:55922340:C:G	0	0	0	0	0	0	0	0
chr2:58163412:G:A	11	4	15	7	8	1	1	0
chr2:60948177:T:C	9	2	11	7	4	1	1	0
chr2:61077136:A:G	19	11	30	8	22	2	0	2
chr2:61187335:C:G	19	12	31	7	24	2	0	2
chr2:61190482:A:G	29	17	46	12	34	2	0	2
chr2:61221641:A:C	1	1	2	0	2	2	0	2
chr2:62135860:T:C	592	311	961	317	644	2.0	1.0	2.0
chr2:62146780:T:C	17	5	22	12	10	1	1	0
chr2:62506054:C:T	0	0	0	0	0	0	0	0
chr2:62506118:C:T	0	0	0	0	0	0	0	0
chr2:63622357:T:C	0	0	0	0	0	0	0	0
chr2:63842177:G:C	7	4	11	3	8	2	0	2
chr2:63887419:G:A	206	97	313	115	198	1.0	1.0	0.0
chr2:63962432:A:G	1	0	1	1	0	1	1	0
chr2:64636110:G:A	40	25	67	15	52	2.0	0.0	2.0
chr2:64989691:G:A	14	8	22	6	16	2.0	0.0	2.0
chr2:68131209:T:C	34	14	48	20	28	1.0	1.0	0.0
chr2:68157965:A:G	228	114	346	120	226	1.5	1.0	0.5
chr2:68174880:G:T	134	67	206	70	136	2.0	1.0	1.0
chr2:68319242:T:C	0	0	0	0	0	0	0	0
chr2:68319317:G:A	0	0	0	0	0	0	0	0
chr2:68380815:G:T	462	246	785	257	528	2.0	1.0	2.0
chr2:68386578:G:A	230	104	357	135	222	1.0	1.0	0.0
chr2:68395820:G:C	201	81	297	129	168	1	1	0
chr2:69090793:G:A	0	0	0	0	0	0	0	0
chr2:69181897:C:A	0	0	0	0	0	0	0	0
chr2:69431994:A:T	233	135	382	106	276	2	0	2
chr2:69514477:C:T	1	0	1	1	0	1	1	0
chr2:69961430:C:T	0	0	0	0	0	0	0	0
chr2:70450862:G:A	0	0	0	0	0	0	0	0
chr2:70831053:C:T	0	0	0	0	0	0	0	0
chr2:70831095:C:T	0	0	0	0	0	0	0	0
chr2:70835517:G:A	0	0	0	0	0	0	0	0
chr2:70933092:C:G	0	0	0	0	0	0	0	0
chr2:70935921:C:T	0	0	0	0	0	0	0	0
chr2:70935981:T:C	0	0	0	0	0	0	0	0
chr2:70963254:C:T	0	0	0	0	0	0	0	0
chr2:70979137:G:A	4	2	6	2	4	1.5	0.5	1.0
chr2:70984859:A:G	0	0	0	0	0	0	0	0
chr2:70985000:C:T	0	0	0	0	0	0	0	0
chr2:71511857:C:T	0	0	0	0	0	0	0	0
chr2:71553085:T:C	0	0	0	0	0	0	0	0
chr2:71611467:C:A	0	0	0	0	0	0	0	0
chr2:72132183:A:G	0	0	0	0	0	0	0	0
chr2:72134831:A:G	0	0	0	0	0	0	0	0
chr2:72998961:G:A	11	5	16	6	10	1	1	0
chr2:73080442:C:T	0	0	0	0	0	0	0	0
chr2:73089412:A:T	0	0	0	0	0	0	0	0
chr2:73112580:G:A	0	0	0	0	0	0	0	0
chr2:73291932:A:G	11	4	17	7	10	1	1	0
chr2:73902537:A:G	0	0	0	0	0	0	0	0
chr2:73938978:C:G	300	171	493	143	350	2.0	0.0	2.0
chr2:73947018:A:G	16	6	22	10	12	1.0	1.0	0.0
chr2:74262191:G:A	5	2	7	3	4	1	1	0
chr2:74414497:G:C	25	16	41	9	32	2	0	2
chr2:74439635:C:A	0	0	0	0	0	0	0	0
chr2:74455385:C:T	10	1	11	9	2	1.0	1.0	0.0
chr2:74460423:T:C	531	264	842	318	524	1	1	0
chr2:74462912:G:A	61	30	91	31	60	1	1	0
chr2:74463251:C:T	65	32	97	33	64	1	1	0
chr2:74472651:C:A	370	186	602	212	390	2.0	1.0	2.0
chr2:74483364:C:T	119	59	180	62	118	2	1	0
chr2:74492783:G:T	8	1	9	7	2	1.0	1.0	0.0
chr2:74498051:G:A	7	6	13	1	12	2	0	2
chr2:74505288:T:G	10	6	16	4	12	2.0	0.0	2.0
chr2:74519195:A:T	0	0	0	0	0	0	0	0
chr2:74529049:G:C	274	151	431	129	302	2.0	0.0	2.0
chr2:74531807:G:A	4	3	7	1	6	2.0	0.0	2.0
chr2:74673461:G:T	6	3	9	3	6	1.5	0.5	1.0
chr2:74872350:A:T	2	0	2	2	0	1.0	1.0	0.0
chr2:74874327:T:C	1	0	1	1	0	1	1	0
chr2:74886530:C:T	1	1	2	0	2	2	0	2
chr2:75198602:A:G	0	0	0	0	0	0	0	0
chr2:75670050:C:G	6	5	11	1	10	2.0	0.0	2.0
chr2:75710675:C:T	107	65	180	46	134	2	0	2
chr2:79123221:A:G	0	0	0	0	0	0	0	0
chr2:80574221:T:C	0	0	0	0	0	0	0	0
chr2:84625036:T:G	0	0	0	0	0	0	0	0
chr2:84669504:G:A	0	0	0	0	0	0	0	0
chr2:85309292:G:A	2	1	3	1	2	1.5	0.5	1.0
chr2:85322751:A:G	13	7	20	6	14	2	0	2
chr2:85326661:C:T	233	108	350	132	218	1	1	0
chr2:85326957:G:A	277	147	441	139	302	2	0	2
chr2:85345926:G:A	0	0	0	0	0	0	0	0
chr2:85371504:C:T	25	8	33	17	16	1	1	0
chr2:85390204:C:T	27	13	40	14	26	1	1	0
chr2:85390790:G:T	25	12	37	13	24	1	1	0
chr2:85391048:G:A	25	12	37	13	24	1	1	0
chr2:85401622:C:T	1525	878	3265	1137	2128	2	1	2
chr2:85616308:C:T	165	87	257	81	176	2	0	2
chr2:85665785:C:T	57	33	104	32	72	2	1	2
chr2:85666618:G:A	57	33	104	32	72	2	1	2
chr2:85697606:C:T	0	0	0	0	0	0	0	0
chr2:85698633:C:G	0	0	0	0	0	0	0	0
chr2:86042040:C:T	0	0	0	0	0	0	0	0
chr2:86065533:C:T	0	0	0	0	0	0	0	0
chr2:86088618:C:T	20	7	28	14	14	1.0	1.0	0.0
chr2:86108595:G:A	6	4	10	2	8	2.0	0.0	2.0
chr2:86144760:T:C	83	36	119	47	72	1	1	0
chr2:86158545:T:C	43	25	68	18	50	2	0	2
chr2:86206117:C:T	194	102	304	97	207	2.0	0.0	2.0
chr2:86603928:C:A	13	5	18	8	10	1	1	0
chr2:88084451:G:A	0	0	0	0	0	0	0	0
chr2:88088038:A:C	0	0	0	0	0	0	0	0
chr2:88096655:T:C	0	0	0	0	0	0	0	0
chr2:88108440:T:C	0	0	0	0	0	0	0	0
chr2:88108506:C:T	0	0	0	0	0	0	0	0
chr2:88110583:C:G	0	0	0	0	0	0	0	0
chr2:88124547:T:C	0	0	0	0	0	0	0	0
chr2:88173272:G:A	26	26	52	0	52	2.0	0.0	2.0
chr2:88575373:C:A	20	7	27	13	14	1.0	1.0	0.0
chr2:88579613:T:C	11	4	15	7	8	1	1	0
chr2:88595605:T:C	9	6	15	3	12	2	0	2
chr2:91748437:G:A	0	0	0	0	0	0	0	0
chr2:94857002:C:G	0	0	0	0	0	0	0	0
chr2:94871500:C:G	0	0	0	0	0	0	0	0
chr2:94871756:C:T	0	0	0	0	0	0	0	0
chr2:94871827:C:T	0	0	0	0	0	0	0	0
chr2:94871877:A:G	0	0	0	0	0	0	0	0
chr2:94876688:C:G	0	0	0	0	0	0	0	0
chr2:95149561:C:T	5	2	7	3	4	1	1	0
chr2:95278884:T:G	0	0	0	0	0	0	0	0
chr2:95855978:G:A	22	11	33	11	22	1.5	0.5	1.0
chr2:95882320:C:T	34	13	47	21	26	1.0	1.0	0.0
chr2:96114968:T:G	2	1	3	1	2	1.5	0.5	1.0
chr2:96124048:T:C	0	0	0	0	0	0	0	0
chr2:96124234:C:T	0	0	0	0	0	0	0	0
chr2:96130118:T:C	1	0	1	1	0	1	1	0
chr2:96193176:A:G	53	30	82	23	59	2	0	2
chr2:96193296:A:G	175	99	277	79	198	2	0	2
chr2:96195421:C:G	191	109	303	85	218	2	0	2
chr2:96253904:C:T	20	8	28	12	16	1.0	1.0	0.0
chr2:96266311:G:T	275	136	422	146	276	2	1	0
chr2:96277735:T:C	9	5	14	4	10	2	0	2
chr2:96287095:A:G	35	18	53	17	36	2	0	2
chr2:96325754:A:G	12	7	19	5	14	2.0	0.0	2.0
chr2:96328019:C:T	21	12	33	9	24	2	0	2
chr2:96328146:A:G	21	13	34	8	26	2	0	2
chr2:96354311:T:C	1	1	2	0	2	2	0	2
chr2:96364509:T:C	1	1	2	0	2	2	0	2
chr2:96500467:A:G	1	1	2	0	2	2	0	2
chr2:96601907:G:A	0	0	0	0	0	0	0	0
chr2:96854345:G:C	119	62	187	59	128	2	0	2
chr2:96861889:C:T	0	0	0	0	0	0	0	0
chr2:97194750:T:C	37	28	65	9	56	2	0	2
chr2:97211703:T:C	49	24	75	25	50	1	1	0
chr2:97211741:G:A	48	23	72	26	46	1.5	1.0	0.0
chr2:98236710:G:A	0	0	0	0	0	0	0	0
chr2:98312466:A:G	0	0	0	0	0	0	0	0
chr2:98370047:T:C	0	0	0	0	0	0	0	0
chr2:98564696:C:T	1	1	2	0	2	2	0	2
chr2:98726322:C:T	6	3	9	3	6	1.5	0.5	1.0
chr2:99379341:T:C	9	4	13	5	8	1	1	0
chr2:100299310:A:G	0	0	0	0	0	0	0	0
chr2:100299844:A:G	0	0	0	0	0	0	0	0
chr2:100299853:A:G	0	0	0	0	0	0	0	0
chr2:100300647:C:T	0	0	0	0	0	0	0	0
chr2:100393237:C:T	11	8	19	3	16	2	0	2
chr2:100393620:G:C	10	7	17	3	14	2.0	0.0	2.0
chr2:100397958:G:A	22	13	35	9	26	2.0	0.0	2.0
chr2:100470504:C:T	0	0	0	0	0	0	0	0
chr2:100480498:C:T	0	0	0	0	0	0	0	0
chr2:100569626:C:T	280	148	451	145	306	2.0	0.5	2.0
chr2:100974842:A:G	0	0	0	0	0	0	0	0
chr2:100995589:G:A	0	0	0	0	0	0	0	0
chr2:101008009:T:C	6	2	8	4	4	1.0	1.0	0.0
chr2:101011390:C:T	3	2	5	1	4	2	0	2
chr2:101022426:A:G	0	0	0	0	0	0	0	0
chr2:101029682:G:A	1	0	1	1	0	1	1	0
chr2:101040264:T:C	0	0	0	0	0	0	0	0
chr2:101253126:G:T	218	107	341	123	218	2.0	1.0	0.0
chr2:101308564:T:C	316	148	476	178	298	1.0	1.0	0.0
chr2:102343547:G:A	0	0	0	0	0	0	0	0
chr2:102351547:G:A	0	0	0	0	0	0	0	0
chr2:102351615:T:C	0	0	0	0	0	0	0	0
chr2:102384942:C:T	0	0	0	0	0	0	0	0
chr2:102423226:C:A	0	0	0	0	0	0	0	0
chr2:102473668:C:T	0	0	0	0	0	0	0	0
chr2:102704665:G:A	0	0	0	0	0	0	0	0
chr2:102718510:G:A	15	7	21	8	13	1	1	0
chr2:105272892:G:A	4	3	7	1	6	2.0	0.0	2.0
chr2:105280546:G:A	4	0	4	4	0	1.0	1.0	0.0
chr2:105361304:G:A	1	1	2	1	1	2	1	1
chr2:106424108:C:T	0	0	0	0	0	0	0	0
chr2:106491111:G:C	0	0	0	0	0	0	0	0
chr2:106806732:G:A	0	0	0	0	0	0	0	0
chr2:106843518:C:T	0	0	0	0	0	0	0	0
chr2:106843892:T:A	0	0	0	0	0	0	0	0
chr2:106844018:T:G	0	0	0	0	0	0	0	0
chr2:108489925:A:G	4	3	9	1	8	2.0	0.0	2.0
chr2:108495275:T:A	0	0	0	0	0	0	0	0
chr2:108659722:C:T	430	0	476	476	0	1.0	1.0	0.0
chr2:108662367:T:C	163	0	175	175	0	1	1	0
chr2:111929411:G:A	0	0	0	0	0	0	0	0
chr2:111994351:G:A	0	0	0	0	0	0	0	0
chr2:112008396:A:G	0	0	0	0	0	0	0	0
chr2:112187611:T:A	0	0	0	0	0	0	0	0
chr2:112324574:A:G	1	0	1	1	0	1	1	0
chr2:112433433:A:C	62	0	62	62	0	1.0	1.0	0.0
chr2:112501339:C:T	3	2	5	1	4	2	0	2
chr2:112551896:C:T	8	5	13	3	10	2.0	0.0	2.0
chr2:112564323:T:C	0	0	0	0	0	0	0	0
chr2:112588836:C:G	3	0	3	3	0	1	1	0
chr2:112762552:G:A	1	1	2	0	2	2	0	2
chr2:112779646:C:A	0	0	0	0	0	0	0	0
chr2:112831216:C:T	0	0	0	0	0	0	0	0
chr2:112832813:G:A	0	0	0	0	0	0	0	0
chr2:113005998:A:G	0	0	0	0	0	0	0	0
chr2:113183104:T:C	6	2	8	4	4	1.0	1.0	0.0
chr2:113183262:G:C	7	3	10	4	6	1	1	0
chr2:113185893:A:G	2	2	4	0	4	2.0	0.0	2.0
chr2:113198918:A:C	2	0	2	2	0	1.0	1.0	0.0
chr2:113635139:C:T	17	7	24	10	14	1	1	0
chr2:113658498:G:T	0	0	0	0	0	0	0	0
chr2:113658514:A:G	0	0	0	0	0	0	0	0
chr2:113668513:C:T	0	0	0	0	0	0	0	0
chr2:113668538:T:C	0	0	0	0	0	0	0	0
chr2:113756324:C:T	57	38	100	20	80	2	0	2
chr2:113951842:G:A	700	341	1141	420	721	2.0	1.0	0.0
chr2:115064709:T:G	0	0	0	0	0	0	0	0
chr2:115746095:G:A	0	0	0	0	0	0	0	0
chr2:119230989:G:A	0	0	0	0	0	0	0	0
chr2:119254836:C:T	0	0	0	0	0	0	0	0
chr2:119257588:A:G	0	0	0	0	0	0	0	0
chr2:119367477:C:G	15	1	18	16	2	1	1	0
chr2:119367482:C:T	15	1	18	16	2	1	1	0
chr2:119367808:G:A	6	1	8	6	2	1.0	1.0	0.0
chr2:119368334:C:A	3	0	3	3	0	1	1	0
chr2:119601228:G:A	0	0	0	0	0	0	0	0
chr2:120143123:G:A	0	0	0	0	0	0	0	0
chr2:120984731:C:T	0	0	0	0	0	0	0	0
chr2:120989380:G:T	0	0	0	0	0	0	0	0
chr2:120989830:G:A	0	0	0	0	0	0	0	0
chr2:120989853:A:G	0	0	0	0	0	0	0	0
chr2:124434491:T:C	0	0	0	0	0	0	0	0
chr2:124903032:C:T	0	0	0	0	0	0	0	0
chr2:127059056:G:A	300	192	523	115	408	2.0	0.0	2.0
chr2:127068957:A:G	292	186	504	113	391	2.0	0.0	2.0
chr2:127195478:A:C	0	0	0	0	0	0	0	0
chr2:127292558:T:C	3	1	4	2	2	1	1	0
chr2:127322230:A:G	23	4	27	19	8	1	1	0
chr2:127427194:T:C	3	2	5	1	4	2	0	2
chr2:127428832:G:A	10	3	13	7	6	1.0	1.0	0.0
chr2:127564195:G:A	0	0	0	0	0	0	0	0
chr2:127609517:G:A	0	0	0	0	0	0	0	0
chr2:127620258:C:G	0	0	0	0	0	0	0	0
chr2:127631215:G:A	0	0	0	0	0	0	0	0
chr2:127631287:G:C	0	0	0	0	0	0	0	0
chr2:127635686:T:C	0	0	0	0	0	0	0	0
chr2:127639232:A:G	9	4	13	5	8	1	1	0
chr2:127643033:C:T	1	0	1	1	0	1	1	0
chr2:127651707:C:T	0	0	0	0	0	0	0	0
chr2:127651763:GC:CA	0	0	0	0	0	0	0	0
chr2:127673823:A:G	0	0	0	0	0	0	0	0
chr2:128176826:T:C	3	1	4	2	2	1	1	0
chr2:128182243:G:A	20	13	33	7	26	2.0	0.0	2.0
chr2:128519146:T:C	0	0	0	0	0	0	0	0
chr2:130074719:T:A	0	0	0	0	0	0	0	0
chr2:130139661:C:T	0	0	0	0	0	0	0	0
chr2:130167515:C:T	21	10	31	11	20	1	1	0
chr2:130182517:G:T	56	30	85	26	59	2.0	0.0	2.0
chr2:130193975:G:A	1	1	2	0	2	2	0	2
chr2:130193993:G:A	1	1	2	0	2	2	0	2
chr2:130194376:G:A	1	1	2	0	2	2	0	2
chr2:130195145:G:A	0	0	0	0	0	0	0	0
chr2:130195152:C:T	0	0	0	0	0	0	0	0
chr2:130230219:G:A	0	0	0	0	0	0	0	0
chr2:130342923:G:A	283	138	441	157	284	2	1	0
chr2:130343161:G:A	335	185	545	163	382	2	0	2
chr2:130370301:C:T	10	5	15	5	10	1.5	0.5	1.0
chr2:130656603:C:T	0	0	0	0	0	0	0	0
chr2:130762605:C:G	0	0	0	0	0	0	0	0
chr2:131424287:C:G	0	0	0	0	0	0	0	0
chr2:131443822:TG:AA	0	0	0	0	0	0	0	0
chr2:131444090:T:C	0	0	0	0	0	0	0	0
chr2:131476167:C:A	1	0	1	1	0	1	1	0
chr2:131476182:G:A	1	0	1	1	0	1	1	0
chr2:131480713:C:T	1	1	2	0	2	2	0	2
chr2:131484131:C:T	591	135	792	512	280	1	1	0
chr2:131484158:T:C	592	136	794	512	282	1.0	1.0	0.0
chr2:131490806:T:G	11	6	17	5	12	2	0	2
chr2:131517770:G:T	9	4	13	5	8	1	1	0
chr2:131517823:T:C	9	5	14	4	10	2	0	2
chr2:131530789:T:C	1	0	1	1	0	1	1	0
chr2:131532891:G:A	1	0	1	1	0	1	1	0
chr2:131626564:A:C	0	0	0	0	0	0	0	0
chr2:131626766:C:T	0	0	0	0	0	0	0	0
chr2:131723579:AT:TC	2	0	2	2	0	1.0	1.0	0.0
chr2:132781993:G:A	0	0	0	0	0	0	0	0
chr2:132782603:A:G	0	0	0	0	0	0	0	0
chr2:132783871:T:C	0	0	0	0	0	0	0	0
chr2:132783881:A:G	0	0	0	0	0	0	0	0
chr2:132784002:C:T	0	0	0	0	0	0	0	0
chr2:132784441:T:C	0	0	0	0	0	0	0	0
chr2:132784972:G:A	0	0	0	0	0	0	0	0
chr2:132796715:A:G	0	0	0	0	0	0	0	0
chr2:134983306:A:G	0	0	0	0	0	0	0	0
chr2:134987559:G:A	1	0	1	1	0	1	1	0
chr2:134987822:G:A	1	1	2	0	2	2	0	2
chr2:134987975:C:T	1	1	2	0	2	2	0	2
chr2:134988152:A:G	1	1	2	0	2	2	0	2
chr2:135023465:C:T	0	0	0	0	0	0	0	0
chr2:135153852:T:C	39	19	59	21	38	2	1	0
chr2:135207806:T:C	1	0	1	1	0	1	1	0
chr2:135230616:G:A	3	2	5	1	4	2	0	2
chr2:135230846:C:T	3	2	5	1	4	2	0	2
chr2:135652004:A:C	4	3	7	1	6	2.0	0.0	2.0
chr2:135798089:T:C	0	0	0	0	0	0	0	0
chr2:135804902:G:A	0	0	0	0	0	0	0	0
chr2:135817629:G:T	0	0	0	0	0	0	0	0
chr2:135836588:G:A	0	0	0	0	0	0	0	0
chr2:136115979:A:T	89	45	132	44	88	1	0	1
chr2:137056907:C:G	0	0	0	0	0	0	0	0
chr2:137618402:A:T	0	0	0	0	0	0	0	0
chr2:138569139:A:T	55	25	82	30	52	1	1	0
chr2:140517007:T:C	0	0	0	0	0	0	0	0
chr2:140850326:A:C	0	0	0	0	0	0	0	0
chr2:141810341:T:C	0	0	0	0	0	0	0	0
chr2:144141992:C:A	33	15	48	18	30	1	1	0
chr2:151261757:GCAGA:ACAGG	39	15	57	25	32	1	1	0
chr2:151455056:G:A	12	5	19	7	12	1.0	1.0	0.0
chr2:151457871:G:A	14	5	19	9	10	1.0	1.0	0.0
chr2:151463604:G:A	5	2	7	3	4	1	1	0
chr2:151465581:A:T	6	3	9	3	6	1.5	0.5	1.0
chr2:151492512:G:A	1	0	1	1	0	1	1	0
chr2:151531039:T:C	0	0	0	0	0	0	0	0
chr2:151633705:A:G	0	0	0	0	0	0	0	0
chr2:151643878:T:C	0	0	0	0	0	0	0	0
chr2:151643935:C:G	0	0	0	0	0	0	0	0
chr2:152521945:T:C	0	0	0	0	0	0	0	0
chr2:154409111:G:A	0	0	0	0	0	0	0	0
chr2:156569460:G:A	9	6	15	3	12	2	0	2
chr2:157299583:A:C	0	0	0	0	0	0	0	0
chr2:157780398:G:A	8	5	13	3	10	2.0	0.0	2.0
chr2:158338713:T:G	0	0	0	0	0	0	0	0
chr2:158807104:G:A	0	0	0	0	0	0	0	0
chr2:159349882:C:T	4	4	8	0	8	2.0	0.0	2.0
chr2:159453735:A:G	18	7	25	11	14	1.0	1.0	0.0
chr2:159747868:C:T	96	53	150	44	106	2.0	0.0	2.0
chr2:159748257:G:A	96	52	149	45	104	2.0	0.0	2.0
chr2:159748425:G:A	98	45	145	53	92	1.0	1.0	0.0
chr2:159819839:T:C	7	4	11	3	8	2	0	2
chr2:160045006:A:G	0	0	0	0	0	0	0	0
chr2:160126549:G:C	0	0	0	0	0	0	0	0
chr2:160172707:G:A	0	0	0	0	0	0	0	0
chr2:161505297:G:A	0	0	0	0	0	0	0	0
chr2:164568327:A:G	0	0	0	0	0	0	0	0
chr2:164722071:A:G	35	30	65	5	60	2	0	2
chr2:164722092:C:T	53	7	60	46	14	1	1	0
chr2:164842037:G:A	4	4	8	0	8	2.0	0.0	2.0
chr2:165131262:T:G	0	0	0	0	0	0	0	0
chr2:165139597:T:A	0	0	0	0	0	0	0	0
chr2:165146969:G:A	0	0	0	0	0	0	0	0
chr2:168834219:T:C	0	0	0	0	0	0	0	0
chr2:168850918:C:T	0	0	0	0	0	0	0	0
chr2:168864867:G:A	0	0	0	0	0	0	0	0
chr2:168907710:G:A	0	0	0	0	0	0	0	0
chr2:168932506:T:C	0	0	0	0	0	0	0	0
chr2:169140541:G:A	0	0	0	0	0	0	0	0
chr2:169157394:A:C	0	0	0	0	0	0	0	0
chr2:170214402:T:C	0	0	0	0	0	0	0	0
chr2:170217377:G:A	0	0	0	0	0	0	0	0
chr2:170404287:A:G	0	0	0	0	0	0	0	0
chr2:170822115:T:C	0	0	0	0	0	0	0	0
chr2:171453167:G:A	41	22	63	19	44	2	0	2
chr2:171868791:A:G	233	145	380	90	290	2	0	2
chr2:171922612:C:T	16	8	24	8	16	1.5	0.5	1.0
chr2:172595912:T:C	9	3	12	6	6	1	1	0
chr2:172967206:C:T	0	0	0	0	0	0	0	0
chr2:173956022:T:C	132	56	189	77	112	1.0	1.0	0.0
chr2:174335141:G:T	0	0	0	0	0	0	0	0
chr2:174335167:G:A	0	0	0	0	0	0	0	0
chr2:174336175:G:C	0	0	0	0	0	0	0	0
chr2:174436269:G:A	8	6	16	2	14	2.0	0.0	2.0
chr2:174566979:C:G	11	6	17	5	12	2	0	2
chr2:174812294:C:T	0	0	0	0	0	0	0	0
chr2:174847214:C:T	0	0	0	0	0	0	0	0
chr2:175178420:T:C	43	20	66	26	40	2	1	0
chr2:176119307:G:C	0	0	0	0	0	0	0	0
chr2:176169051:C:T	0	0	0	0	0	0	0	0
chr2:176169393:G:T	0	0	0	0	0	0	0	0
chr2:176172026:T:C	0	0	0	0	0	0	0	0
chr2:176190041:G:A	0	0	0	0	0	0	0	0
chr2:177617866:G:T	1	1	2	0	2	2	0	2
chr2:178680256:C:G	12	5	17	7	10	1.0	1.0	0.0
chr2:178756457:G:A	1	1	2	0	2	2	0	2
chr2:178756776:C:T	0	0	0	0	0	0	0	0
chr2:178884913:C:T	55	26	81	29	52	1	1	0
chr2:181509807:A:G	0	0	0	0	0	0	0	0
chr2:181534370:T:C	0	0	0	0	0	0	0	0
chr2:181548532:A:G	0	0	0	0	0	0	0	0
chr2:182728970:C:T	132	76	208	56	152	2.0	0.0	2.0
chr2:182732591:A:G	6	4	10	2	8	2.0	0.0	2.0
chr2:182762777:A:G	67	31	98	36	62	1	1	0
chr2:185792113:T:C	0	0	0	0	0	0	0	0
chr2:185807800:T:A	0	0	0	0	0	0	0	0
chr2:185808967:T:G	1	1	2	0	2	2	0	2
chr2:186675668:G:A	4	2	6	2	4	1.5	0.5	1.0
chr2:186694233:G:A	0	0	0	0	0	0	0	0
chr2:187478770:T:C	0	0	0	0	0	0	0	0
chr2:188477667:T:G	0	0	0	0	0	0	0	0
chr2:188734770:A:C	0	0	0	0	0	0	0	0
chr2:189565451:A:G	0	0	0	0	0	0	0	0
chr2:189580468:G:C	0	0	0	0	0	0	0	0
chr2:189863992:T:A	39	17	56	22	34	1	1	0
chr2:190200027:C:T	131	56	190	78	112	1	1	0
chr2:190296896:T:C	373	252	647	131	516	2	0	2
chr2:190319749:A:G	403	274	701	139	562	2	0	2
chr2:190360255:G:T	72	37	111	37	74	2.0	0.5	2.0
chr2:190366777:G:A	30	17	49	15	34	2.0	0.0	2.0
chr2:190514542:G:A	19	14	33	5	28	2	0	2
chr2:191030927:G:T	0	0	0	0	0	0	0	0
chr2:191836667:A:G	0	0	0	0	0	0	0	0
chr2:196027971:T:C	0	0	0	0	0	0	0	0
chr2:196201240:C:A	0	0	0	0	0	0	0	0
chr2:196257769:T:G	0	0	0	0	0	0	0	0
chr2:196308092:G:A	0	0	0	0	0	0	0	0
chr2:196308132:A:T	0	0	0	0	0	0	0	0
chr2:196319597:C:T	0	0	0	0	0	0	0	0
chr2:196998974:G:A	24	13	37	11	26	2.0	0.0	2.0
chr2:197393071:T:C	207	105	325	111	214	2	1	2
chr2:197400802:A:G	64	36	101	29	72	2.0	0.0	2.0
chr2:197497294:T:C	697	392	1339	431	908	2	1	2
chr2:197500319:C:G	175	76	258	102	156	1	1	0
chr2:197644227:G:A	0	0	0	0	0	0	0	0
chr2:199955782:T:G	17	4	21	13	8	1	1	0
chr2:200571832:A:G	3	2	5	1	4	2	0	2
chr2:201160898:A:G	104	52	160	52	108	1.5	0.5	1.0
chr2:201185954:A:G	19	10	29	9	20	2	0	2
chr2:201217736:T:A	2	1	3	1	2	1.5	0.5	1.0
chr2:201272839:G:A	17	5	22	12	10	1	1	0
chr2:201284973:G:A	136	70	206	66	140	2.0	0.0	2.0
chr2:201636725:T:C	0	0	0	0	0	0	0	0
chr2:201806658:C:G	0	0	0	0	0	0	0	0
chr2:202035234:G:A	0	0	0	0	0	0	0	0
chr2:202036168:G:A	0	0	0	0	0	0	0	0
chr2:202074931:T:C	0	0	0	0	0	0	0	0
chr2:202201563:G:T	0	0	0	0	0	0	0	0
chr2:202291213:A:C	548	281	890	300	590	2.0	1.0	2.0
chr2:202556476:G:A	23	12	36	12	24	2	0	2
chr2:205047680:T:C	0	0	0	0	0	0	0	0
chr2:205125629:C:T	0	0	0	0	0	0	0	0
chr2:206009615:G:A	8	2	10	6	4	1.0	1.0	0.0
chr2:206056727:G:A	28	14	42	15	27	1.5	1.0	0.5
chr2:206141952:T:C	47	28	75	19	56	2	0	2
chr2:206144039:C:A	52	32	84	20	64	2.0	0.0	2.0
chr2:206160720:T:C	256	131	391	129	262	2.0	0.0	2.0
chr2:206176329:T:C	0	0	0	0	0	0	0	0
chr2:206176717:G:A	0	0	0	0	0	0	0	0
chr2:206305007:G:A	5	0	5	5	0	1	1	0
chr2:206307903:A:G	3	0	3	3	0	1	1	0
chr2:206309592:T:C	7	0	8	8	0	1	1	0
chr2:206663116:G:T	0	0	0	0	0	0	0	0
chr2:206705805:G:C	0	0	0	0	0	0	0	0
chr2:206955552:G:A	0	0	0	0	0	0	0	0
chr2:206960932:A:T	0	0	0	0	0	0	0	0
chr2:206969259:A:G	0	0	0	0	0	0	0	0
chr2:207624377:C:A	373	175	575	213	362	1	1	0
chr2:208112337:C:A	0	0	0	0	0	0	0	0
chr2:208112388:C:T	0	0	0	0	0	0	0	0
chr2:208112411:A:G	0	0	0	0	0	0	0	0
chr2:208121661:A:G	0	0	0	0	0	0	0	0
chr2:208121913:T:C	0	0	0	0	0	0	0	0
chr2:208142835:T:G	0	0	0	0	0	0	0	0
chr2:208145834:A:G	0	0	0	0	0	0	0	0
chr2:209145412:T:C	0	0	0	0	0	0	0	0
chr2:209978659:G:A	0	0	0	0	0	0	0	0
chr2:210195326:T:G	0	0	0	0	0	0	0	0
chr2:210303622:A:C	0	0	0	0	0	0	0	0
chr2:210577488:G:A	0	0	0	0	0	0	0	0
chr2:211387139:T:C	0	0	0	0	0	0	0	0
chr2:213862497:A:C	0	0	0	0	0	0	0	0
chr2:213930019:A:C	0	0	0	0	0	0	0	0
chr2:214780740:C:G	7	4	11	3	8	2	0	2
chr2:214780821:C:G	7	3	10	4	6	1	1	0
chr2:214809500:G:A	54	35	89	19	70	2.0	0.0	2.0
chr2:214809599:C:G	54	35	89	19	70	2.0	0.0	2.0
chr2:215000851:T:C	0	0	0	0	0	0	0	0
chr2:215367833:C:T	5	4	9	1	8	2	0	2
chr2:215371989:T:C	1	0	1	1	0	1	1	0
chr2:215433361:G:A	0	0	0	0	0	0	0	0
chr2:216013285:C:G	1	1	2	0	2	2	0	2
chr2:216043956:C:T	38	28	66	10	56	2.0	0.0	2.0
chr2:216283694:C:A	0	0	0	0	0	0	0	0
chr2:217847583:C:T	0	0	0	0	0	0	0	0
chr2:217847883:G:A	0	0	0	0	0	0	0	0
chr2:217848003:A:G	0	0	0	0	0	0	0	0
chr2:217848195:C:T	0	0	0	0	0	0	0	0
chr2:217848213:C:T	0	0	0	0	0	0	0	0
chr2:217848559:G:A	0	0	0	0	0	0	0	0
chr2:218060426:G:A	0	0	0	0	0	0	0	0
chr2:218135587:C:T	0	0	0	0	0	0	0	0
chr2:218238857:A:G	108	58	172	54	118	2.0	0.5	2.0
chr2:218275565:G:C	80	33	113	48	65	1.0	1.0	0.0
chr2:218277871:C:T	2	2	4	0	4	2.0	0.0	2.0
chr2:218278050:C:T	0	0	0	0	0	0	0	0
chr2:218278506:G:A	0	0	0	0	0	0	0	0
chr2:218279366:G:A	1	0	1	1	0	1	1	0
chr2:218279426:G:A	1	0	1	1	0	1	1	0
chr2:218282080:G:A	86	49	137	37	100	2.0	0.0	2.0
chr2:218568874:G:A	143	73	219	73	146	2	0	2
chr2:218628201:T:C	0	0	0	0	0	0	0	0
chr2:218634036:T:G	5	2	7	3	4	1	1	0
chr2:218636410:G:A	3	0	3	3	0	1	1	0
chr2:218636605:G:A	3	0	3	3	0	1	1	0
chr2:218643649:A:T	1	1	2	0	2	2	0	2
chr2:218644265:T:C	1	0	1	1	0	1	1	0
chr2:218644895:C:A	0	0	0	0	0	0	0	0
chr2:218662282:C:T	3	1	4	2	2	1	1	0
chr2:218668180:CGG:TGA	3	0	3	3	0	1	1	0
chr2:218690539:G:A	0	0	0	0	0	0	0	0
chr2:218692517:T:C	0	0	0	0	0	0	0	0
chr2:218697952:G:A	4	0	4	4	0	1.0	1.0	0.0
chr2:218737776:G:C	4	4	8	0	8	2.0	0.0	2.0
chr2:218738096:G:A	4	4	8	0	8	2.0	0.0	2.0
chr2:218745710:A:G	1	0	1	1	0	1	1	0
chr2:218747559:A:G	0	0	0	0	0	0	0	0
chr2:219213284:C:T	0	0	0	0	0	0	0	0
chr2:219246940:G:A	0	0	0	0	0	0	0	0
chr2:219250790:T:C	474	263	793	249	544	2.0	0.0	2.0
chr2:219297407:C:T	0	0	0	0	0	0	0	0
chr2:219421525:C:T	0	0	0	0	0	0	0	0
chr2:219451248:G:A	0	0	0	0	0	0	0	0
chr2:219466082:T:C	0	0	0	0	0	0	0	0
chr2:219472001:C:T	0	0	0	0	0	0	0	0
chr2:219484029:C:T	0	0	0	0	0	0	0	0
chr2:219488291:G:A	0	0	0	0	0	0	0	0
chr2:219489386:A:G	0	0	0	0	0	0	0	0
chr2:219489643:C:T	0	0	0	0	0	0	0	0
chr2:219490807:A:G	0	0	0	0	0	0	0	0
chr2:219491798:G:T	0	0	0	0	0	0	0	0
chr2:219497835:C:T	2	2	4	0	4	2.0	0.0	2.0
chr2:219537949:G:T	0	0	0	0	0	0	0	0
chr2:219537958:T:C	0	0	0	0	0	0	0	0
chr2:219539762:G:C	15	7	22	8	14	1	1	0
chr2:219539926:C:T	14	7	21	7	14	1.5	0.5	1.0
chr2:219540004:G:A	14	7	21	7	14	1.5	0.5	1.0
chr2:219540508:G:A	13	6	19	7	12	1	1	0
chr2:219542000:T:C	39	17	56	22	34	1	1	0
chr2:219556695:C:G	0	0	0	0	0	0	0	0
chr2:219556757:A:G	0	0	0	0	0	0	0	0
chr2:219558052:A:G	0	0	0	0	0	0	0	0
chr2:219562625:G:T	0	0	0	0	0	0	0	0
chr2:219562673:G:A	0	0	0	0	0	0	0	0
chr2:219566909:G:T	0	0	0	0	0	0	0	0
chr2:219567292:G:A	0	0	0	0	0	0	0	0
chr2:219572359:C:T	0	0	0	0	0	0	0	0
chr2:219574956:C:T	0	0	0	0	0	0	0	0
chr2:219601477:G:T	5	2	7	3	4	1	1	0
chr2:219606394:C:G	6	1	7	5	2	1.0	1.0	0.0
chr2:219608633:G:A	8	4	14	4	10	1.5	0.5	1.0
chr2:219611721:C:T	5	3	8	2	6	2	0	2
chr2:219615959:A:G	2	2	4	0	4	2.0	0.0	2.0
chr2:219628664:T:A	0	0	0	0	0	0	0	0
chr2:222297170:A:G	0	0	0	0	0	0	0	0
chr2:223959900:A:G	307	168	492	150	342	2	0	2
chr2:224854976:G:A	46	23	73	25	48	2.0	0.5	1.0
chr2:227007466:G:A	2	1	3	1	2	1.5	0.5	1.0
chr2:227008279:T:C	9	4	13	5	8	1	1	0
chr2:227022057:A:G	6	3	9	3	6	1.5	0.5	1.0
chr2:227027903:C:T	1	1	2	0	2	2	0	2
chr2:227028004:C:T	1	1	2	0	2	2	0	2
chr2:227051116:G:A	0	0	0	0	0	0	0	0
chr2:227238007:G:C	1	1	2	0	2	2	0	2
chr2:227246719:T:C	0	0	0	0	0	0	0	0
chr2:227248459:A:G	1	1	2	0	2	2	0	2
chr2:227263852:G:A	0	0	0	0	0	0	0	0
chr2:227270915:C:T	0	0	0	0	0	0	0	0
chr2:227284391:A:G	2	1	3	1	2	1.5	0.5	1.0
chr2:227332522:G:A	551	295	887	275	612	2	0	2
chr2:227702382:C:T	0	0	0	0	0	0	0	0
chr2:227871597:G:T	0	0	0	0	0	0	0	0
chr2:227991150:G:C	0	0	0	0	0	0	0	0
chr2:228018313:A:C	0	0	0	0	0	0	0	0
chr2:228019005:T:C	0	0	0	0	0	0	0	0
chr2:230284393:G:A	54	27	83	29	54	1.5	1.0	1.0
chr2:230383546:C:T	146	85	233	63	170	2.0	0.0	2.0
chr2:230392097:A:G	23	11	34	12	22	1	1	0
chr2:230467181:G:A	839	474	1470	456	1014	2	0	2
chr2:230573706:T:C	1	1	2	0	2	2	0	2
chr2:230865087:C:T	10	9	19	1	18	2.0	0.0	2.0
chr2:230910582:T:G	0	0	0	0	0	0	0	0
chr2:231461706:C:T	1480	807	3003	1005	1998	2.0	1.0	2.0
chr2:231525033:A:G	0	0	0	0	0	0	0	0
chr2:232380220:G:C	0	0	0	0	0	0	0	0
chr2:232445587:T:C	0	0	0	0	0	0	0	0
chr2:232445659:T:C	0	0	0	0	0	0	0	0
chr2:232520686:G:A	0	0	0	0	0	0	0	0
chr2:232524103:T:G	0	0	0	0	0	0	0	0
chr2:232535364:A:G	0	0	0	0	0	0	0	0
chr2:232545584:C:T	2	1	3	1	2	1.5	0.5	1.0
chr2:232672415:A:G	0	0	0	0	0	0	0	0
chr2:232735194:A:C	60	34	94	26	68	2.0	0.0	2.0
chr2:232768750:G:A	9	4	13	5	8	1	1	0
chr2:232844096:A:G	9	6	15	3	12	2	0	2
chr2:233146227:G:A	11	4	15	7	8	1	1	0
chr2:233169936:G:A	38	15	55	23	32	1.0	1.0	0.0
chr2:233274722:A:G	6	5	11	1	10	2.0	0.0	2.0
chr2:233318877:A:G	0	0	0	0	0	0	0	0
chr2:233327174:C:T	0	0	0	0	0	0	0	0
chr2:233445674:C:T	13	8	21	5	16	2	0	2
chr2:233464121:T:C	13	1	14	12	2	1	1	0
chr2:233477372:A:G	7	4	11	3	8	2	0	2
chr2:233477488:A:G	5	4	9	1	8	2	0	2
chr2:233485841:G:A	11	5	16	6	10	1	1	0
chr2:233485923:A:G	12	6	18	6	12	1.5	0.5	1.0
chr2:233523371:A:G	1	0	1	1	0	1	1	0
chr2:233540670:G:A	6	4	10	2	8	2.0	0.0	2.0
chr2:233618225:C:G	0	0	0	0	0	0	0	0
chr2:233681970:C:A	0	0	0	0	0	0	0	0
chr2:233682324:TGACCG:GGACAA	0	0	0	0	0	0	0	0
chr2:233682559:T:C	0	0	0	0	0	0	0	0
chr2:233693023:T:G	0	0	0	0	0	0	0	0
chr2:233693319:A:G	0	0	0	0	0	0	0	0
chr2:233713783:T:C	0	0	0	0	0	0	0	0
chr2:233729157:T:C	0	0	0	0	0	0	0	0
chr2:233729207:G:A	0	0	0	0	0	0	0	0
chr2:233729266:T:C	0	0	0	0	0	0	0	0
chr2:233729603:A:G	0	0	0	0	0	0	0	0
chr2:233743701:C:G	0	0	0	0	0	0	0	0
chr2:233793813:T:C	0	0	0	0	0	0	0	0
chr2:233794490:T:C	0	0	0	0	0	0	0	0
chr2:233795672:A:G	0	0	0	0	0	0	0	0
chr2:233841137:C:G	0	0	0	0	0	0	0	0
chr2:233945906:G:C	0	0	0	0	0	0	0	0
chr2:233996434:C:T	0	0	0	0	0	0	0	0
chr2:235041543:T:C	0	0	0	0	0	0	0	0
chr2:235043175:A:G	2	1	3	1	2	1.5	0.5	1.0
chr2:235852752:C:T	0	0	0	0	0	0	0	0
chr2:236581261:C:T	0	0	0	0	0	0	0	0
chr2:237334649:G:A	0	0	0	0	0	0	0	0
chr2:237336320:A:G	0	0	0	0	0	0	0	0
chr2:237340987:C:T	0	0	0	0	0	0	0	0
chr2:237342196:G:A	0	0	0	0	0	0	0	0
chr2:237344422:C:T	0	0	0	0	0	0	0	0
chr2:237366926:T:C	0	0	0	0	0	0	0	0
chr2:237510968:A:G	0	0	0	0	0	0	0	0
chr2:237525791:C:T	0	0	0	0	0	0	0	0
chr2:237534583:A:G	0	0	0	0	0	0	0	0
chr2:237540464:A:G	0	0	0	0	0	0	0	0
chr2:237586099:A:G	0	0	0	0	0	0	0	0
chr2:237760159:A:G	145	63	221	89	132	1	1	0
chr2:237762685:A:G	169	72	254	104	150	1	1	0
chr2:237824373:G:A	2	2	4	0	4	2.0	0.0	2.0
chr2:238081747:G:A	36	23	60	14	46	2.0	0.0	2.0
chr2:238083155:C:T	6	1	7	5	2	1.0	1.0	0.0
chr2:238102078:T:C	0	0	0	0	0	0	0	0
chr2:238107898:C:G	0	0	0	0	0	0	0	0
chr2:238130416:A:G	0	0	0	0	0	0	0	0
chr2:238130434:G:T	0	0	0	0	0	0	0	0
chr2:238140899:G:A	0	0	0	0	0	0	0	0
chr2:238150843:T:C	0	0	0	0	0	0	0	0
chr2:238150969:C:T	0	0	0	0	0	0	0	0
chr2:238253316:C:T	1	1	2	0	2	2	0	2
chr2:238329312:G:T	5	3	8	2	6	2	0	2
chr2:239082174:G:A	0	0	0	0	0	0	0	0
chr2:240014693:A:G	29	17	48	15	33	2	0	2
chr2:240022311:T:C	575	302	951	322	629	2	1	2
chr2:240029595:T:C	0	0	0	0	0	0	0	0
chr2:240029895:A:G	0	0	0	0	0	0	0	0
chr2:240126863:C:T	0	0	0	0	0	0	0	0
chr2:240126908:A:C	0	0	0	0	0	0	0	0
chr2:240463419:G:A	0	0	0	0	0	0	0	0
chr2:240524036:C:A	16	8	24	8	16	1.5	0.5	1.0
chr2:240552838:G:T	13	7	20	6	14	2	0	2
chr2:240561257:C:G	2	0	2	2	0	1.0	1.0	0.0
chr2:240630168:C:T	0	0	0	0	0	0	0	0
chr2:240630432:C:T	0	0	0	0	0	0	0	0
chr2:240630675:C:T	0	0	0	0	0	0	0	0
chr2:240630710:C:T	0	0	0	0	0	0	0	0
chr2:240692059:C:G	0	0	0	0	0	0	0	0
chr2:240874036:G:A	0	0	0	0	0	0	0	0
chr2:240888381:T:C	0	0	0	0	0	0	0	0
chr2:240888595:T:C	0	0	0	0	0	0	0	0
chr2:240891879:C:G	0	0	0	0	0	0	0	0
chr2:240895490:C:T	0	0	0	0	0	0	0	0
chr2:240895527:T:C	0	0	0	0	0	0	0	0
chr2:240895962:G:A	0	0	0	0	0	0	0	0
chr2:240896015:G:A	0	0	0	0	0	0	0	0
chr2:241064880:G:A	0	0	0	0	0	0	0	0
chr2:241071915:C:A	1	0	1	1	0	1	1	0
chr2:241224123:G:A	1	1	2	0	2	2	0	2
chr2:241229561:T:C	51	29	82	24	58	2	0	2
chr2:241465606:C:T	7	2	10	6	4	1	1	0
chr2:241468173:G:A	6	3	9	3	6	1.5	0.5	1.0
chr2:241666621:G:C	2	1	3	1	2	1.5	0.5	1.0
chr2:241671358:T:A	149	62	212	89	123	1	1	0
chr2:241676047:T:C	177	93	281	89	192	2	0	2
chr2:241678635:A:G	148	75	232	76	156	2.0	1.0	2.0
chr2:241690633:G:A	12	7	19	5	14	2.0	0.0	2.0
chr2:241709130:CGTTG:TGTTA	9	7	16	2	14	2	0	2
chr2:241720139:C:T	19	12	31	7	24	2	0	2
chr2:241751330:C:T	15	8	23	7	16	2	0	2
chr2:241816877:C:T	0	0	0	0	0	0	0	0
chr2:241817000:A:G	0	0	0	0	0	0	0	0
chr2:241851121:A:G	28	12	40	16	24	1.0	1.0	0.0
chr2:241871857:G:A	0	0	0	0	0	0	0	0
chr3:1383034:G:A	0	0	0	0	0	0	0	0
chr3:1383166:T:G	0	0	0	0	0	0	0	0
chr3:3040066:A:T	0	0	0	0	0	0	0	0
chr3:3040141:T:C	0	0	0	0	0	0	0	0
chr3:3140611:G:T	64	25	91	39	52	1.0	1.0	0.0
chr3:3147595:A:G	38	21	60	18	42	2.0	0.0	2.0
chr3:4313013:G:A	2	0	2	2	0	1.0	1.0	0.0
chr3:4362083:A:G	57	24	81	33	48	1	1	0
chr3:4362133:TT:AC	56	22	78	34	44	1.0	1.0	0.0
chr3:4362153:A:G	56	23	79	33	46	1.0	1.0	0.0
chr3:4467058:C:T	139	68	209	73	136	1	1	0
chr3:4670729:G:A	17	11	17	6	11	1	0	1
chr3:4788048:A:G	10	7	17	3	14	2.0	0.0	2.0
chr3:6861610:C:T	0	0	0	0	0	0	0	0
chr3:7452730:A:T	0	0	0	0	0	0	0	0
chr3:7680310:G:A	0	0	0	0	0	0	0	0
chr3:8627675:C:A	0	0	0	0	0	0	0	0
chr3:8733975:C:T	0	0	0	0	0	0	0	0
chr3:8768017:G:A	0	0	0	0	0	0	0	0
chr3:8963394:C:T	47	27	74	20	54	2	0	2
chr3:8992874:C:T	1	1	2	0	2	2	0	2
chr3:9766201:A:G	17	5	23	13	10	1	1	0
chr3:9928162:C:T	0	0	0	0	0	0	0	0
chr3:9928474:C:T	0	0	0	0	0	0	0	0
chr3:10222796:C:G	12	4	16	8	8	1.0	1.0	0.0
chr3:10234479:T:A	7	1	8	6	2	1	1	0
chr3:10278895:G:A	10	5	15	5	10	1.5	0.5	1.0
chr3:10301192:C:T	253	137	403	125	278	2	0	2
chr3:10328802:G:C	0	0	0	0	0	0	0	0
chr3:10338239:C:T	0	0	0	0	0	0	0	0
chr3:10844235:T:C	0	0	0	0	0	0	0	0
chr3:12572367:T:C	60	25	85	35	50	1.0	1.0	0.0
chr3:12815994:C:T	1	0	1	1	0	1	1	0
chr3:12817323:C:T	0	0	0	0	0	0	0	0
chr3:13353975:G:C	46	21	67	25	42	1.0	1.0	0.0
chr3:13358286:G:A	42	23	65	19	46	2.0	0.0	2.0
chr3:13504197:C:T	4	3	7	1	6	2.0	0.0	2.0
chr3:13629008:G:A	0	0	0	0	0	0	0	0
chr3:14485030:G:A	5	1	6	4	2	1	1	0
chr3:14509936:A:G	0	0	0	0	0	0	0	0
chr3:14513708:T:C	0	0	0	0	0	0	0	0
chr3:14514303:A:G	0	0	0	0	0	0	0	0
chr3:14521751:A:G	0	0	0	0	0	0	0	0
chr3:14523510:G:A	0	0	0	0	0	0	0	0
chr3:14670966:G:A	28	15	42	13	29	1.5	0.0	1.5
chr3:14682838:G:A	1	0	1	1	0	1	1	0
chr3:14682906:G:A	1	0	1	1	0	1	1	0
chr3:14704350:G:A	0	0	0	0	0	0	0	0
chr3:14714065:A:G	0	0	0	0	0	0	0	0
chr3:14897972:G:T	0	0	0	0	0	0	0	0
chr3:15073763:G:T	2	0	2	2	0	1.0	1.0	0.0
chr3:15235034:A:G	17	6	23	11	12	1	1	0
chr3:15439219:C:T	11	5	18	6	12	1	1	0
chr3:15601651:A:C	2	2	4	0	4	2.0	0.0	2.0
chr3:15712134:A:G	12	6	18	6	12	1.5	0.5	1.0
chr3:16271057:C:T	33	13	46	21	25	1	1	0
chr3:16286348:T:G	25	10	35	15	20	1	1	0
chr3:16286402:C:T	26	16	42	11	31	2.0	0.0	2.0
chr3:16317077:T:C	15	9	24	6	18	2	0	2
chr3:16598568:T:C	1	0	1	1	0	1	1	0
chr3:16605238:C:G	0	0	0	0	0	0	0	0
chr3:17012007:A:G	44	24	68	21	47	2.0	0.0	2.0
chr3:17089929:C:T	52	31	84	22	62	2.0	0.0	2.0
chr3:17166775:T:C	21	9	30	12	18	1	1	0
chr3:18013739:A:C	0	0	0	0	0	0	0	0
chr3:18351327:C:T	0	0	0	0	0	0	0	0
chr3:18386432:G:T	0	0	0	0	0	0	0	0
chr3:19933723:C:A	0	0	0	0	0	0	0	0
chr3:19934090:A:G	0	0	0	0	0	0	0	0
chr3:19951096:G:A	177	77	267	107	160	1	1	0
chr3:19985740:G:T	6	6	12	0	12	2.0	0.0	2.0
chr3:19986079:T:A	7	0	7	7	0	1	1	0
chr3:20001342:C:T	0	0	0	0	0	0	0	0
chr3:20170697:A:G	3	1	4	2	2	1	1	0
chr3:21421295:G:A	0	0	0	0	0	0	0	0
chr3:24143504:G:A	0	0	0	0	0	0	0	0
chr3:25794532:C:T	24	0	24	24	0	1.0	1.0	0.0
chr3:27284960:A:G	0	0	0	0	0	0	0	0
chr3:27431445:C:T	0	0	0	0	0	0	0	0
chr3:27431575:A:G	0	0	0	0	0	0	0	0
chr3:27448703:T:C	0	0	0	0	0	0	0	0
chr3:31748090:T:C	200	90	294	112	182	1.0	1.0	0.0
chr3:33021558:A:G	1	1	2	0	2	2	0	2
chr3:33097052:A:G	96	56	155	41	114	2.0	0.0	2.0
chr3:33097057:G:A	95	55	153	42	111	2	0	2
chr3:33152658:C:T	0	0	0	0	0	0	0	0
chr3:33153498:C:A	0	0	0	0	0	0	0	0
chr3:33153792:G:A	0	0	0	0	0	0	0	0
chr3:33153817:A:G	0	0	0	0	0	0	0	0
chr3:33373431:G:A	0	0	0	0	0	0	0	0
chr3:33439908:G:C	9	5	14	4	10	2	0	2
chr3:33836134:G:A	85	49	136	38	98	2	0	2
chr3:33866453:A:G	85	49	138	38	100	2	0	2
chr3:35737281:A:G	1	0	1	1	0	1	1	0
chr3:35738258:A:G	1	0	1	1	0	1	1	0
chr3:36738216:G:A	0	0	0	0	0	0	0	0
chr3:37065979:G:A	2	2	4	0	4	2.0	0.0	2.0
chr3:37243661:C:T	224	122	352	104	248	2.0	0.0	2.0
chr3:37327264:T:A	20	8	28	12	16	1.0	1.0	0.0
chr3:37366173:G:T	18	9	28	10	18	1.5	1.0	1.0
chr3:37732813:C:T	0	0	0	0	0	0	0	0
chr3:37997491:T:C	33	16	49	17	32	1	1	0
chr3:38002413:T:C	29	18	47	11	36	2	0	2
chr3:38002652:C:G	0	0	0	0	0	0	0	0
chr3:38003101:C:T	0	0	0	0	0	0	0	0
chr3:38006189:G:A	39	19	59	21	38	1	1	0
chr3:38006463:G:C	42	20	63	23	40	1.0	1.0	0.0
chr3:38008668:G:A	1	0	1	1	0	1	1	0
chr3:38010450:T:C	3	1	4	2	2	1	1	0
chr3:38110240:T:C	0	0	0	0	0	0	0	0
chr3:38129319:C:G	193	97	297	99	198	2	1	2
chr3:38307458:G:T	0	0	0	0	0	0	0	0
chr3:38316470:C:G	0	0	0	0	0	0	0	0
chr3:38698003:G:A	0	0	0	0	0	0	0	0
chr3:39187185:T:G	0	0	0	0	0	0	0	0
chr3:39389590:G:A	98	46	145	53	92	1.0	1.0	0.0
chr3:39407646:T:C	423	224	669	215	454	2	0	2
chr3:39408574:C:T	129	58	194	76	118	1	1	0
chr3:39411669:G:A	219	126	351	97	254	2	0	2
chr3:39412119:C:T	34	8	43	27	16	1.0	1.0	0.0
chr3:40209901:T:C	1	1	2	0	2	2	0	2
chr3:40244526:T:C	2	1	3	1	2	1.5	0.5	1.0
chr3:40427405:C:T	0	0	0	0	0	0	0	0
chr3:40457354:C:T	4743	2300	23397	16461	6936	4	3	0
chr3:42160267:G:A	1	0	1	1	0	1	1	0
chr3:42209837:C:T	32	16	51	17	34	1.5	1.0	1.0
chr3:42406979:G:A	0	0	0	0	0	0	0	0
chr3:42519391:C:G	0	0	0	0	0	0	0	0
chr3:42527577:C:A	2	2	4	0	4	2.0	0.0	2.0
chr3:42568882:A:G	137	66	206	72	134	1	1	0
chr3:42638285:T:G	53	31	84	22	62	2	0	2
chr3:42638508:C:T	57	34	90	23	67	2	0	2
chr3:42659138:A:G	0	0	0	0	0	0	0	0
chr3:42659225:A:G	0	0	0	0	0	0	0	0
chr3:42739784:G:T	0	0	0	0	0	0	0	0
chr3:42743138:A:G	0	0	0	0	0	0	0	0
chr3:42745977:A:G	2	1	3	1	2	1.5	0.5	1.0
chr3:42758273:G:A	3	2	5	1	4	2	0	2
chr3:43032269:G:A	0	0	0	0	0	0	0	0
chr3:43032938:AGCTC:GGCTT	0	0	0	0	0	0	0	0
chr3:43053609:A:G	0	0	0	0	0	0	0	0
chr3:43055443:C:T	0	0	0	0	0	0	0	0
chr3:43080067:C:T	1	1	2	0	2	2	0	2
chr3:44570404:A:G	1	0	1	1	0	1	1	0
chr3:44571403:C:G	2	0	2	2	0	1.0	1.0	0.0
chr3:44580488:C:G	0	0	0	0	0	0	0	0
chr3:44580877:G:C	0	0	0	0	0	0	0	0
chr3:44721545:A:C	8	2	10	6	4	1.0	1.0	0.0
chr3:44843155:C:A	11	9	20	2	18	2	0	2
chr3:44865254:A:G	149	77	229	73	156	2	0	2
chr3:44901577:C:T	0	0	0	0	0	0	0	0
chr3:44901897:G:A	0	0	0	0	0	0	0	0
chr3:44906987:C:T	1	0	1	1	0	1	1	0
chr3:44907098:G:A	1	0	1	1	0	1	1	0
chr3:44907182:G:C	1	0	1	1	0	1	1	0
chr3:44922499:G:A	2	2	4	0	4	2.0	0.0	2.0
chr3:45011283:G:C	242	133	383	115	268	2.0	0.0	2.0
chr3:45035627:CCTGG:TCTGA	0	0	0	0	0	0	0	0
chr3:45089117:G:A	0	0	0	0	0	0	0	0
chr3:45541805:C:T	2	0	2	2	0	1.0	1.0	0.0
chr3:45595947:T:C	87	56	153	33	120	2	0	2
chr3:45739656:C:T	0	0	0	0	0	0	0	0
chr3:45771533:A:G	0	0	0	0	0	0	0	0
chr3:45947552:T:G	0	0	0	0	0	0	0	0
chr3:45955348:A:T	1	0	1	1	0	1	1	0
chr3:45958418:T:C	1	1	2	0	2	2	0	2
chr3:45967298:G:A	1	1	2	0	2	2	0	2
chr3:45967999:C:T	1	0	1	1	0	1	1	0
chr3:45968372:C:G	1	1	2	0	2	2	0	2
chr3:45984767:G:A	0	0	0	0	0	0	0	0
chr3:46358307:T:C	0	0	0	0	0	0	0	0
chr3:46373066:T:A	0	0	0	0	0	0	0	0
chr3:46408487:A:C	1	0	1	1	0	1	1	0
chr3:46408579:T:A	1	0	1	1	0	1	1	0
chr3:46439467:C:G	0	0	0	0	0	0	0	0
chr3:46625303:G:A	0	0	0	0	0	0	0	0
chr3:46671000:G:A	0	0	0	0	0	0	0	0
chr3:46676774:C:G	0	0	0	0	0	0	0	0
chr3:46681202:G:T	0	0	0	0	0	0	0	0
chr3:46688267:C:G	0	0	0	0	0	0	0	0
chr3:46733832:A:G	1	0	1	1	0	1	1	0
chr3:46733893:A:G	1	0	1	1	0	1	1	0
chr3:46734118:A:G	1	0	1	1	0	1	1	0
chr3:46736391:CAAGT:GAAGC	0	0	0	0	0	0	0	0
chr3:46742267:T:G	6	6	12	0	12	2.0	0.0	2.0
chr3:46742469:T:C	6	6	12	0	12	2.0	0.0	2.0
chr3:46742977:G:A	5	5	9	1	8	2	0	2
chr3:46833952:C:T	0	0	0	0	0	0	0	0
chr3:46996564:G:A	0	0	0	0	0	0	0	0
chr3:48630737:C:G	0	0	0	0	0	0	0	0
chr3:48660238:C:T	0	0	0	0	0	0	0	0
chr3:48688737:T:G	124	55	181	69	112	1.0	1.0	0.0
chr3:49652766:G:A	0	0	0	0	0	0	0	0
chr3:49653194:G:A	0	0	0	0	0	0	0	0
chr3:49663865:G:A	1	1	2	0	2	2	0	2
chr3:49686351:C:A	1	0	1	1	0	1	1	0
chr3:49687375:T:C	1	0	1	1	0	1	1	0
chr3:49702074:G:C	0	0	0	0	0	0	0	0
chr3:49712755:T:A	2	0	2	2	0	1.0	1.0	0.0
chr3:49715570:T:G	0	0	0	0	0	0	0	0
chr3:49810209:G:A	2	2	4	0	4	2.0	0.0	2.0
chr3:49829151:T:G	4	4	8	0	8	2.0	0.0	2.0
chr3:49860840:A:G	0	0	0	0	0	0	0	0
chr3:49860885:C:G	0	0	0	0	0	0	0	0
chr3:49862362:G:A	0	0	0	0	0	0	0	0
chr3:49887507:T:C	1	1	2	0	2	2	0	2
chr3:49898669:T:C	0	0	0	0	0	0	0	0
chr3:49911638:A:G	6	5	11	1	10	2.0	0.0	2.0
chr3:50115923:T:C	74	39	114	36	78	2.0	0.0	2.0
chr3:50159664:C:T	0	0	0	0	0	0	0	0
chr3:50559661:G:A	5	2	7	3	4	1	1	0
chr3:50572193:T:G	35	17	52	18	34	1	1	0
chr3:50580071:C:T	3	1	4	2	2	1	1	0
chr3:51861677:G:A	0	0	0	0	0	0	0	0
chr3:51944536:C:T	189	82	277	109	168	1	1	0
chr3:51944624:G:A	20	14	34	6	28	2.0	0.0	2.0
chr3:52075825:T:C	16	12	28	4	24	2.0	0.0	2.0
chr3:52221376:G:A	29	10	39	19	20	1	1	0
chr3:52229951:G:A	475	245	764	260	504	2	1	2
chr3:52230891:T:C	467	248	755	247	508	2	1	2
chr3:52231199:G:A	459	242	741	244	497	2	1	2
chr3:52291090:C:G	49	21	71	29	42	1	1	0
chr3:52344524:G:C	1	1	2	0	2	2	0	2
chr3:52349324:C:T	0	0	0	0	0	0	0	0
chr3:52356773:C:T	0	0	0	0	0	0	0	0
chr3:52357719:A:C	1	0	1	1	0	1	1	0
chr3:52373025:C:T	0	0	0	0	0	0	0	0
chr3:52392868:C:T	1	0	1	1	0	1	1	0
chr3:52395649:C:T	4	1	5	3	2	1.0	1.0	0.0
chr3:52419877:C:T	5	2	7	3	4	1	1	0
chr3:52458691:T:C	111	59	172	54	118	2	0	2
chr3:52476576:G:A	27	15	44	12	32	2	0	2
chr3:52478302:A:G	4	2	6	2	4	1.5	0.5	1.0
chr3:52489389:C:T	6	0	6	6	0	1.0	1.0	0.0
chr3:52510454:A:G	0	0	0	0	0	0	0	0
chr3:52512435:G:A	0	0	0	0	0	0	0	0
chr3:52516994:C:T	0	0	0	0	0	0	0	0
chr3:52517550:G:C	0	0	0	0	0	0	0	0
chr3:52522353:C:T	0	0	0	0	0	0	0	0
chr3:52522874:A:G	0	0	0	0	0	0	0	0
chr3:52524117:T:C	0	0	0	0	0	0	0	0
chr3:52524888:A:T	0	0	0	0	0	0	0	0
chr3:52527763:C:T	0	0	0	0	0	0	0	0
chr3:52528870:G:A	3	1	4	2	2	1	1	0
chr3:52576635:T:A	32	13	45	19	26	1.0	1.0	0.0
chr3:52609291:A:G	16	11	27	5	22	2.0	0.0	2.0
chr3:52609669:T:C	43	19	62	24	38	1	1	0
chr3:52687289:G:A	156	83	245	81	164	2.0	0.0	2.0
chr3:52693241:G:A	80	39	123	45	78	1.5	1.0	0.0
chr3:52694788:C:T	168	90	260	78	182	2.0	0.0	2.0
chr3:52706166:C:G	2300	1360	4893	1662	3231	2.0	1.0	2.0
chr3:52763618:G:C	5	0	5	5	0	1	1	0
chr3:52766268:T:C	7	2	9	5	4	1	1	0
chr3:52768386:A:C	7	2	9	5	4	1	1	0
chr3:52786995:A:G	0	0	0	0	0	0	0	0
chr3:52791569:T:C	2	1	4	2	2	2.0	1.0	1.0
chr3:52796748:C:T	0	0	0	0	0	0	0	0
chr3:52823762:T:A	2	1	3	1	2	1.5	0.5	1.0
chr3:52830568:A:G	0	0	0	0	0	0	0	0
chr3:52830619:A:G	0	0	0	0	0	0	0	0
chr3:52840430:C:T	13	6	19	7	12	1	1	0
chr3:52969163:A:C	298	184	497	125	372	2.0	0.0	2.0
chr3:53091906:T:C	17	6	23	11	12	1	1	0
chr3:53225834:C:T	278	141	443	153	290	2.0	1.0	2.0
chr3:53225980:G:A	4	0	4	4	0	1.0	1.0	0.0
chr3:53226700:C:T	4	0	4	4	0	1.0	1.0	0.0
chr3:53226887:G:C	0	0	0	0	0	0	0	0
chr3:53227984:G:A	0	0	0	0	0	0	0	0
chr3:53230469:A:G	277	140	442	154	288	2	1	1
chr3:53231565:C:T	1	1	2	0	2	2	0	2
chr3:53233084:C:A	1	0	1	1	0	1	1	0
chr3:53233139:G:A	1	1	2	0	2	2	0	2
chr3:53233280:G:A	0	0	0	0	0	0	0	0
chr3:53233326:G:A	0	0	0	0	0	0	0	0
chr3:53235030:T:C	292	142	456	167	289	1.5	1.0	0.0
chr3:53235147:G:A	288	140	453	165	288	2.0	1.0	0.0
chr3:53235259:T:C	0	0	0	0	0	0	0	0
chr3:53242083:C:T	0	0	0	0	0	0	0	0
chr3:53666523:T:C	4	2	6	2	4	1.5	0.5	1.0
chr3:53735452:C:T	3	1	4	2	2	1	1	0
chr3:53888465:C:T	1329	681	2291	842	1449	2	1	2
chr3:54320483:T:C	0	0	0	0	0	0	0	0
chr3:54570002:C:T	0	0	0	0	0	0	0	0
chr3:54764231:G:A	0	0	0	0	0	0	0	0
chr3:56296340:C:T	1	1	2	0	2	2	0	2
chr3:56563660:A:G	1	0	1	1	0	1	1	0
chr3:56633654:G:C	13	8	21	5	16	2	0	2
chr3:56682894:T:G	158	82	246	80	166	2.0	0.0	2.0
chr3:56801733:G:A	128	56	184	72	112	1.0	1.0	0.0
chr3:57301848:C:T	0	0	0	0	0	0	0	0
chr3:57377088:A:G	0	0	0	0	0	0	0	0
chr3:57428707:A:G	0	0	0	0	0	0	0	0
chr3:58096161:T:C	23	8	31	15	16	1	1	0
chr3:58123435:G:A	13	6	19	7	12	1	1	0
chr3:58126713:A:G	11	6	17	5	12	2	0	2
chr3:58132828:G:A	7	2	9	5	4	1	1	0
chr3:58168600:C:T	13	6	19	7	12	1	1	0
chr3:58193301:T:C	0	0	0	0	0	0	0	0
chr3:58205539:C:T	0	0	0	0	0	0	0	0
chr3:58653738:T:G	0	0	0	0	0	0	0	0
chr3:59922400:A:G	40	38	78	2	76	2.0	0.0	2.0
chr3:61742859:G:A	1	1	2	0	2	2	0	2
chr3:63278660:G:A	0	0	0	0	0	0	0	0
chr3:66998338:T:C	113	56	176	60	116	1	1	0
chr3:68987556:G:A	0	0	0	0	0	0	0	0
chr3:68988937:A:G	10	4	14	6	8	1.0	1.0	0.0
chr3:69047463:G:A	167	90	260	80	180	2	0	2
chr3:69104703:G:T	1302	745	2461	776	1685	2.0	1.0	2.0
chr3:72750552:C:T	12	7	19	5	14	2.0	0.0	2.0
chr3:72975199:C:A	0	0	0	0	0	0	0	0
chr3:73062658:A:G	23	13	37	11	26	2	0	2
chr3:73404174:C:T	0	0	0	0	0	0	0	0
chr3:73624819:A:C	0	0	0	0	0	0	0	0
chr3:75336163:C:T	0	0	0	0	0	0	0	0
chr3:75337146:G:A	0	0	0	0	0	0	0	0
chr3:75423110:G:T	2	1	3	1	2	1.5	0.5	1.0
chr3:75423138:C:T	2	1	3	1	2	1.5	0.5	1.0
chr3:75426519:A:C	33	15	48	18	30	1	1	0
chr3:75426534:A:G	33	15	47	18	29	1	1	0
chr3:75426556:G:T	33	15	48	18	30	1	1	0
chr3:75427635:C:T	1	1	2	0	2	2	0	2
chr3:75665936:T:A	0	0	0	0	0	0	0	0
chr3:75665948:T:A	0	0	0	0	0	0	0	0
chr3:75666110:CGACC:TGATG	0	0	0	0	0	0	0	0
chr3:77580013:G:A	0	0	0	0	0	0	0	0
chr3:78614799:G:A	0	0	0	0	0	0	0	0
chr3:78639808:G:A	0	0	0	0	0	0	0	0
chr3:78651751:G:T	0	0	0	0	0	0	0	0
chr3:78668193:C:T	0	0	0	0	0	0	0	0
chr3:88139270:G:A	14	9	23	5	18	2.0	0.0	2.0
chr3:88140191:T:C	14	9	23	5	18	2.0	0.0	2.0
chr3:88150029:T:C	300	148	462	160	302	2.0	1.0	0.0
chr3:88150148:T:C	304	151	469	161	308	2.0	1.0	0.0
chr3:97646194:G:A	0	0	0	0	0	0	0	0
chr3:97646230:A:G	0	0	0	0	0	0	0	0
chr3:98007903:A:T	0	0	0	0	0	0	0	0
chr3:98087772:G:A	0	0	0	0	0	0	0	0
chr3:98088100:T:C	0	0	0	0	0	0	0	0
chr3:98133154:A:C	0	0	0	0	0	0	0	0
chr3:98149330:T:G	0	0	0	0	0	0	0	0
chr3:98149575:G:A	0	0	0	0	0	0	0	0
chr3:98149772:C:T	0	0	0	0	0	0	0	0
chr3:98149951:A:G	0	0	0	0	0	0	0	0
chr3:98150126:T:A	0	0	0	0	0	0	0	0
chr3:98169021:G:A	0	0	0	0	0	0	0	0
chr3:98264413:C:G	0	0	0	0	0	0	0	0
chr3:98264717:G:C	0	0	0	0	0	0	0	0
chr3:98264867:T:C	0	0	0	0	0	0	0	0
chr3:98265098:A:G	0	0	0	0	0	0	0	0
chr3:98265137:G:A	0	0	0	0	0	0	0	0
chr3:98390796:G:A	0	0	0	0	0	0	0	0
chr3:98533183:G:A	0	0	0	0	0	0	0	0
chr3:98812498:A:G	0	0	0	0	0	0	0	0
chr3:99924332:C:T	6	4	10	2	8	2.0	0.0	2.0
chr3:100167818:G:A	87	42	130	46	84	1	1	0
chr3:100993405:T:C	0	0	0	0	0	0	0	0
chr3:101230998:G:A	0	0	0	0	0	0	0	0
chr3:101459004:T:G	203	106	321	103	218	2	0	2
chr3:101564948:C:G	215	91	318	131	187	1	1	0
chr3:101576658:T:A	30	11	41	19	22	1.0	1.0	0.0
chr3:101576740:C:T	28	9	37	19	18	1.0	1.0	0.0
chr3:101682404:G:C	49	27	77	23	54	2	0	2
chr3:101765491:G:A	5	3	8	2	6	2	0	2
chr3:101801693:C:T	24	11	35	13	22	1.0	1.0	0.0
chr3:101857331:T:C	86	34	119	52	67	1.0	1.0	0.0
chr3:105547430:T:C	10	6	16	4	12	2.0	0.0	2.0
chr3:107755603:T:C	321	168	502	164	338	2	0	2
chr3:108057568:C:T	1128	620	2009	661	1348	2.0	1.0	2.0
chr3:108167028:A:G	6	4	10	2	8	2.0	0.0	2.0
chr3:108362430:C:A	2	1	3	1	2	1.5	0.5	1.0
chr3:108376518:G:A	1	0	1	1	0	1	1	0
chr3:108428881:T:C	0	0	0	0	0	0	0	0
chr3:108470780:C:T	0	0	0	0	0	0	0	0
chr3:108648131:A:G	11	4	15	7	8	1	1	0
chr3:108757127:G:A	0	0	0	0	0	0	0	0
chr3:109333885:T:C	0	0	0	0	0	0	0	0
chr3:112185692:C:T	0	0	0	0	0	0	0	0
chr3:112345003:C:A	402	198	641	223	418	2.0	1.0	0.0
chr3:112928985:A:C	2	1	3	1	2	1.5	0.5	1.0
chr3:112929141:C:T	1	1	2	0	2	2	0	2
chr3:112929278:GGT:TGG	2	1	3	1	2	1.5	0.5	1.0
chr3:112929375:T:C	2	1	3	1	2	1.5	0.5	1.0
chr3:112974906:A:T	1	1	2	0	2	2	0	2
chr3:112991395:T:C	7	4	10	3	7	1	0	1
chr3:113272465:C:T	0	0	0	0	0	0	0	0
chr3:113273112:C:T	0	0	0	0	0	0	0	0
chr3:113278707:A:G	0	0	0	0	0	0	0	0
chr3:113279418:A:G	0	0	0	0	0	0	0	0
chr3:113284748:G:C	1	0	1	1	0	1	1	0
chr3:113296813:G:A	1	1	2	0	2	2	0	2
chr3:113366065:T:C	1	1	2	0	2	2	0	2
chr3:113409204:G:T	0	0	0	0	0	0	0	0
chr3:113427283:T:C	0	0	0	0	0	0	0	0
chr3:113468801:C:T	11	8	19	3	16	2	0	2
chr3:113514716:C:T	11	6	17	5	12	2	0	2
chr3:113604940:G:A	8	3	11	5	6	1.0	1.0	0.0
chr3:113658514:A:G	0	0	0	0	0	0	0	0
chr3:113661018:G:C	3	2	5	1	4	2	0	2
chr3:113746012:A:G	269	147	431	133	298	2	0	2
chr3:113936360:C:T	2	0	2	2	0	1.0	1.0	0.0
chr3:113954278:A:G	10	3	13	7	6	1.0	1.0	0.0
chr3:119409551:G:A	9	2	11	7	4	1	1	0
chr3:119414707:G:A	2	2	4	0	4	2.0	0.0	2.0
chr3:119431989:C:T	31	13	46	20	26	1	1	0
chr3:119503609:G:C	256	130	407	135	272	2.0	1.0	2.0
chr3:119586322:G:A	9	4	13	5	8	1	1	0
chr3:119586532:T:A	9	5	14	4	10	2	0	2
chr3:119608806:T:C	0	0	0	0	0	0	0	0
chr3:119613027:C:T	0	0	0	0	0	0	0	0
chr3:119613045:C:G	0	0	0	0	0	0	0	0
chr3:119619645:G:A	0	0	0	0	0	0	0	0
chr3:119707460:T:C	1	1	2	0	2	2	0	2
chr3:119807502:G:A	0	0	0	0	0	0	0	0
chr3:120348950:G:A	92	54	148	38	110	2.0	0.0	2.0
chr3:120670396:T:C	0	0	0	0	0	0	0	0
chr3:121436127:T:C	0	0	0	0	0	0	0	0
chr3:121510113:G:A	1	1	2	0	2	2	0	2
chr3:121632491:C:T	676	359	1140	382	758	2.0	1.0	2.0
chr3:121644833:C:T	786	411	1334	466	868	2.0	1.0	2.0
chr3:121696763:G:A	17	10	27	7	20	2	0	2
chr3:122414983:T:G	20	15	35	5	30	2.0	0.0	2.0
chr3:122555910:G:C	70	36	106	34	72	2.0	0.0	2.0
chr3:122718474:T:C	34	12	46	22	24	1.0	1.0	0.0
chr3:122879444:A:G	11	7	18	4	14	2	0	2
chr3:122911476:T:G	0	0	0	0	0	0	0	0
chr3:122923743:G:A	0	0	0	0	0	0	0	0
chr3:123733085:G:A	2	2	4	0	4	2.0	0.0	2.0
chr3:123733991:G:A	4	2	6	2	4	1.5	0.5	1.0
chr3:124269192:T:C	0	0	0	0	0	0	0	0
chr3:124562757:G:A	0	0	0	0	0	0	0	0
chr3:125009628:C:G	0	0	0	0	0	0	0	0
chr3:125009782:A:G	0	0	0	0	0	0	0	0
chr3:125012641:C:G	0	0	0	0	0	0	0	0
chr3:125013774:A:G	0	0	0	0	0	0	0	0
chr3:125019263:C:T	0	0	0	0	0	0	0	0
chr3:125021048:G:A	0	0	0	0	0	0	0	0
chr3:125027205:A:G	0	0	0	0	0	0	0	0
chr3:125027338:C:A	0	0	0	0	0	0	0	0
chr3:125027503:T:C	0	0	0	0	0	0	0	0
chr3:125029382:G:A	0	0	0	0	0	0	0	0
chr3:125083833:A:G	0	0	0	0	0	0	0	0
chr3:125084037:A:G	0	0	0	0	0	0	0	0
chr3:125925072:T:C	0	0	0	0	0	0	0	0
chr3:125929513:T:C	1	0	1	1	0	1	1	0
chr3:125934448:A:G	0	0	0	0	0	0	0	0
chr3:128064855:A:T	20	9	29	11	18	1.0	1.0	0.0
chr3:128081228:A:G	147	74	231	79	152	2	1	2
chr3:128264652:T:C	38	18	56	20	36	1.0	1.0	0.0
chr3:128462934:A:G	0	0	0	0	0	0	0	0
chr3:128481963:G:A	0	0	0	0	0	0	0	0
chr3:128486034:C:G	0	0	0	0	0	0	0	0
chr3:128486108:C:T	0	0	0	0	0	0	0	0
chr3:128487017:G:C	0	0	0	0	0	0	0	0
chr3:128638009:C:T	241	119	368	124	244	1	1	0
chr3:128895342:A:C	34	14	48	20	28	1.0	1.0	0.0
chr3:128909090:C:T	19	9	28	10	18	1	1	0
chr3:129037110:G:A	0	0	0	0	0	0	0	0
chr3:129272155:T:C	4	2	6	2	4	1.5	0.5	1.0
chr3:129428575:G:A	2	1	3	1	2	1.5	0.5	1.0
chr3:129514530:C:T	4	2	6	2	4	1.5	0.5	1.0
chr3:129565975:A:C	1	0	1	1	0	1	1	0
chr3:129567570:G:C	0	0	0	0	0	0	0	0
chr3:129567792:G:A	0	0	0	0	0	0	0	0
chr3:129572908:T:C	3	1	4	2	2	1	1	0
chr3:129574413:T:C	3	1	4	2	2	1	1	0
chr3:130643012:G:A	0	0	0	0	0	0	0	0
chr3:130649225:A:G	0	0	0	0	0	0	0	0
chr3:130649457:G:A	0	0	0	0	0	0	0	0
chr3:130999628:G:A	41	17	58	24	34	1	1	0
chr3:131024968:G:A	37	22	60	16	44	2	0	2
chr3:131228591:A:T	2	1	3	1	2	1.5	0.5	1.0
chr3:131462750:G:A	440	216	700	251	449	2.0	1.0	0.0
chr3:131549980:T:C	0	0	0	0	0	0	0	0
chr3:132356863:A:G	0	0	0	0	0	0	0	0
chr3:132356915:T:C	0	0	0	0	0	0	0	0
chr3:132682756:C:T	25	12	38	14	24	2	1	0
chr3:133380401:G:A	0	0	0	0	0	0	0	0
chr3:133746439:A:G	0	0	0	0	0	0	0	0
chr3:133754502:G:A	0	0	0	0	0	0	0	0
chr3:133755484:G:A	0	0	0	0	0	0	0	0
chr3:133768114:G:C	0	0	0	0	0	0	0	0
chr3:133805873:G:C	162	87	258	78	180	2.0	0.0	2.0
chr3:133942508:G:T	0	0	0	0	0	0	0	0
chr3:133947365:C:T	0	0	0	0	0	0	0	0
chr3:133951229:T:C	0	0	0	0	0	0	0	0
chr3:133979505:C:T	0	0	0	0	0	0	0	0
chr3:134358628:C:G	0	0	0	0	0	0	0	0
chr3:134486229:G:T	22	10	32	12	20	1.0	1.0	0.0
chr3:134603900:A:G	0	0	0	0	0	0	0	0
chr3:134603972:G:C	0	0	0	0	0	0	0	0
chr3:134951682:C:T	0	0	0	0	0	0	0	0
chr3:135179900:C:T	0	0	0	0	0	0	0	0
chr3:135248339:C:T	0	0	0	0	0	0	0	0
chr3:136001698:A:G	0	0	0	0	0	0	0	0
chr3:136298060:G:A	98	56	156	44	112	2.0	0.0	2.0
chr3:136855022:A:G	6	4	10	2	8	2.0	0.0	2.0
chr3:138068205:C:T	0	0	0	0	0	0	0	0
chr3:138068213:G:A	0	0	0	0	0	0	0	0
chr3:138068350:T:C	0	0	0	0	0	0	0	0
chr3:138124252:C:T	0	0	0	0	0	0	0	0
chr3:138124264:T:C	0	0	0	0	0	0	0	0
chr3:138124634:G:T	0	0	0	0	0	0	0	0
chr3:138131161:A:G	0	0	0	0	0	0	0	0
chr3:138161901:G:A	15	5	20	10	10	1	1	0
chr3:138162423:T:A	18	7	25	11	14	1.0	1.0	0.0
chr3:138163910:A:G	0	0	0	0	0	0	0	0
chr3:138263876:T:G	1	0	1	1	0	1	1	0
chr3:138464345:G:C	0	0	0	0	0	0	0	0
chr3:138470189:T:C	0	0	0	0	0	0	0	0
chr3:138470816:A:G	0	0	0	0	0	0	0	0
chr3:139005915:C:G	0	0	0	0	0	0	0	0
chr3:139043865:C:G	0	0	0	0	0	0	0	0
chr3:139044501:T:G	0	0	0	0	0	0	0	0
chr3:139538761:A:G	0	0	0	0	0	0	0	0
chr3:139539569:G:A	0	0	0	0	0	0	0	0
chr3:140459539:T:C	0	0	0	0	0	0	0	0
chr3:140459643:G:A	0	0	0	0	0	0	0	0
chr3:140566273:T:C	0	0	0	0	0	0	0	0
chr3:141066087:T:C	0	0	0	0	0	0	0	0
chr3:141066333:C:A	0	0	0	0	0	0	0	0
chr3:141444203:T:C	32	16	49	17	32	2.0	0.5	1.0
chr3:142404999:C:T	28	12	42	18	24	1.5	1.0	0.0
chr3:142459302:C:T	15	9	24	6	18	2	0	2
chr3:142503442:A:G	9	4	13	5	8	1	1	0
chr3:142558694:A:G	9	4	14	6	8	2	1	0
chr3:142784763:G:A	0	0	0	0	0	0	0	0
chr3:142804507:G:A	1	1	2	0	2	2	0	2
chr3:142806016:G:A	1	1	2	0	2	2	0	2
chr3:143176702:G:A	0	0	0	0	0	0	0	0
chr3:143177093:C:G	0	0	0	0	0	0	0	0
chr3:143177111:A:T	0	0	0	0	0	0	0	0
chr3:143177433:T:C	0	0	0	0	0	0	0	0
chr3:143177444:C:A	0	0	0	0	0	0	0	0
chr3:143574170:A:G	13	3	16	10	6	1	1	0
chr3:146199974:T:C	0	0	0	0	0	0	0	0
chr3:146460028:C:T	1	0	1	1	0	1	1	0
chr3:146517066:C:T	63	27	91	37	54	1	1	0
chr3:147403964:C:T	0	0	0	0	0	0	0	0
chr3:148741608:C:T	0	0	0	0	0	0	0	0
chr3:148857369:C:T	0	0	0	0	0	0	0	0
chr3:148857593:C:T	0	0	0	0	0	0	0	0
chr3:148986000:T:G	0	0	0	0	0	0	0	0
chr3:149041538:T:C	1	0	1	1	0	1	1	0
chr3:149375451:A:G	0	0	0	0	0	0	0	0
chr3:150410605:G:A	63	35	99	29	70	2	0	2
chr3:150562658:C:G	318	174	512	159	353	2.0	0.0	2.0
chr3:150943947:G:A	0	0	0	0	0	0	0	0
chr3:150972652:T:A	0	0	0	0	0	0	0	0
chr3:150972779:T:C	0	0	0	0	0	0	0	0
chr3:151446407:T:C	0	0	0	0	0	0	0	0
chr3:151447890:T:C	0	0	0	0	0	0	0	0
chr3:151448634:C:T	0	0	0	0	0	0	0	0
chr3:151453651:A:C	0	0	0	0	0	0	0	0
chr3:151453754:A:G	0	0	0	0	0	0	0	0
chr3:151827813:G:A	0	0	0	0	0	0	0	0
chr3:154255619:T:C	0	0	0	0	0	0	0	0
chr3:155523951:A:G	0	0	0	0	0	0	0	0
chr3:155763820:G:A	14	4	18	10	8	1.0	1.0	0.0
chr3:156291825:A:G	0	0	0	0	0	0	0	0
chr3:156531425:T:C	0	0	0	0	0	0	0	0
chr3:157437525:C:A	0	0	0	0	0	0	0	0
chr3:158571246:T:A	10	7	17	3	14	2.0	0.0	2.0
chr3:158644602:C:T	118	45	163	73	90	1.0	1.0	0.0
chr3:158650048:C:T	4	2	6	2	4	1.5	0.5	1.0
chr3:158710853:G:A	0	0	0	0	0	0	0	0
chr3:158802222:C:T	145	83	238	64	174	2	0	2
chr3:159840078:G:A	0	0	0	0	0	0	0	0
chr3:161086379:C:T	2	2	4	0	4	2.0	0.0	2.0
chr3:161503917:A:C	0	0	0	0	0	0	0	0
chr3:165046931:C:A	0	0	0	0	0	0	0	0
chr3:165065377:T:C	0	0	0	0	0	0	0	0
chr3:165067408:C:T	0	0	0	0	0	0	0	0
chr3:167471819:A:C	0	0	0	0	0	0	0	0
chr3:167500176:A:G	0	0	0	0	0	0	0	0
chr3:169116597:C:T	0	0	0	0	0	0	0	0
chr3:169381204:G:A	4	4	8	0	8	2.0	0.0	2.0
chr3:169822262:T:C	2	1	3	1	2	1.5	0.5	1.0
chr3:169822609:T:C	2	1	3	1	2	1.5	0.5	1.0
chr3:169840237:C:T	0	0	0	0	0	0	0	0
chr3:170360444:C:T	25	15	42	10	32	2	0	2
chr3:171014637:G:A	0	0	0	0	0	0	0	0
chr3:171175281:G:A	0	0	0	0	0	0	0	0
chr3:171228213:A:G	0	0	0	0	0	0	0	0
chr3:171659253:T:C	2	1	3	1	2	1.5	0.5	1.0
chr3:172329071:T:C	0	0	0	0	0	0	0	0
chr3:172346301:G:A	0	0	0	0	0	0	0	0
chr3:172447937:C:T	0	0	0	0	0	0	0	0
chr3:172506513:A:G	48	20	70	30	40	1.0	1.0	0.0
chr3:172603644:G:T	0	0	0	0	0	0	0	0
chr3:172710992:T:C	7	3	10	4	6	1	1	0
chr3:173049032:G:A	0	0	0	0	0	0	0	0
chr3:173117335:T:C	0	0	0	0	0	0	0	0
chr3:178828238:T:C	0	0	0	0	0	0	0	0
chr3:178842793:A:C	0	0	0	0	0	0	0	0
chr3:179067761:G:A	27	12	39	15	24	1	1	0
chr3:179258989:C:T	0	0	0	0	0	0	0	0
chr3:179259033:G:A	0	0	0	0	0	0	0	0
chr3:179260290:T:G	10	5	15	5	10	1.5	0.5	1.0
chr3:179260540:C:T	10	5	15	5	10	1.5	0.5	1.0
chr3:179419485:A:G	2	2	4	0	4	2.0	0.0	2.0
chr3:179576564:C:A	2	2	4	0	4	2.0	0.0	2.0
chr3:179588987:C:T	374	227	633	161	472	2.0	0.0	2.0
chr3:179604597:A:C	467	276	785	208	577	2	0	2
chr3:179653366:C:T	5	3	8	2	6	2	0	2
chr3:180648168:G:A	0	0	0	0	0	0	0	0
chr3:180648279:T:C	0	0	0	0	0	0	0	0
chr3:180659741:G:C	0	0	0	0	0	0	0	0
chr3:182914004:C:A	13	4	17	9	8	1	1	0
chr3:183099540:C:G	21	7	28	14	14	1	1	0
chr3:183508326:G:T	15	6	21	9	12	1	1	0
chr3:183650428:A:T	191	99	300	100	200	2	1	2
chr3:183651103:C:T	207	106	323	109	214	2	1	2
chr3:183967746:A:G	6	2	8	4	4	1.0	1.0	0.0
chr3:183978614:A:G	5	3	8	2	6	2	0	2
chr3:184056974:C:A	0	0	0	0	0	0	0	0
chr3:184060222:G:C	0	0	0	0	0	0	0	0
chr3:184083921:C:T	0	0	0	0	0	0	0	0
chr3:184100628:G:A	0	0	0	0	0	0	0	0
chr3:184143455:A:G	35	24	59	11	48	2	0	2
chr3:184233347:C:T	0	0	0	0	0	0	0	0
chr3:184233643:C:T	0	0	0	0	0	0	0	0
chr3:184236184:G:A	0	0	0	0	0	0	0	0
chr3:184237321:C:T	0	0	0	0	0	0	0	0
chr3:184241720:A:C	0	0	0	0	0	0	0	0
chr3:184242464:A:C	177	89	272	92	180	2	1	2
chr3:184258320:T:C	26	18	47	9	38	2.0	0.0	2.0
chr3:184258453:A:G	26	17	45	11	34	2.0	0.0	2.0
chr3:184292260:G:C	0	0	0	0	0	0	0	0
chr3:184308915:C:T	140	68	211	75	136	1.5	1.0	0.0
chr3:184321878:A:G	33	18	51	15	36	2	0	2
chr3:184328567:C:T	7	5	12	2	10	2	0	2
chr3:184328682:C:T	24	12	36	12	24	1.5	0.5	1.0
chr3:184344988:A:G	14	7	21	7	14	1.5	0.5	1.0
chr3:184353275:G:C	1	1	2	0	2	2	0	2
chr3:184372478:C:T	0	0	0	0	0	0	0	0
chr3:184376395:A:G	0	0	0	0	0	0	0	0
chr3:184426797:A:G	0	0	0	0	0	0	0	0
chr3:184575981:T:C	0	0	0	0	0	0	0	0
chr3:184578040:C:A	0	0	0	0	0	0	0	0
chr3:184581280:G:A	0	0	0	0	0	0	0	0
chr3:184581379:T:C	0	0	0	0	0	0	0	0
chr3:184581626:C:T	0	0	0	0	0	0	0	0
chr3:185418481:G:A	0	0	0	0	0	0	0	0
chr3:185418495:A:G	0	0	0	0	0	0	0	0
chr3:185494805:T:C	5	3	8	2	6	2	0	2
chr3:186272307:C:T	27	9	36	18	18	1	1	0
chr3:186288777:T:C	45	17	62	28	34	1	1	0
chr3:186570776:A:G	421	225	681	215	466	2	0	2
chr3:186620636:A:C	0	0	0	0	0	0	0	0
chr3:186671770:T:C	0	0	0	0	0	0	0	0
chr3:186677324:A:G	0	0	0	0	0	0	0	0
chr3:186677647:C:T	0	0	0	0	0	0	0	0
chr3:186722454:G:A	0	0	0	0	0	0	0	0
chr3:186742138:T:C	1	0	1	1	0	1	1	0
chr3:186787917:A:C	110	65	180	50	130	2.0	0.0	2.0
chr3:186789968:G:A	158	86	248	76	172	2.0	0.0	2.0
chr3:187669043:T:C	0	0	0	0	0	0	0	0
chr3:188872658:A:G	22	9	31	13	18	1.0	1.0	0.0
chr3:189320859:T:C	0	0	0	0	0	0	0	0
chr3:189631458:A:T	0	0	0	0	0	0	0	0
chr3:189873035:G:C	0	0	0	0	0	0	0	0
chr3:189987753:A:G	0	0	0	0	0	0	0	0
chr3:190308175:C:T	0	0	0	0	0	0	0	0
chr3:190564408:G:A	5	4	9	1	8	2	0	2
chr3:193314137:C:T	0	0	0	0	0	0	0	0
chr3:193318994:G:A	0	0	0	0	0	0	0	0
chr3:193362625:C:G	0	0	0	0	0	0	0	0
chr3:193378740:C:T	0	0	0	0	0	0	0	0
chr3:193454190:T:A	0	0	0	0	0	0	0	0
chr3:193466028:A:G	0	0	0	0	0	0	0	0
chr3:193554628:A:G	0	0	0	0	0	0	0	0
chr3:193644128:G:A	4	2	6	2	4	1.5	0.5	1.0
chr3:194341097:C:T	0	0	0	0	0	0	0	0
chr3:194341177:T:C	0	0	0	0	0	0	0	0
chr3:194341790:C:T	0	0	0	0	0	0	0	0
chr3:194341836:C:T	0	0	0	0	0	0	0	0
chr3:194342571:T:C	0	0	0	0	0	0	0	0
chr3:194617694:C:T	1	0	1	1	0	1	1	0
chr3:194628449:C:T	38	14	52	24	28	1.0	1.0	0.0
chr3:195729837:G:A	2	2	4	0	4	2.0	0.0	2.0
chr3:195791459:C:G	2	1	3	1	2	1.5	0.5	1.0
chr3:195868079:G:A	12	5	17	7	10	1.0	1.0	0.0
chr3:195868830:C:T	0	0	0	0	0	0	0	0
chr3:195892510:C:T	0	0	0	0	0	0	0	0
chr3:196055305:CA:TG	4	1	5	3	2	1.0	1.0	0.0
chr3:196055313:C:T	4	1	5	3	2	1.0	1.0	0.0
chr3:196062543:T:C	1	1	2	0	2	2	0	2
chr3:196062837:G:T	4	2	6	2	4	1.5	0.5	1.0
chr3:196073940:C:T	24	8	32	16	16	1.0	1.0	0.0
chr3:196296090:G:T	0	0	0	0	0	0	0	0
chr3:196947436:C:T	0	0	0	0	0	0	0	0
chr3:196948045:A:C	0	0	0	0	0	0	0	0
chr3:197621767:G:A	33	13	46	20	26	1	1	0
chr3:197675081:T:C	2	1	3	1	2	1.5	0.5	1.0
chr3:197700686:A:G	37	21	58	16	42	2	0	2
chr3:197870173:C:T	26	10	36	16	20	1.0	1.0	0.0
chr3:197932289:C:G	50	19	71	31	40	1.0	1.0	0.0
chr3:197985888:T:C	1	1	2	0	2	2	0	2
chr3:198038561:C:T	2	1	3	1	2	1.5	0.5	1.0
chr4:161923:A:G	8	7	15	1	14	2.0	0.0	2.0
chr4:516061:T:C	58	30	89	29	60	2.0	0.5	2.0
chr4:521700:G:A	25	13	38	12	26	2	0	2
chr4:522055:C:A	16	6	22	10	12	1.0	1.0	0.0
chr4:523587:T:C	13	8	21	5	16	2	0	2
chr4:523672:T:C	12	8	20	4	16	2.0	0.0	2.0
chr4:523833:C:T	13	8	21	5	16	2	0	2
chr4:527064:G:A	17	10	27	7	20	2	0	2
chr4:533745:G:A	6	4	10	2	8	2.0	0.0	2.0
chr4:533888:T:C	31	19	51	12	39	2	0	2
chr4:539212:T:C	42	25	69	17	52	2.0	0.0	2.0
chr4:655850:C:A	0	0	0	0	0	0	0	0
chr4:656087:C:T	0	0	0	0	0	0	0	0
chr4:670119:A:G	126	65	193	61	132	2.0	0.0	2.0
chr4:670127:C:A	126	65	193	61	132	2.0	0.0	2.0
chr4:761237:G:A	3	2	5	1	4	2	0	2
chr4:761341:C:T	20	10	30	10	20	1.5	0.5	1.0
chr4:792613:T:C	0	0	0	0	0	0	0	0
chr4:849932:T:C	60	31	91	29	62	2.0	0.0	2.0
chr4:966754:T:G	1	0	1	1	0	1	1	0
chr4:967609:C:T	1	1	2	0	2	2	0	2
chr4:989064:G:A	0	0	0	0	0	0	0	0
chr4:989896:A:G	0	0	0	0	0	0	0	0
chr4:990021:C:T	0	0	0	0	0	0	0	0
chr4:1025103:G:T	0	0	0	0	0	0	0	0
chr4:1093477:T:C	0	0	0	0	0	0	0	0
chr4:1093550:C:T	0	0	0	0	0	0	0	0
chr4:1096837:G:A	0	0	0	0	0	0	0	0
chr4:1170489:C:G	1	1	2	0	2	2	0	2
chr4:1171976:C:T	0	0	0	0	0	0	0	0
chr4:1309894:G:T	0	0	0	0	0	0	0	0
chr4:1338354:C:T	8	3	11	5	6	1.0	1.0	0.0
chr4:1376097:G:A	2	0	2	2	0	1.0	1.0	0.0
chr4:1644290:C:G	0	0	0	0	0	0	0	0
chr4:1655074:A:C	1	0	1	1	0	1	1	0
chr4:1655554:G:A	0	0	0	0	0	0	0	0
chr4:1717567:T:C	52	27	79	25	54	2.0	0.0	2.0
chr4:1727698:C:G	2	2	4	0	4	2.0	0.0	2.0
chr4:1727829:G:A	53	27	80	26	54	2	0	2
chr4:1728488:C:G	52	28	81	25	56	2.0	0.0	2.0
chr4:1728572:A:G	52	27	79	26	53	2.0	0.0	1.5
chr4:1739936:G:A	1	0	1	1	0	1	1	0
chr4:1740013:G:A	1	0	1	1	0	1	1	0
chr4:1955267:C:A	2	1	3	1	2	1.5	0.5	1.0
chr4:1984815:C:T	40	14	54	26	28	1.0	1.0	0.0
chr4:1986466:T:C	2	2	4	0	4	2.0	0.0	2.0
chr4:1986530:A:G	2	2	4	0	4	2.0	0.0	2.0
chr4:2274108:G:A	1	1	2	0	2	2	0	2
chr4:2304326:A:G	1	1	2	0	2	2	0	2
chr4:2305394:G:A	1	1	2	0	2	2	0	2
chr4:2305451:G:C	1	1	2	0	2	2	0	2
chr4:2330615:C:G	2	0	2	2	0	1.0	1.0	0.0
chr4:2339467:T:C	14	2	16	12	4	1.0	1.0	0.0
chr4:2341454:C:T	4	3	7	1	6	2.0	0.0	2.0
chr4:2458844:C:T	0	0	0	0	0	0	0	0
chr4:2742360:G:A	172	65	242	112	130	1.0	1.0	0.0
chr4:2744558:A:C	17	6	23	11	12	1	1	0
chr4:2820740:G:T	32	19	53	13	40	2.0	0.0	2.0
chr4:2829656:T:G	31	19	52	12	40	2	0	2
chr4:2904726:T:G	3	1	4	2	2	1	1	0
chr4:2904980:G:T	137	68	208	70	138	2	1	0
chr4:2915035:C:G	119	60	183	61	122	2	1	2
chr4:2941634:T:C	14	9	23	5	18	2.0	0.0	2.0
chr4:2950077:A:G	16	10	27	7	20	2.0	0.0	2.0
chr4:2988772:G:T	0	0	0	0	0	0	0	0
chr4:3004316:C:T	0	0	0	0	0	0	0	0
chr4:3255866:C:T	1	0	1	1	0	1	1	0
chr4:3316686:A:G	0	0	0	0	0	0	0	0
chr4:3444405:C:G	0	0	0	0	0	0	0	0
chr4:3449382:G:A	0	0	0	0	0	0	0	0
chr4:3492873:A:G	0	0	0	0	0	0	0	0
chr4:3493099:A:C	0	0	0	0	0	0	0	0
chr4:3493120:G:A	0	0	0	0	0	0	0	0
chr4:3493171:C:T	0	0	0	0	0	0	0	0
chr4:3500868:C:T	0	0	0	0	0	0	0	0
chr4:3518035:A:G	481	258	773	247	526	2	1	2
chr4:3525059:C:T	0	0	0	0	0	0	0	0
chr4:4197575:C:G	0	0	0	0	0	0	0	0
chr4:4198033:G:A	0	0	0	0	0	0	0	0
chr4:4226555:G:T	0	0	0	0	0	0	0	0
chr4:4248128:G:A	136	74	210	62	148	2.0	0.0	2.0
chr4:4302795:A:C	22	10	32	12	20	1.0	1.0	0.0
chr4:4303022:G:A	12	8	20	4	16	2.0	0.0	2.0
chr4:4420831:A:C	1	0	1	1	0	1	1	0
chr4:5051829:G:A	1	1	2	0	2	2	0	2
chr4:5446865:G:A	0	0	0	0	0	0	0	0
chr4:5640547:T:C	9	2	11	7	4	1	1	0
chr4:5689175:T:C	24	6	30	18	12	1.0	1.0	0.0
chr4:5719294:A:C	0	0	0	0	0	0	0	0
chr4:5748177:T:C	0	0	0	0	0	0	0	0
chr4:5748234:G:C	0	0	0	0	0	0	0	0
chr4:5748276:A:G	0	0	0	0	0	0	0	0
chr4:5752817:T:C	0	0	0	0	0	0	0	0
chr4:5783715:G:A	0	0	0	0	0	0	0	0
chr4:5811051:G:A	0	0	0	0	0	0	0	0
chr4:5965074:T:C	0	0	0	0	0	0	0	0
chr4:5988383:C:A	0	0	0	0	0	0	0	0
chr4:5989749:G:A	0	0	0	0	0	0	0	0
chr4:6323291:A:T	0	0	0	0	0	0	0	0
chr4:6323359:G:A	0	0	0	0	0	0	0	0
chr4:7433261:A:G	0	0	0	0	0	0	0	0
chr4:7433282:G:A	0	0	0	0	0	0	0	0
chr4:7433331:C:T	0	0	0	0	0	0	0	0
chr4:7433994:C:T	0	0	0	0	0	0	0	0
chr4:7434346:C:T	0	0	0	0	0	0	0	0
chr4:7434512:C:T	0	0	0	0	0	0	0	0
chr4:7712763:T:C	0	0	0	0	0	0	0	0
chr4:7715183:C:T	0	0	0	0	0	0	0	0
chr4:7715285:G:A	0	0	0	0	0	0	0	0
chr4:7733384:A:G	0	0	0	0	0	0	0	0
chr4:7778855:C:T	0	0	0	0	0	0	0	0
chr4:7800500:G:C	0	0	0	0	0	0	0	0
chr4:7800565:G:A	0	0	0	0	0	0	0	0
chr4:7843027:C:G	0	0	0	0	0	0	0	0
chr4:7855503:C:T	0	0	0	0	0	0	0	0
chr4:8008032:G:A	1	1	2	0	2	2	0	2
chr4:8029744:A:G	1	1	2	0	2	2	0	2
chr4:8205356:A:G	71	45	120	28	92	2	0	2
chr4:8205427:C:T	57	34	95	25	70	2	0	2
chr4:8227221:T:C	7	2	9	5	4	1	1	0
chr4:8233202:A:C	12	6	18	6	12	1.5	0.5	1.0
chr4:8236424:C:T	149	88	249	63	186	2	0	2
chr4:8241013:G:C	185	103	301	86	215	2	0	2
chr4:8366877:C:T	19	11	30	8	22	2	0	2
chr4:8373615:G:A	9	6	15	3	12	2	0	2
chr4:8441314:C:T	29	21	50	8	42	2	0	2
chr4:8581015:C:T	0	0	0	0	0	0	0	0
chr4:8581129:T:G	0	0	0	0	0	0	0	0
chr4:8581585:A:C	0	0	0	0	0	0	0	0
chr4:8604091:C:T	0	0	0	0	0	0	0	0
chr4:10446016:A:G	26	17	43	9	34	2.0	0.0	2.0
chr4:13600309:C:T	12	5	17	7	10	1.0	1.0	0.0
chr4:15962862:G:A	0	0	0	0	0	0	0	0
chr4:15962878:G:A	0	0	0	0	0	0	0	0
chr4:15963047:C:T	0	0	0	0	0	0	0	0
chr4:16166866:T:C	9	4	15	5	10	1	1	0
chr4:17501759:C:T	92	43	135	49	86	1.0	1.0	0.0
chr4:17709453:T:C	0	0	0	0	0	0	0	0
chr4:17810992:A:C	4	3	7	1	6	2.0	0.0	2.0
chr4:17817262:T:C	2	0	2	2	0	1.0	1.0	0.0
chr4:17842406:G:A	3	3	8	0	8	2	0	2
chr4:20542561:C:T	0	0	0	0	0	0	0	0
chr4:20850543:A:G	0	0	0	0	0	0	0	0
chr4:20850621:A:G	0	0	0	0	0	0	0	0
chr4:23814301:T:C	0	0	0	0	0	0	0	0
chr4:24799732:C:T	0	0	0	0	0	0	0	0
chr4:25417661:T:C	40	16	58	24	34	1.0	1.0	0.0
chr4:25676577:A:G	0	0	0	0	0	0	0	0
chr4:25914236:C:A	283	197	497	93	404	2	0	2
chr4:26481586:C:T	0	0	0	0	0	0	0	0
chr4:26584259:C:T	32	19	52	14	38	2.0	0.0	2.0
chr4:26717947:T:C	15	3	18	12	6	1	1	0
chr4:36308427:C:T	0	0	0	0	0	0	0	0
chr4:37590506:G:A	0	0	0	0	0	0	0	0
chr4:37591052:T:C	0	0	0	0	0	0	0	0
chr4:37834680:T:C	100	51	155	53	102	2.0	1.0	2.0
chr4:37960512:G:A	2	1	3	1	2	1.5	0.5	1.0
chr4:37960565:G:C	2	1	3	1	2	1.5	0.5	1.0
chr4:38021658:G:C	62	31	91	31	60	1.0	0.5	0.5
chr4:38021673:G:A	62	31	93	31	62	1.5	0.5	1.0
chr4:38118264:G:A	5	2	7	3	4	1	1	0
chr4:38697303:C:T	6	4	10	2	8	2.0	0.0	2.0
chr4:38774486:T:G	34	12	46	22	24	1.0	1.0	0.0
chr4:38774682:T:C	33	11	44	22	22	1	1	0
chr4:38774870:T:G	94	55	152	40	112	2.0	0.0	2.0
chr4:38775552:A:T	96	55	152	42	110	2.0	0.0	2.0
chr4:38797027:C:A	29	15	45	15	30	2	0	2
chr4:38797314:C:T	25	13	39	13	26	2	0	2
chr4:38798089:T:C	24	11	37	15	22	1.5	1.0	0.0
chr4:38827207:G:A	1	0	1	1	0	1	1	0
chr4:38827542:A:C	1	1	2	0	2	2	0	2
chr4:38878328:G:A	87	38	127	51	76	1	1	0
chr4:38878425:T:C	87	39	129	51	78	1	1	0
chr4:38929300:A:G	37	16	53	21	32	1	1	0
chr4:38932238:G:A	4	1	6	4	2	1.5	1.0	0.0
chr4:38943548:A:G	5	2	8	4	4	2	1	0
chr4:39465159:A:G	48	26	74	22	52	2.0	0.0	2.0
chr4:39510727:T:C	12	8	21	5	16	2.0	0.0	2.0
chr4:39770180:C:G	3	1	4	2	2	1	1	0
chr4:39976385:A:G	10	5	16	6	10	1.5	1.0	1.0
chr4:40102147:G:T	45	27	73	18	55	2	0	2
chr4:40117881:T:C	54	34	90	20	70	2.0	0.0	2.0
chr4:40425973:G:C	12	7	19	5	14	2.0	0.0	2.0
chr4:40808646:A:G	0	0	0	0	0	0	0	0
chr4:40808961:G:A	0	0	0	0	0	0	0	0
chr4:41013806:G:A	0	0	0	0	0	0	0	0
chr4:41013882:C:T	0	0	0	0	0	0	0	0
chr4:42455331:T:C	3	1	4	2	2	1	1	0
chr4:43030595:G:A	0	0	0	0	0	0	0	0
chr4:44624624:A:G	0	0	0	0	0	0	0	0
chr4:44680448:T:C	69	31	100	38	62	1	1	0
chr4:46993349:G:T	0	0	0	0	0	0	0	0
chr4:47536027:G:A	7	1	8	6	2	1	1	0
chr4:47558146:C:A	3	0	3	3	0	1	1	0
chr4:47568859:G:A	1	1	2	0	2	2	0	2
chr4:47576954:G:A	3	1	4	2	2	1	1	0
chr4:47591146:A:G	2	1	3	1	2	1.5	0.5	1.0
chr4:47591266:G:C	2	1	3	1	2	1.5	0.5	1.0
chr4:47665047:T:C	0	0	0	0	0	0	0	0
chr4:47680157:A:G	0	0	0	0	0	0	0	0
chr4:47936862:G:A	0	0	0	0	0	0	0	0
chr4:48035909:A:G	0	0	0	0	0	0	0	0
chr4:48341676:G:A	85	35	121	51	70	1	1	0
chr4:52072077:T:C	0	0	0	0	0	0	0	0
chr4:53365943:G:A	71	32	103	39	64	1	1	0
chr4:54100500:C:T	0	0	0	0	0	0	0	0
chr4:54100752:T:C	0	0	0	0	0	0	0	0
chr4:54263911:T:C	0	0	0	0	0	0	0	0
chr4:54267559:T:G	0	0	0	0	0	0	0	0
chr4:54727298:A:C	0	0	0	0	0	0	0	0
chr4:54736599:G:C	0	0	0	0	0	0	0	0
chr4:55424406:T:C	2	1	3	1	2	1.5	0.5	1.0
chr4:55443825:A:G	4	2	6	2	4	1.5	0.5	1.0
chr4:55868535:C:T	16	9	25	7	18	2.0	0.0	2.0
chr4:55890365:T:C	39	21	62	18	44	2	0	2
chr4:56314535:A:G	0	0	0	0	0	0	0	0
chr4:56338611:A:C	9	6	15	3	12	2	0	2
chr4:56345186:T:C	4	3	7	1	6	2.0	0.0	2.0
chr4:56349803:C:T	3	1	4	2	2	1	1	0
chr4:56435515:G:A	48	23	76	26	50	1.5	1.0	0.0
chr4:56435584:G:A	35	21	58	14	44	2	0	2
chr4:56530884:A:C	0	0	0	0	0	0	0	0
chr4:56530916:T:C	0	0	0	0	0	0	0	0
chr4:56531030:C:G	0	0	0	0	0	0	0	0
chr4:56650683:C:T	0	0	0	0	0	0	0	0
chr4:61935010:T:C	0	0	0	0	0	0	0	0
chr4:67911336:C:T	0	0	0	0	0	0	0	0
chr4:68316224:G:A	6	5	11	1	10	2.0	0.0	2.0
chr4:68647129:T:G	0	0	0	0	0	0	0	0
chr4:68816130:T:C	0	0	0	0	0	0	0	0
chr4:68816218:G:T	0	0	0	0	0	0	0	0
chr4:69019965:T:C	0	0	0	0	0	0	0	0
chr4:69096892:A:G	0	0	0	0	0	0	0	0
chr4:69214120:T:C	0	0	0	0	0	0	0	0
chr4:69647003:G:T	0	0	0	0	0	0	0	0
chr4:69727072:G:T	0	0	0	0	0	0	0	0
chr4:70055620:G:A	0	0	0	0	0	0	0	0
chr4:70202772:T:C	0	0	0	0	0	0	0	0
chr4:70249343:G:A	0	0	0	0	0	0	0	0
chr4:70249435:T:C	0	0	0	0	0	0	0	0
chr4:70335931:T:G	0	0	0	0	0	0	0	0
chr4:70389876:G:A	0	0	0	0	0	0	0	0
chr4:70389940:A:G	0	0	0	0	0	0	0	0
chr4:70518820:C:T	0	0	0	0	0	0	0	0
chr4:70531272:C:T	0	0	0	0	0	0	0	0
chr4:70982143:A:T	2	0	2	2	0	1.0	1.0	0.0
chr4:71752606:G:T	0	0	0	0	0	0	0	0
chr4:71752617:A:C	0	0	0	0	0	0	0	0
chr4:72548569:C:T	0	0	0	0	0	0	0	0
chr4:73076961:C:T	19	10	29	9	20	2	0	2
chr4:73091019:G:A	11	4	15	7	8	1	1	0
chr4:73585356:A:G	15	15	30	0	30	2	0	2
chr4:73620528:C:T	49	49	104	0	104	2	0	2
chr4:73869434:C:T	0	0	0	0	0	0	0	0
chr4:75914984:A:G	192	102	303	93	210	2.0	0.0	2.0
chr4:75957535:G:A	71	38	109	33	76	2	0	2
chr4:76021790:C:G	0	0	0	0	0	0	0	0
chr4:76034761:T:C	0	0	0	0	0	0	0	0
chr4:76036018:C:T	0	0	0	0	0	0	0	0
chr4:76112437:C:T	1	0	1	1	0	1	1	0
chr4:76118199:A:G	10	3	13	7	6	1.0	1.0	0.0
chr4:76256262:C:T	0	0	0	0	0	0	0	0
chr4:76271685:A:C	0	0	0	0	0	0	0	0
chr4:76740972:C:T	0	0	0	0	0	0	0	0
chr4:76741333:G:T	0	0	0	0	0	0	0	0
chr4:76896209:T:C	0	0	0	0	0	0	0	0
chr4:76896721:G:T	0	0	0	0	0	0	0	0
chr4:76897049:T:C	0	0	0	0	0	0	0	0
chr4:77158542:T:G	63	30	95	33	62	1	1	0
chr4:77158619:G:A	61	32	94	30	64	2	0	2
chr4:78057987:C:T	1	1	2	0	2	2	0	2
chr4:78284545:T:A	0	0	0	0	0	0	0	0
chr4:78317495:T:C	0	0	0	0	0	0	0	0
chr4:78318909:A:G	0	0	0	0	0	0	0	0
chr4:78363540:C:T	0	0	0	0	0	0	0	0
chr4:78450425:G:A	0	0	0	0	0	0	0	0
chr4:78451776:C:T	0	0	0	0	0	0	0	0
chr4:78464565:G:A	0	0	0	0	0	0	0	0
chr4:78466432:A:G	0	0	0	0	0	0	0	0
chr4:78479714:C:T	0	0	0	0	0	0	0	0
chr4:78511301:A:C	0	0	0	0	0	0	0	0
chr4:78516001:C:T	0	0	0	0	0	0	0	0
chr4:78522696:G:A	0	0	0	0	0	0	0	0
chr4:78526609:T:C	0	0	0	0	0	0	0	0
chr4:78604250:G:A	0	0	0	0	0	0	0	0
chr4:78865702:G:A	48	25	73	23	50	2.0	0.0	2.0
chr4:78878926:G:A	35	15	50	20	30	1	1	0
chr4:78911355:A:C	30	17	47	13	34	2.0	0.0	2.0
chr4:78930372:G:C	8	3	11	5	6	1.0	1.0	0.0
chr4:79408189:T:C	0	0	0	0	0	0	0	0
chr4:79977654:C:T	84	44	131	41	90	2.0	0.0	2.0
chr4:82917109:G:T	5	3	8	2	6	2	0	2
chr4:83267697:G:A	62	34	96	28	68	2.0	0.0	2.0
chr4:83269878:A:G	60	28	88	32	56	1.0	1.0	0.0
chr4:83462582:C:T	58	28	86	30	56	1.0	1.0	0.0
chr4:84244126:G:C	0	0	0	0	0	0	0	0
chr4:85923682:A:G	1212	581	2037	806	1231	2.0	1.0	0.0
chr4:86751082:G:T	0	0	0	0	0	0	0	0
chr4:86762878:A:G	0	0	0	0	0	0	0	0
chr4:87047646:A:T	23	11	34	12	22	1	1	0
chr4:87613083:A:G	0	0	0	0	0	0	0	0
chr4:87614633:C:T	0	0	0	0	0	0	0	0
chr4:87615210:G:A	0	0	0	0	0	0	0	0
chr4:87615368:T:C	0	0	0	0	0	0	0	0
chr4:87615398:T:C	0	0	0	0	0	0	0	0
chr4:87616205:T:C	0	0	0	0	0	0	0	0
chr4:87616232:T:C	0	0	0	0	0	0	0	0
chr4:87616253:T:C	0	0	0	0	0	0	0	0
chr4:87616268:C:T	0	0	0	0	0	0	0	0
chr4:87616585:G:A	0	0	0	0	0	0	0	0
chr4:87811379:T:C	0	0	0	0	0	0	0	0
chr4:87811594:A:G	0	0	0	0	0	0	0	0
chr4:87891948:G:A	0	0	0	0	0	0	0	0
chr4:87891974:C:A	0	0	0	0	0	0	0	0
chr4:87893837:C:T	0	0	0	0	0	0	0	0
chr4:88390810:T:C	10	5	15	5	10	1.5	0.5	1.0
chr4:90309428:G:A	0	0	0	0	0	0	0	0
chr4:90780569:C:T	0	0	0	0	0	0	0	0
chr4:93395612:T:G	0	0	0	0	0	0	0	0
chr4:94252628:T:C	45	23	69	23	46	2	1	2
chr4:94264904:A:G	14	7	21	7	14	1.5	0.5	1.0
chr4:94575731:C:T	20	14	34	6	28	2.0	0.0	2.0
chr4:94640308:A:G	8	1	9	7	2	1.0	1.0	0.0
chr4:95840105:G:C	0	0	0	0	0	0	0	0
chr4:99313896:A:G	0	0	0	0	0	0	0	0
chr4:99317955:A:C	0	0	0	0	0	0	0	0
chr4:99550953:T:C	3	3	6	0	6	2	0	2
chr4:99649524:T:A	0	0	0	0	0	0	0	0
chr4:99649844:T:C	0	0	0	0	0	0	0	0
chr4:99653038:A:G	0	0	0	0	0	0	0	0
chr4:99654554:C:T	0	0	0	0	0	0	0	0
chr4:99816878:G:T	246	104	357	145	212	1.0	1.0	0.0
chr4:102253334:A:G	0	0	0	0	0	0	0	0
chr4:102267667:A:G	0	0	0	0	0	0	0	0
chr4:102304356:T:C	0	0	0	0	0	0	0	0
chr4:102634835:A:G	28	13	41	15	26	1.0	1.0	0.0
chr4:102635920:G:A	16	7	23	9	14	1.0	1.0	0.0
chr4:102827067:G:A	311	172	506	146	360	2	0	2
chr4:102901141:C:T	18	0	18	18	0	1.0	1.0	0.0
chr4:103043372:A:C	29	17	46	12	34	2	0	2
chr4:103145733:T:A	0	0	0	0	0	0	0	0
chr4:103161192:C:T	0	0	0	0	0	0	0	0
chr4:105234028:C:G	37	14	51	23	28	1	1	0
chr4:105275794:A:G	1	1	2	0	2	2	0	2
chr4:105474024:G:A	272	140	434	142	292	2.0	0.5	2.0
chr4:105938392:G:C	0	0	0	0	0	0	0	0
chr4:105940573:A:G	0	0	0	0	0	0	0	0
chr4:105969030:C:A	0	0	0	0	0	0	0	0
chr4:107645048:T:C	239	118	361	123	238	1	1	0
chr4:107720161:G:A	308	152	484	170	314	2.0	1.0	0.0
chr4:108742458:G:A	0	0	0	0	0	0	0	0
chr4:108942214:C:T	0	0	0	0	0	0	0	0
chr4:109760349:C:T	0	0	0	0	0	0	0	0
chr4:112425840:G:A	4	0	4	4	0	1.0	1.0	0.0
chr4:112430666:G:A	5	2	7	3	4	1	1	0
chr4:112431241:G:A	1	0	1	1	0	1	1	0
chr4:112431472:A:G	1	0	1	1	0	1	1	0
chr4:112431589:G:A	2	1	3	1	2	1.5	0.5	1.0
chr4:112431743:G:A	2	1	3	1	2	1.5	0.5	1.0
chr4:112432129:T:C	3	2	5	1	4	2	0	2
chr4:112438547:A:G	2	2	4	0	4	2.0	0.0	2.0
chr4:112514888:T:G	0	0	0	0	0	0	0	0
chr4:112562290:C:A	5	1	6	4	2	1	1	0
chr4:112618813:T:C	4	2	6	2	4	1.5	0.5	1.0
chr4:112633229:A:T	7	2	9	5	4	1	1	0
chr4:118240640:G:A	0	0	0	0	0	0	0	0
chr4:118282324:T:C	1	1	2	0	2	2	0	2
chr4:118514975:G:A	0	0	0	0	0	0	0	0
chr4:118523301:G:A	0	0	0	0	0	0	0	0
chr4:118815452:C:T	32	17	49	15	34	2.0	0.0	2.0
chr4:118815458:C:T	32	17	49	15	34	2.0	0.0	2.0
chr4:119026830:G:C	0	0	0	0	0	0	0	0
chr4:119031800:C:T	0	0	0	0	0	0	0	0
chr4:119318976:T:C	0	0	0	0	0	0	0	0
chr4:119319083:T:C	0	0	0	0	0	0	0	0
chr4:120060059:T:C	25	15	41	11	30	2	0	2
chr4:120816612:G:A	0	0	0	0	0	0	0	0
chr4:121036404:G:A	0	0	0	0	0	0	0	0
chr4:121036936:T:G	0	0	0	0	0	0	0	0
chr4:121037032:A:G	0	0	0	0	0	0	0	0
chr4:121037536:T:C	0	0	0	0	0	0	0	0
chr4:121037542:G:A	0	0	0	0	0	0	0	0
chr4:121932961:G:C	0	0	0	0	0	0	0	0
chr4:122192273:A:G	8	5	15	3	12	2.0	0.0	2.0
chr4:122224596:T:A	7	2	10	6	4	1	1	0
chr4:122257419:T:C	0	0	0	0	0	0	0	0
chr4:122347704:A:G	8	6	14	2	12	2.0	0.0	2.0
chr4:122893153:C:T	29	13	42	16	26	1	1	0
chr4:122917603:A:G	31	15	46	16	30	1	1	0
chr4:122922586:A:G	17	4	21	13	8	1	1	0
chr4:124669323:T:C	0	0	0	0	0	0	0	0
chr4:124669583:T:C	0	0	0	0	0	0	0	0
chr4:124670268:A:T	0	0	0	0	0	0	0	0
chr4:124671285:T:C	0	0	0	0	0	0	0	0
chr4:125451587:G:A	0	0	0	0	0	0	0	0
chr4:125451820:A:C	0	0	0	0	0	0	0	0
chr4:125452415:C:T	0	0	0	0	0	0	0	0
chr4:128946125:T:A	5	2	7	3	4	1	1	0
chr4:129102604:A:T	52	20	73	34	39	1.0	1.0	0.0
chr4:129109497:A:G	50	19	71	33	38	1.0	1.0	0.0
chr4:133152903:A:G	0	0	0	0	0	0	0	0
chr4:137528529:A:G	0	0	0	0	0	0	0	0
chr4:138561804:G:T	0	0	0	0	0	0	0	0
chr4:139266940:C:T	0	0	0	0	0	0	0	0
chr4:139454142:C:G	78	39	117	39	78	1.5	0.5	1.0
chr4:139529115:T:C	14	6	20	8	12	1.0	1.0	0.0
chr4:140622843:G:A	14	8	22	6	16	2.0	0.0	2.0
chr4:140676972:C:T	10	4	14	6	8	1.0	1.0	0.0
chr4:140679166:A:G	12	3	15	9	6	1.0	1.0	0.0
chr4:141719385:T:C	76	33	109	43	66	1.0	1.0	0.0
chr4:142112625:T:C	0	0	0	0	0	0	0	0
chr4:142145901:G:A	0	0	0	0	0	0	0	0
chr4:143880509:C:G	12	0	13	13	0	1.0	1.0	0.0
chr4:145732468:G:A	0	0	0	0	0	0	0	0
chr4:146189739:A:G	557	275	918	346	572	2	1	0
chr4:146640502:C:G	0	0	0	0	0	0	0	0
chr4:147542688:G:C	0	0	0	0	0	0	0	0
chr4:149735451:T:C	0	0	0	0	0	0	0	0
chr4:150285975:C:T	10	5	15	5	10	1.5	0.5	1.0
chr4:151279901:G:A	0	0	0	0	0	0	0	0
chr4:151291334:C:T	0	0	0	0	0	0	0	0
chr4:151577473:C:T	0	0	0	0	0	0	0	0
chr4:151649698:G:C	0	0	0	0	0	0	0	0
chr4:151662612:C:G	0	0	0	0	0	0	0	0
chr4:152769690:T:C	1	1	2	0	2	2	0	2
chr4:152976618:G:A	1	0	1	1	0	1	1	0
chr4:153276082:T:G	11	5	16	6	10	1	1	0
chr4:153295558:G:A	1	1	2	0	2	2	0	2
chr4:153558278:T:C	289	151	456	142	314	2	0	2
chr4:153584929:G:A	152	70	221	83	138	1.0	1.0	0.0
chr4:154298230:G:C	0	0	0	0	0	0	0	0
chr4:154298397:T:G	0	0	0	0	0	0	0	0
chr4:154298510:G:C	0	0	0	0	0	0	0	0
chr4:154320583:C:T	0	0	0	0	0	0	0	0
chr4:154366383:T:C	0	0	0	0	0	0	0	0
chr4:154489579:G:C	0	0	0	0	0	0	0	0
chr4:154489670:G:A	0	0	0	0	0	0	0	0
chr4:154490497:G:A	0	0	0	0	0	0	0	0
chr4:154490787:A:C	0	0	0	0	0	0	0	0
chr4:154491312:C:T	0	0	0	0	0	0	0	0
chr4:154491429:C:G	0	0	0	0	0	0	0	0
chr4:154539961:T:C	214	110	336	112	224	2.0	0.5	2.0
chr4:154604818:G:A	0	0	0	0	0	0	0	0
chr4:154799122:T:C	0	0	0	0	0	0	0	0
chr4:155214524:C:T	0	0	0	0	0	0	0	0
chr4:155214875:C:T	0	0	0	0	0	0	0	0
chr4:155353225:T:C	20	13	33	7	26	2.0	0.0	2.0
chr4:155375908:A:G	69	50	119	19	100	2	0	2
chr4:155696842:G:A	0	0	0	0	0	0	0	0
chr4:156763096:T:C	0	0	0	0	0	0	0	0
chr4:158155674:C:T	0	0	0	0	0	0	0	0
chr4:158709665:T:C	145	64	210	81	129	1	1	0
chr4:158723342:G:C	241	115	366	130	236	1	1	0
chr4:158723349:C:T	241	118	369	127	242	1	1	0
chr4:163351551:G:A	0	0	0	0	0	0	0	0
chr4:163519429:T:C	151	76	233	79	154	2	1	2
chr4:163545672:C:T	193	97	299	99	200	2	1	2
chr4:167234027:A:G	0	0	0	0	0	0	0	0
chr4:168379787:C:T	5	3	8	2	6	2	0	2
chr4:168421893:A:G	1	0	1	1	0	1	1	0
chr4:168461840:C:A	32	22	56	10	46	2.0	0.0	2.0
chr4:168878297:A:G	18	2	21	17	4	1.0	1.0	0.0
chr4:169010117:G:A	109	58	171	53	118	2	0	2
chr4:169010123:G:A	109	58	171	53	118	2	0	2
chr4:169010137:T:C	103	55	159	50	109	2	0	2
chr4:169424742:C:T	6	1	7	5	2	1.0	1.0	0.0
chr4:169713239:C:T	13	7	20	6	14	2	0	2
chr4:169713257:A:G	13	5	18	8	10	1	1	0
chr4:169757842:T:C	133	63	197	72	125	1	1	0
chr4:174643836:C:T	0	0	0	0	0	0	0	0
chr4:174677129:A:G	0	0	0	0	0	0	0	0
chr4:174766987:A:G	3	1	4	2	2	1	1	0
chr4:176179493:G:A	0	0	0	0	0	0	0	0
chr4:176192805:A:G	0	0	0	0	0	0	0	0
chr4:177353411:A:G	0	0	0	0	0	0	0	0
chr4:177353681:A:C	0	0	0	0	0	0	0	0
chr4:177440260:A:C	5	2	7	3	4	1	1	0
chr4:183321806:C:G	0	0	0	0	0	0	0	0
chr4:183505234:C:T	56	24	85	37	48	1.5	1.0	0.0
chr4:183649562:T:G	136	61	203	81	122	1.0	1.0	0.0
chr4:183679448:A:G	7	3	10	4	6	1	1	0
chr4:183697783:G:C	3	1	4	2	2	1	1	0
chr4:184010665:G:A	0	0	0	0	0	0	0	0
chr4:184091245:T:C	0	0	0	0	0	0	0	0
chr4:184766709:A:G	16	9	25	7	18	2.0	0.0	2.0
chr4:185175891:C:T	31	17	48	14	34	2	0	2
chr4:185190485:T:C	290	136	434	162	272	1.0	1.0	0.0
chr4:185587569:G:T	2	2	4	0	4	2.0	0.0	2.0
chr4:185623281:C:T	0	0	0	0	0	0	0	0
chr4:186082920:C:T	0	0	0	0	0	0	0	0
chr4:186157712:C:T	0	0	0	0	0	0	0	0
chr4:186191887:C:G	80	49	132	34	98	2.0	0.0	2.0
chr4:186197508:G:T	0	0	0	0	0	0	0	0
chr4:186274397:T:A	0	0	0	0	0	0	0	0
chr4:186534245:C:T	0	0	0	0	0	0	0	0
chr4:186597720:G:A	0	0	0	0	0	0	0	0
chr4:186708343:G:A	0	0	0	0	0	0	0	0
chr4:186708616:A:C	0	0	0	0	0	0	0	0
chr4:186708742:G:A	0	0	0	0	0	0	0	0
chr4:186709436:G:A	0	0	0	0	0	0	0	0
chr4:186709835:C:A	0	0	0	0	0	0	0	0
chr4:188139456:G:C	0	0	0	0	0	0	0	0
chr4:188139952:G:A	0	0	0	0	0	0	0	0
chr4:188143798:C:G	0	0	0	0	0	0	0	0
chr4:189984870:G:A	0	0	0	0	0	0	0	0
chr5:639116:C:A	3	3	6	0	6	2	0	2
chr5:640590:A:G	3	0	3	3	0	1	1	0
chr5:748362:A:C	0	0	0	0	0	0	0	0
chr5:748367:G:C	0	0	0	0	0	0	0	0
chr5:766795:C:T	0	0	0	0	0	0	0	0
chr5:766824:G:A	0	0	0	0	0	0	0	0
chr5:766918:A:C	0	0	0	0	0	0	0	0
chr5:767395:G:A	0	0	0	0	0	0	0	0
chr5:767473:G:A	0	0	0	0	0	0	0	0
chr5:840391:C:T	1	1	2	0	2	2	0	2
chr5:840460:T:C	1	1	2	0	2	2	0	2
chr5:843581:G:T	0	0	0	0	0	0	0	0
chr5:843587:G:A	0	0	0	0	0	0	0	0
chr5:843608:C:A	0	0	0	0	0	0	0	0
chr5:1065284:C:T	0	0	0	0	0	0	0	0
chr5:1076130:G:A	0	0	0	0	0	0	0	0
chr5:1293274:C:G	0	0	0	0	0	0	0	0
chr5:1294051:C:T	0	0	0	0	0	0	0	0
chr5:1320607:C:T	0	0	0	0	0	0	0	0
chr5:1330401:G:A	11	6	17	5	12	2	0	2
chr5:5146264:T:C	0	0	0	0	0	0	0	0
chr5:5146282:A:G	0	0	0	0	0	0	0	0
chr5:5200168:C:T	0	0	0	0	0	0	0	0
chr5:6372472:A:G	797	408	1278	457	821	2	1	1
chr5:7802250:C:T	0	0	0	0	0	0	0	0
chr5:7859410:A:G	40	21	63	21	42	2.0	0.0	2.0
chr5:7869122:T:C	0	0	0	0	0	0	0	0
chr5:7875194:C:G	9	3	12	6	6	1	1	0
chr5:7878066:C:T	46	25	71	21	50	2.0	0.0	2.0
chr5:7878079:T:C	46	21	67	25	42	1.0	1.0	0.0
chr5:7885846:A:G	27	12	39	15	24	1	1	0
chr5:7892967:T:C	37	19	56	18	38	2	0	2
chr5:7897170:G:A	30	14	44	16	28	1.0	1.0	0.0
chr5:7897206:G:A	30	16	46	14	32	2.0	0.0	2.0
chr5:10227436:C:A	10	4	14	6	8	1.0	1.0	0.0
chr5:10250318:G:A	228	135	378	102	276	2.0	0.0	2.0
chr5:10250331:T:C	342	196	578	168	410	2.0	0.0	2.0
chr5:10256049:T:C	347	209	598	162	436	2	0	2
chr5:10258013:G:A	2	1	3	1	2	1.5	0.5	1.0
chr5:10260953:C:T	0	0	0	0	0	0	0	0
chr5:10264850:A:G	305	179	517	143	374	2	0	2
chr5:13718913:T:G	0	0	0	0	0	0	0	0
chr5:13718980:G:A	0	0	0	0	0	0	0	0
chr5:13737335:G:A	0	0	0	0	0	0	0	0
chr5:13754285:C:T	0	0	0	0	0	0	0	0
chr5:13762863:T:C	0	0	0	0	0	0	0	0
chr5:14711166:T:C	2	0	2	2	0	1.0	1.0	0.0
chr5:31302181:C:T	0	0	0	0	0	0	0	0
chr5:31317845:T:C	0	0	0	0	0	0	0	0
chr5:31401340:A:G	24	13	37	11	26	2.0	0.0	2.0
chr5:31409008:T:C	1	0	1	1	0	1	1	0
chr5:31409145:A:G	19	7	26	12	14	1	1	0
chr5:31422900:T:C	13	7	20	6	14	2	0	2
chr5:31526264:T:C	7	4	11	3	8	2	0	2
chr5:32523192:T:A	0	0	0	0	0	0	0	0
chr5:33549282:G:A	0	0	0	0	0	0	0	0
chr5:33751349:A:T	0	0	0	0	0	0	0	0
chr5:33988430:C:T	3	3	6	0	6	2	0	2
chr5:34811026:G:A	0	0	0	0	0	0	0	0
chr5:34811032:T:G	0	0	0	0	0	0	0	0
chr5:34840736:A:G	2	1	3	1	2	1.5	0.5	1.0
chr5:34998673:C:A	0	0	0	0	0	0	0	0
chr5:35047993:C:T	0	0	0	0	0	0	0	0
chr5:42719137:A:C	0	0	0	0	0	0	0	0
chr5:42800706:C:T	1	1	2	0	2	2	0	2
chr5:43039691:T:C	53	28	82	25	57	2	0	2
chr5:43245820:C:T	0	0	0	0	0	0	0	0
chr5:43505891:A:G	4	2	6	2	4	1.5	0.5	1.0
chr5:43609241:C:T	56	36	94	20	74	2.0	0.0	2.0
chr5:44809060:G:C	276	126	415	160	255	1.0	1.0	0.0
chr5:53055583:G:A	0	0	0	0	0	0	0	0
chr5:53109651:G:A	22	7	29	15	14	1.0	1.0	0.0
chr5:53658684:T:G	23	9	33	15	18	1	1	0
chr5:53683267:G:A	376	191	600	202	398	2.0	1.0	2.0
chr5:54519236:C:A	75	28	104	48	56	1	1	0
chr5:54519410:G:C	79	49	130	30	100	2	0	2
chr5:54519665:A:C	31	10	42	22	20	1	1	0
chr5:54519892:G:A	31	10	42	22	20	1	1	0
chr5:55270539:C:T	1	1	2	0	2	2	0	2
chr5:55767993:G:A	0	0	0	0	0	0	0	0
chr5:55851541:G:A	0	0	0	0	0	0	0	0
chr5:55941604:A:C	8	6	14	2	12	2.0	0.0	2.0
chr5:56111125:T:C	0	0	0	0	0	0	0	0
chr5:56111715:C:T	0	0	0	0	0	0	0	0
chr5:56535194:A:G	0	0	0	0	0	0	0	0
chr5:56910246:G:T	28	15	44	14	30	2.0	0.5	2.0
chr5:56911296:T:A	57	30	88	28	60	2	0	2
chr5:60699993:G:C	0	0	0	0	0	0	0	0
chr5:60945315:G:A	316	152	490	182	308	1.0	1.0	0.0
chr5:61687014:G:A	0	0	0	0	0	0	0	0
chr5:61703941:C:T	0	0	0	0	0	0	0	0
chr5:62347989:G:A	2	1	3	1	2	1.5	0.5	1.0
chr5:62398552:T:C	207	107	322	104	218	2	0	2
chr5:63961168:G:A	0	0	0	0	0	0	0	0
chr5:64213983:C:T	0	0	0	0	0	0	0	0
chr5:64609241:A:G	0	0	0	0	0	0	0	0
chr5:66163945:T:C	18	10	28	8	20	2.0	0.0	2.0
chr5:67145241:G:A	0	0	0	0	0	0	0	0
chr5:67166666:C:A	13	7	20	7	13	2	1	1
chr5:68226894:C:T	38	20	58	18	40	2.0	0.0	2.0
chr5:69113267:A:C	19	12	31	7	24	2	0	2
chr5:69320504:C:T	64	30	95	35	60	1.0	1.0	0.0
chr5:72115891:T:C	1	0	1	1	0	1	1	0
chr5:72195135:A:G	1	0	1	1	0	1	1	0
chr5:72198257:C:T	0	0	0	0	0	0	0	0
chr5:72198381:G:A	0	0	0	0	0	0	0	0
chr5:72443719:C:G	0	0	0	0	0	0	0	0
chr5:72460275:G:A	0	0	0	0	0	0	0	0
chr5:72888271:C:T	36	22	58	14	44	2.0	0.0	2.0
chr5:73502899:T:G	30	11	41	19	22	1.0	1.0	0.0
chr5:73502987:G:A	3861	2990	14577	4133	10444	3	1	2
chr5:73572622:T:C	22	7	29	15	14	1.0	1.0	0.0
chr5:73813663:G:A	0	0	0	0	0	0	0	0
chr5:73852656:G:A	0	0	0	0	0	0	0	0
chr5:73868006:C:T	0	0	0	0	0	0	0	0
chr5:73868140:C:A	0	0	0	0	0	0	0	0
chr5:73894487:C:T	0	0	0	0	0	0	0	0
chr5:73911547:T:A	0	0	0	0	0	0	0	0
chr5:74721765:G:C	32	13	48	20	28	1.0	1.0	0.0
chr5:74750639:C:T	31	15	47	17	30	1	1	0
chr5:74767329:C:G	1324	697	2377	865	1512	2.0	1.0	2.0
chr5:74781649:C:T	0	0	0	0	0	0	0	0
chr5:74814015:G:A	0	0	0	0	0	0	0	0
chr5:75029077:C:T	0	0	0	0	0	0	0	0
chr5:75104561:G:C	0	0	0	0	0	0	0	0
chr5:75146585:G:A	2	0	2	2	0	1.0	1.0	0.0
chr5:75147095:A:G	2	0	2	2	0	1.0	1.0	0.0
chr5:75147307:C:T	2	0	2	2	0	1.0	1.0	0.0
chr5:75355259:A:G	6	1	7	5	2	1.0	1.0	0.0
chr5:75581441:C:T	359	179	545	188	357	1	1	0
chr5:75611678:G:A	1	0	1	1	0	1	1	0
chr5:75625861:G:A	0	0	0	0	0	0	0	0
chr5:75656076:G:A	0	0	0	0	0	0	0	0
chr5:75666943:C:T	0	0	0	0	0	0	0	0
chr5:75669297:G:A	57	32	90	26	64	2	0	2
chr5:76131693:C:T	0	0	0	0	0	0	0	0
chr5:76132110:G:A	0	0	0	0	0	0	0	0
chr5:76173953:C:T	0	0	0	0	0	0	0	0
chr5:76673922:A:G	5	1	6	4	2	1	1	0
chr5:77312016:G:A	0	0	0	0	0	0	0	0
chr5:77426618:G:A	1	0	1	1	0	1	1	0
chr5:77438259:C:T	76	42	118	34	84	2.0	0.0	2.0
chr5:77784936:G:A	1	0	1	1	0	1	1	0
chr5:77784944:A:G	1	1	2	0	2	2	0	2
chr5:77784965:G:A	0	0	0	0	0	0	0	0
chr5:78002795:A:T	62	28	92	34	58	1.0	1.0	0.0
chr5:78039122:A:G	52	24	79	28	51	1.0	1.0	0.0
chr5:78177341:A:G	51	31	82	20	62	2	0	2
chr5:78488915:A:G	0	0	0	0	0	0	0	0
chr5:78885600:C:T	12	6	18	6	12	1.5	0.5	1.0
chr5:79729334:A:G	1	0	1	1	0	1	1	0
chr5:79729811:G:A	0	0	0	0	0	0	0	0
chr5:79730537:G:A	0	0	0	0	0	0	0	0
chr5:79730716:A:C	0	0	0	0	0	0	0	0
chr5:79731782:T:C	0	0	0	0	0	0	0	0
chr5:79731877:T:C	0	0	0	0	0	0	0	0
chr5:79733465:C:A	0	0	0	0	0	0	0	0
chr5:79733560:T:G	0	0	0	0	0	0	0	0
chr5:79733903:T:A	0	0	0	0	0	0	0	0
chr5:79733926:A:G	0	0	0	0	0	0	0	0
chr5:79734389:C:T	0	0	0	0	0	0	0	0
chr5:79734515:A:G	0	0	0	0	0	0	0	0
chr5:79734523:A:G	0	0	0	0	0	0	0	0
chr5:79735549:G:C	0	0	0	0	0	0	0	0
chr5:79737483:A:C	0	0	0	0	0	0	0	0
chr5:79738839:C:G	0	0	0	0	0	0	0	0
chr5:79752739:C:T	0	0	0	0	0	0	0	0
chr5:80055912:C:T	0	0	0	0	0	0	0	0
chr5:80056029:A:T	0	0	0	0	0	0	0	0
chr5:81266301:G:A	0	0	0	0	0	0	0	0
chr5:81440625:A:G	41	17	60	26	34	1	1	0
chr5:82276365:G:C	38	19	57	19	38	1.5	0.5	1.0
chr5:82278363:C:T	337	144	548	234	314	1	1	0
chr5:83537326:G:A	0	0	0	0	0	0	0	0
chr5:83538480:G:A	0	0	0	0	0	0	0	0
chr5:83538811:T:C	0	0	0	0	0	0	0	0
chr5:83539726:A:G	0	0	0	0	0	0	0	0
chr5:83539905:T:A	0	0	0	0	0	0	0	0
chr5:83541812:G:T	0	0	0	0	0	0	0	0
chr5:83644454:C:G	0	0	0	0	0	0	0	0
chr5:90473830:G:A	0	0	0	0	0	0	0	0
chr5:90658032:C:T	0	0	0	0	0	0	0	0
chr5:90683701:C:T	0	0	0	0	0	0	0	0
chr5:90683881:C:T	0	0	0	0	0	0	0	0
chr5:90692687:A:G	0	0	0	0	0	0	0	0
chr5:90693962:G:A	0	0	0	0	0	0	0	0
chr5:90778942:G:A	0	0	0	0	0	0	0	0
chr5:90811291:A:G	0	0	0	0	0	0	0	0
chr5:90855772:G:A	0	0	0	0	0	0	0	0
chr5:95414019:G:A	0	0	0	0	0	0	0	0
chr5:95652390:C:T	0	0	0	0	0	0	0	0
chr5:95658763:T:C	0	0	0	0	0	0	0	0
chr5:95816609:A:G	1	0	1	1	0	1	1	0
chr5:95898646:A:G	6	2	8	4	4	1.0	1.0	0.0
chr5:95898673:C:T	6	2	8	4	4	1.0	1.0	0.0
chr5:95898688:A:C	6	2	8	4	4	1.0	1.0	0.0
chr5:95942975:G:A	7	2	9	5	4	1	1	0
chr5:96695865:A:G	1076	572	1963	695	1268	2.0	1.0	2.0
chr5:96742633:C:G	5	2	7	3	4	1	1	0
chr5:96793809:A:G	13	5	18	8	10	1	1	0
chr5:96803547:C:G	49	27	75	22	53	2	0	2
chr5:96803892:G:A	50	28	78	22	56	2.0	0.0	2.0
chr5:96895296:G:T	41	7	48	34	14	1	1	0
chr5:96900192:A:G	8	7	15	1	14	2.0	0.0	2.0
chr5:96901622:G:A	43	6	49	37	12	1	1	0
chr5:96909639:C:T	50	9	59	41	18	1.0	1.0	0.0
chr5:96909735:C:T	54	11	65	43	22	1.0	1.0	0.0
chr5:96909814:A:G	14	8	22	6	16	2.0	0.0	2.0
chr5:96913411:C:T	52	7	59	45	14	1.0	1.0	0.0
chr5:97015006:G:A	15	8	23	7	16	2	0	2
chr5:97177767:G:C	115	66	183	51	132	2	0	2
chr5:98576823:G:C	0	0	0	0	0	0	0	0
chr5:102391147:A:G	0	0	0	0	0	0	0	0
chr5:102458463:A:G	0	0	0	0	0	0	0	0
chr5:102498892:T:A	0	0	0	0	0	0	0	0
chr5:103555994:A:G	10	8	18	2	16	2.0	0.0	2.0
chr5:103558972:T:C	12	2	14	10	4	1.0	1.0	0.0
chr5:108798164:A:T	48	27	75	21	54	2.0	0.0	2.0
chr5:109052346:T:G	3	1	4	2	2	1	1	0
chr5:109186192:T:C	0	0	0	0	0	0	0	0
chr5:109187592:A:T	5	4	9	1	8	2	0	2
chr5:109781470:A:G	25	12	37	13	24	1	1	0
chr5:109845981:A:T	26	8	35	19	16	1.0	1.0	0.0
chr5:111073450:C:G	0	0	0	0	0	0	0	0
chr5:111482723:C:T	0	0	0	0	0	0	0	0
chr5:111735409:T:A	0	0	0	0	0	0	0	0
chr5:112827157:T:C	8	5	13	3	10	2.0	0.0	2.0
chr5:112828864:G:A	24	13	39	11	28	2.0	0.0	2.0
chr5:112837553:G:A	2	1	3	1	2	1.5	0.5	1.0
chr5:112840073:G:A	8	3	11	5	6	1.0	1.0	0.0
chr5:112840628:G:A	13	8	21	5	16	2	0	2
chr5:112840862:T:G	14	8	22	6	16	2.0	0.0	2.0
chr5:112841474:G:A	12	8	20	4	16	2.0	0.0	2.0
chr5:112861252:A:C	1	1	2	0	2	2	0	2
chr5:112892242:T:C	18	6	24	12	12	1.0	1.0	0.0
chr5:112922211:T:C	1003	570	1782	565	1217	2	1	2
chr5:113434352:C:T	0	0	0	0	0	0	0	0
chr5:114362847:G:C	0	0	0	0	0	0	0	0
chr5:115524464:G:A	6	2	8	4	4	1.0	1.0	0.0
chr5:116058929:G:A	0	0	0	0	0	0	0	0
chr5:119333529:G:A	76	35	114	42	72	1.0	1.0	0.0
chr5:119452501:C:G	173	106	291	71	220	2	0	2
chr5:122020266:G:A	163	86	257	83	174	2	1	2
chr5:122077195:C:G	0	0	0	0	0	0	0	0
chr5:122077513:C:T	1	1	2	0	2	2	0	2
chr5:122152811:C:G	0	0	0	0	0	0	0	0
chr5:122160164:T:G	0	0	0	0	0	0	0	0
chr5:122182683:T:C	0	0	0	0	0	0	0	0
chr5:123346654:A:G	9	4	13	5	8	1	1	0
chr5:123391332:G:A	17	8	25	9	16	1	1	0
chr5:124648222:G:T	11	11	22	0	22	2	0	2
chr5:126544897:T:C	11	8	19	3	16	2	0	2
chr5:127438533:C:T	0	0	0	0	0	0	0	0
chr5:127457282:T:A	0	0	0	0	0	0	0	0
chr5:127524531:C:T	38	20	39	18	21	1.0	0.0	1.0
chr5:128261826:G:A	0	0	0	0	0	0	0	0
chr5:128349443:C:T	0	0	0	0	0	0	0	0
chr5:128537421:G:C	0	0	0	0	0	0	0	0
chr5:128537493:C:T	0	0	0	0	0	0	0	0
chr5:129737250:G:T	0	0	0	0	0	0	0	0
chr5:131472505:T:C	18	7	25	11	14	1.0	1.0	0.0
chr5:131945413:G:C	0	0	0	0	0	0	0	0
chr5:131985249:A:T	0	0	0	0	0	0	0	0
chr5:132060785:C:T	0	0	0	0	0	0	0	0
chr5:132075767:T:C	0	0	0	0	0	0	0	0
chr5:132217734:G:A	0	0	0	0	0	0	0	0
chr5:132266473:T:C	0	0	0	0	0	0	0	0
chr5:132271243:G:A	0	0	0	0	0	0	0	0
chr5:132271387:A:G	0	0	0	0	0	0	0	0
chr5:132271895:G:T	0	0	0	0	0	0	0	0
chr5:132272249:G:C	0	0	0	0	0	0	0	0
chr5:132378082:C:T	0	0	0	0	0	0	0	0
chr5:132486973:G:C	528	280	979	327	652	2.0	1.0	2.0
chr5:132660272:A:G	0	0	0	0	0	0	0	0
chr5:133199354:G:A	0	0	0	0	0	0	0	0
chr5:133224258:T:G	1	1	2	0	2	2	0	2
chr5:134552090:G:A	40	21	63	19	44	2.0	0.0	2.0
chr5:134887903:A:G	166	80	257	91	166	1.0	1.0	0.0
chr5:135029306:G:T	0	0	0	0	0	0	0	0
chr5:135880847:C:T	0	0	0	0	0	0	0	0
chr5:135892476:G:A	0	0	0	0	0	0	0	0
chr5:135951340:T:C	1	1	2	0	2	2	0	2
chr5:136046835:C:T	8	5	13	3	10	2.0	0.0	2.0
chr5:136055734:G:A	76	46	125	33	92	2.0	0.0	2.0
chr5:137908828:G:A	1	1	2	0	2	2	0	2
chr5:137946019:A:C	8	2	10	6	4	1.0	1.0	0.0
chr5:138084036:A:G	0	0	0	0	0	0	0	0
chr5:138084039:T:C	0	0	0	0	0	0	0	0
chr5:138091079:C:T	0	0	0	0	0	0	0	0
chr5:138181665:T:G	0	0	0	0	0	0	0	0
chr5:138192228:C:G	3	0	3	3	0	1	1	0
chr5:138372745:C:T	38	17	55	21	34	1.0	1.0	0.0
chr5:138419006:T:C	10	7	17	3	14	2.0	0.0	2.0
chr5:138556481:G:A	252	129	401	135	266	2.0	1.0	2.0
chr5:139392844:C:T	1	0	1	1	0	1	1	0
chr5:139394718:C:T	1	1	2	0	2	2	0	2
chr5:139396890:C:T	12	4	16	8	8	1.0	1.0	0.0
chr5:139437401:A:G	84	44	130	40	90	2.0	0.0	2.0
chr5:139439484:T:C	147	67	221	83	138	1	1	0
chr5:139478334:T:C	6	5	11	1	10	2.0	0.0	2.0
chr5:139481561:C:G	5	5	10	0	10	2	0	2
chr5:139837735:G:C	0	0	0	0	0	0	0	0
chr5:140194465:G:A	321	227	581	103	478	2	0	2
chr5:140557175:G:T	768	419	1293	406	887	2.0	1.0	2.0
chr5:140557395:A:G	358	169	556	207	349	1.0	1.0	0.0
chr5:140557561:G:A	4	1	5	3	2	1.0	1.0	0.0
chr5:140560648:G:A	32	16	48	16	32	1.5	0.5	1.0
chr5:140561643:A:G	23	13	36	10	26	2	0	2
chr5:140561733:A:G	19	12	31	7	24	2	0	2
chr5:140644847:C:T	5	1	6	4	2	1	1	0
chr5:140644906:A:G	5	1	6	4	2	1	1	0
chr5:140647631:T:C	578	273	925	359	566	2.0	1.0	0.0
chr5:140668624:T:C	69	41	110	28	82	2	0	2
chr5:140787878:C:T	0	0	0	0	0	0	0	0
chr5:140788485:A:G	0	0	0	0	0	0	0	0
chr5:140788566:G:T	0	0	0	0	0	0	0	0
chr5:140795037:G:A	0	0	0	0	0	0	0	0
chr5:140795280:G:C	0	0	0	0	0	0	0	0
chr5:140801152:C:T	0	0	0	0	0	0	0	0
chr5:140802063:T:C	0	0	0	0	0	0	0	0
chr5:140802149:A:G	0	0	0	0	0	0	0	0
chr5:140802307:T:C	0	0	0	0	0	0	0	0
chr5:140802516:G:T	0	0	0	0	0	0	0	0
chr5:140803473:G:A	0	0	0	0	0	0	0	0
chr5:140807517:A:G	0	0	0	0	0	0	0	0
chr5:140807737:C:T	0	0	0	0	0	0	0	0
chr5:140808798:T:G	0	0	0	0	0	0	0	0
chr5:140808816:A:G	0	0	0	0	0	0	0	0
chr5:140808990:G:C	0	0	0	0	0	0	0	0
chr5:140821835:T:C	0	0	0	0	0	0	0	0
chr5:140823847:C:T	0	0	0	0	0	0	0	0
chr5:140829882:T:G	0	0	0	0	0	0	0	0
chr5:140834796:G:A	0	0	0	0	0	0	0	0
chr5:140841554:G:A	0	0	0	0	0	0	0	0
chr5:140842572:A:C	0	0	0	0	0	0	0	0
chr5:140843056:A:G	0	0	0	0	0	0	0	0
chr5:140848579:C:A	0	0	0	0	0	0	0	0
chr5:140849501:C:G	0	0	0	0	0	0	0	0
chr5:140849783:G:C	0	0	0	0	0	0	0	0
chr5:140849941:T:G	0	0	0	0	0	0	0	0
chr5:140850785:AA:CC	0	0	0	0	0	0	0	0
chr5:140857365:C:G	0	0	0	0	0	0	0	0
chr5:140857524:T:G	0	0	0	0	0	0	0	0
chr5:140857802:T:G	0	0	0	0	0	0	0	0
chr5:140857963:A:G	0	0	0	0	0	0	0	0
chr5:140870667:T:C	0	0	0	0	0	0	0	0
chr5:140876207:C:A	0	0	0	0	0	0	0	0
chr5:140883705:T:G	0	0	0	0	0	0	0	0
chr5:140927699:G:A	0	0	0	0	0	0	0	0
chr5:140928161:C:G	0	0	0	0	0	0	0	0
chr5:140928384:C:G	0	0	0	0	0	0	0	0
chr5:140929431:C:T	0	0	0	0	0	0	0	0
chr5:140966883:T:A	0	0	0	0	0	0	0	0
chr5:140967127:T:C	0	0	0	0	0	0	0	0
chr5:140967468:C:T	0	0	0	0	0	0	0	0
chr5:141096396:G:A	0	0	0	0	0	0	0	0
chr5:141102899:G:A	0	0	0	0	0	0	0	0
chr5:141122595:G:A	0	0	0	0	0	0	0	0
chr5:141150197:C:G	0	0	0	0	0	0	0	0
chr5:141150948:G:A	0	0	0	0	0	0	0	0
chr5:141152011:C:T	0	0	0	0	0	0	0	0
chr5:141174608:G:C	0	0	0	0	0	0	0	0
chr5:141174900:G:T	0	0	0	0	0	0	0	0
chr5:141174981:A:T	0	0	0	0	0	0	0	0
chr5:141175025:T:C	0	0	0	0	0	0	0	0
chr5:141175227:T:A	0	0	0	0	0	0	0	0
chr5:141179739:G:A	0	0	0	0	0	0	0	0
chr5:141179951:G:C	0	0	0	0	0	0	0	0
chr5:141180015:G:T	0	0	0	0	0	0	0	0
chr5:141183164:G:A	0	0	0	0	0	0	0	0
chr5:141184473:G:C	0	0	0	0	0	0	0	0
chr5:141184513:C:T	0	0	0	0	0	0	0	0
chr5:141184688:C:T	0	0	0	0	0	0	0	0
chr5:141187690:G:T	0	0	0	0	0	0	0	0
chr5:141187871:A:G	0	0	0	0	0	0	0	0
chr5:141188452:T:C	0	0	0	0	0	0	0	0
chr5:141193095:C:T	0	0	0	0	0	0	0	0
chr5:141193190:C:G	0	0	0	0	0	0	0	0
chr5:141201358:C:G	0	0	0	0	0	0	0	0
chr5:141201647:C:A	0	0	0	0	0	0	0	0
chr5:141201937:G:T	0	0	0	0	0	0	0	0
chr5:141208801:C:T	0	0	0	0	0	0	0	0
chr5:141210166:C:T	0	0	0	0	0	0	0	0
chr5:141215534:C:G	0	0	0	0	0	0	0	0
chr5:141215611:G:T	0	0	0	0	0	0	0	0
chr5:141216053:G:A	0	0	0	0	0	0	0	0
chr5:141225149:C:A	0	0	0	0	0	0	0	0
chr5:141225506:C:T	0	0	0	0	0	0	0	0
chr5:141236161:A:G	0	0	0	0	0	0	0	0
chr5:141246998:A:C	1	1	2	0	2	2	0	2
chr5:141247003:C:A	1	1	2	0	2	2	0	2
chr5:141247199:C:T	1	0	1	1	0	1	1	0
chr5:141247222:A:C	1	0	1	1	0	1	1	0
chr5:141341387:T:C	0	0	0	0	0	0	0	0
chr5:141344268:C:T	0	0	0	0	0	0	0	0
chr5:141360307:G:A	1	1	2	0	2	2	0	2
chr5:141415561:T:C	1	0	1	1	0	1	1	0
chr5:141626120:A:G	1	0	1	1	0	1	1	0
chr5:141634927:T:C	368	194	578	186	392	2.0	0.5	2.0
chr5:141639543:C:A	97	50	149	49	100	2	1	2
chr5:141640002:G:C	92	48	142	47	95	2.0	1.0	2.0
chr5:141640263:C:G	99	51	152	50	102	2	1	2
chr5:141646200:G:A	8	5	13	3	10	2.0	0.0	2.0
chr5:141647895:G:A	5	3	8	2	6	2	0	2
chr5:141655681:A:G	0	0	0	0	0	0	0	0
chr5:141661868:G:A	0	0	0	0	0	0	0	0
chr5:141672849:G:T	0	0	0	0	0	0	0	0
chr5:141673303:G:C	0	0	0	0	0	0	0	0
chr5:141680082:A:G	0	0	0	0	0	0	0	0
chr5:141680301:T:C	0	0	0	0	0	0	0	0
chr5:141864791:C:T	0	0	0	0	0	0	0	0
chr5:141957002:T:C	0	0	0	0	0	0	0	0
chr5:141957660:A:G	0	0	0	0	0	0	0	0
chr5:143820488:C:T	0	0	0	0	0	0	0	0
chr5:144165488:G:A	187	99	289	91	198	2	0	2
chr5:145866522:T:G	0	0	0	0	0	0	0	0
chr5:146062570:G:A	0	0	0	0	0	0	0	0
chr5:146130165:A:C	3	2	5	1	4	2	0	2
chr5:147632734:T:A	0	0	0	0	0	0	0	0
chr5:147906491:G:A	0	0	0	0	0	0	0	0
chr5:148088671:C:G	0	0	0	0	0	0	0	0
chr5:148089408:G:C	0	0	0	0	0	0	0	0
chr5:148089586:G:A	0	0	0	0	0	0	0	0
chr5:148100549:T:C	0	0	0	0	0	0	0	0
chr5:148101867:A:G	0	0	0	0	0	0	0	0
chr5:148107114:C:A	0	0	0	0	0	0	0	0
chr5:148118456:G:A	0	0	0	0	0	0	0	0
chr5:148125553:G:A	0	0	0	0	0	0	0	0
chr5:148131303:T:C	0	0	0	0	0	0	0	0
chr5:148826812:C:T	47	23	71	25	46	2	1	0
chr5:148826877:G:A	47	23	71	25	46	2	1	0
chr5:148826910:G:C	47	23	71	25	46	2	1	0
chr5:149259499:C:T	0	0	0	0	0	0	0	0
chr5:149621988:A:C	0	0	0	0	0	0	0	0
chr5:149624064:C:T	0	0	0	0	0	0	0	0
chr5:149627077:C:T	0	0	0	0	0	0	0	0
chr5:149627163:A:C	0	0	0	0	0	0	0	0
chr5:149833051:G:T	10	4	14	6	8	1.0	1.0	0.0
chr5:149896561:T:C	0	0	0	0	0	0	0	0
chr5:149944209:G:A	0	0	0	0	0	0	0	0
chr5:149944343:T:G	0	0	0	0	0	0	0	0
chr5:149995369:T:C	4	2	6	2	4	1.5	0.5	1.0
chr5:150026708:C:T	13	10	23	3	20	2	0	2
chr5:150054033:TG:GA	0	0	0	0	0	0	0	0
chr5:150077208:CT:AA	0	0	0	0	0	0	0	0
chr5:150078115:G:A	0	0	0	0	0	0	0	0
chr5:150080990:A:G	0	0	0	0	0	0	0	0
chr5:150129883:C:T	0	0	0	0	0	0	0	0
chr5:150133926:G:A	0	0	0	0	0	0	0	0
chr5:150222717:T:C	0	0	0	0	0	0	0	0
chr5:150392717:C:G	73	48	123	27	96	2	0	2
chr5:150396669:C:T	52	27	80	26	54	2.0	0.0	2.0
chr5:150540177:G:C	3	0	3	3	0	1	1	0
chr5:150540216:G:A	3	3	6	0	6	2	0	2
chr5:150670428:G:T	0	0	0	0	0	0	0	0
chr5:150718321:G:C	7	4	11	3	8	2	0	2
chr5:150759072:A:G	2	1	3	1	2	1.5	0.5	1.0
chr5:150848404:C:A	0	0	0	0	0	0	0	0
chr5:150896225:C:T	0	0	0	0	0	0	0	0
chr5:151045906:G:A	215	94	316	127	189	1	1	0
chr5:151056942:G:C	214	90	311	131	180	1.0	1.0	0.0
chr5:151199013:A:G	200	93	303	114	189	1.0	1.0	0.0
chr5:151287372:C:A	0	0	0	0	0	0	0	0
chr5:151316886:C:T	0	0	0	0	0	0	0	0
chr5:151316979:C:T	0	0	0	0	0	0	0	0
chr5:151325197:A:G	0	0	0	0	0	0	0	0
chr5:151344245:G:A	0	0	0	0	0	0	0	0
chr5:151507321:G:A	0	0	0	0	0	0	0	0
chr5:151512102:T:C	0	0	0	0	0	0	0	0
chr5:151512172:A:G	0	0	0	0	0	0	0	0
chr5:151521550:A:G	0	0	0	0	0	0	0	0
chr5:151521700:C:T	0	0	0	0	0	0	0	0
chr5:151521739:G:A	0	0	0	0	0	0	0	0
chr5:151525837:C:T	0	0	0	0	0	0	0	0
chr5:151529252:G:A	1	1	2	0	2	2	0	2
chr5:151567219:C:A	0	0	0	0	0	0	0	0
chr5:151567601:A:G	0	0	0	0	0	0	0	0
chr5:151673098:G:A	0	0	0	0	0	0	0	0
chr5:152392494:G:T	0	0	0	0	0	0	0	0
chr5:152395503:C:G	0	0	0	0	0	0	0	0
chr5:152404622:G:A	0	0	0	0	0	0	0	0
chr5:153650400:T:C	0	0	0	0	0	0	0	0
chr5:153992965:G:A	23	16	39	7	32	2	0	2
chr5:154049899:T:C	4	3	7	1	6	2.0	0.0	2.0
chr5:154053173:T:C	3	1	4	2	2	1	1	0
chr5:154053410:C:T	2	1	3	1	2	1.5	0.5	1.0
chr5:154329403:G:A	5	0	6	6	0	1	1	0
chr5:154329483:G:A	5	0	6	6	0	1	1	0
chr5:154404027:A:G	2	1	3	1	2	1.5	0.5	1.0
chr5:154823522:A:G	12	5	17	7	10	1.0	1.0	0.0
chr5:154823561:C:T	14	5	20	10	10	1.0	1.0	0.0
chr5:156344569:T:C	0	0	0	0	0	0	0	0
chr5:157104725:C:A	3	3	6	0	6	2	0	2
chr5:157162574:A:G	0	0	0	0	0	0	0	0
chr5:157163344:A:G	0	0	0	0	0	0	0	0
chr5:157243906:C:T	0	0	0	0	0	0	0	0
chr5:157326249:C:T	59	29	92	30	62	1	1	0
chr5:157343125:C:T	2	1	3	1	2	1.5	0.5	1.0
chr5:157343201:G:A	2	1	3	1	2	1.5	0.5	1.0
chr5:157343336:G:C	3	2	5	1	4	2	0	2
chr5:157491842:C:T	15	10	25	5	20	2	0	2
chr5:157509356:T:C	46	31	77	15	62	2.0	0.0	2.0
chr5:157638298:G:A	0	0	0	0	0	0	0	0
chr5:157731431:C:A	158	62	230	102	128	1.0	1.0	0.0
chr5:157731545:C:T	195	119	335	81	254	2	0	2
chr5:159161611:T:C	6	2	8	4	4	1.0	1.0	0.0
chr5:160232266:C:T	0	0	0	0	0	0	0	0
chr5:161294312:G:A	0	0	0	0	0	0	0	0
chr5:163460644:G:A	18	11	30	8	22	2.0	0.0	2.0
chr5:163464888:G:A	0	0	0	0	0	0	0	0
chr5:163517703:A:G	3	1	4	2	2	1	1	0
chr5:166382433:C:T	0	0	0	0	0	0	0	0
chr5:167755050:G:A	0	0	0	0	0	0	0	0
chr5:168218883:T:C	0	0	0	0	0	0	0	0
chr5:168414579:G:A	0	0	0	0	0	0	0	0
chr5:168423743:A:G	0	0	0	0	0	0	0	0
chr5:168464825:T:C	1	0	1	1	0	1	1	0
chr5:168671230:A:G	0	0	0	0	0	0	0	0
chr5:168696308:A:G	0	0	0	0	0	0	0	0
chr5:168749512:A:G	0	0	0	0	0	0	0	0
chr5:168752917:T:C	0	0	0	0	0	0	0	0
chr5:168753076:C:T	0	0	0	0	0	0	0	0
chr5:168806469:G:A	0	0	0	0	0	0	0	0
chr5:170008709:A:C	9	5	14	4	10	2	0	2
chr5:170080063:A:G	0	0	0	0	0	0	0	0
chr5:170082925:G:A	82	40	128	44	84	2.0	1.0	0.0
chr5:170108518:T:C	0	0	0	0	0	0	0	0
chr5:170258159:C:T	4	1	5	3	2	1.0	1.0	0.0
chr5:170270703:G:A	0	0	0	0	0	0	0	0
chr5:170812108:C:A	0	0	0	0	0	0	0	0
chr5:171791134:G:A	0	0	0	0	0	0	0	0
chr5:172053051:G:A	2	1	3	1	2	1.5	0.5	1.0
chr5:172054602:A:G	20	13	33	7	26	2.0	0.0	2.0
chr5:172106625:A:G	43	23	65	20	45	2	0	2
chr5:172106652:C:T	44	23	67	21	46	2.0	0.0	2.0
chr5:172422467:G:A	0	0	0	0	0	0	0	0
chr5:172762301:G:C	5	1	6	4	2	1	1	0
chr5:173144415:T:G	4	2	6	2	4	1.5	0.5	1.0
chr5:173956191:C:A	47	17	65	31	34	1	1	0
chr5:175443147:C:T	0	0	0	0	0	0	0	0
chr5:175443193:C:T	0	0	0	0	0	0	0	0
chr5:175509035:A:G	113	43	159	71	88	1	1	0
chr5:176290213:C:T	37	21	58	16	42	2	0	2
chr5:176366529:C:T	41	25	66	16	50	2	0	2
chr5:176529176:G:A	3	2	5	1	4	2	0	2
chr5:176529515:G:A	0	0	0	0	0	0	0	0
chr5:176532333:C:T	24	9	33	15	18	1.0	1.0	0.0
chr5:176578476:C:T	0	0	0	0	0	0	0	0
chr5:176584888:G:A	0	0	0	0	0	0	0	0
chr5:176590638:C:A	0	0	0	0	0	0	0	0
chr5:176620760:G:A	0	0	0	0	0	0	0	0
chr5:176626621:G:A	0	0	0	0	0	0	0	0
chr5:176887059:C:G	0	0	0	0	0	0	0	0
chr5:176887205:T:C	0	0	0	0	0	0	0	0
chr5:176887458:G:A	0	0	0	0	0	0	0	0
chr5:176887638:G:A	0	0	0	0	0	0	0	0
chr5:176906125:C:T	2	1	3	1	2	1.5	0.5	1.0
chr5:176907194:C:T	0	0	0	0	0	0	0	0
chr5:176943401:A:G	129	64	195	67	128	2	1	0
chr5:176975400:G:A	278	121	415	163	252	1.0	1.0	0.0
chr5:177079492:C:T	3	1	4	2	2	1	1	0
chr5:177089630:G:A	0	0	0	0	0	0	0	0
chr5:177093242:G:A	2	2	4	0	4	2.0	0.0	2.0
chr5:177209881:C:T	34	20	54	14	40	2.0	0.0	2.0
chr5:177210148:G:A	33	19	52	14	38	2	0	2
chr5:177210239:G:T	33	19	52	14	38	2	0	2
chr5:177210575:T:C	10	7	17	3	14	2.0	0.0	2.0
chr5:177294197:T:C	6	4	10	2	8	2.0	0.0	2.0
chr5:177306115:A:G	1399	839	2706	808	1898	2	1	2
chr5:177306615:T:C	1412	850	2742	818	1924	2.0	1.0	2.0
chr5:177310719:A:G	1	0	1	1	0	1	1	0
chr5:177332263:G:A	9	2	11	7	4	1	1	0
chr5:177466941:C:T	6	3	10	4	6	2.0	0.5	1.0
chr5:177489515:C:T	24	8	32	16	16	1.0	1.0	0.0
chr5:177502973:G:A	4	2	6	2	4	1.5	0.5	1.0
chr5:177513273:C:T	1	1	2	0	2	2	0	2
chr5:177513383:G:A	97	44	144	56	88	1	1	0
chr5:177604347:T:C	105	49	157	59	98	1	1	0
chr5:177608963:T:C	92	53	145	39	106	2.0	0.0	2.0
chr5:177631765:G:A	63	29	92	34	58	1	1	0
chr5:177995907:A:G	0	0	0	0	0	0	0	0
chr5:178055693:T:C	5	1	6	4	2	1	1	0
chr5:178186295:C:T	0	0	0	0	0	0	0	0
chr5:178187000:T:C	0	0	0	0	0	0	0	0
chr5:178187089:GCTCC:CCTCG	0	0	0	0	0	0	0	0
chr5:178187136:C:T	0	0	0	0	0	0	0	0
chr5:178187182:T:C	0	0	0	0	0	0	0	0
chr5:178256376:T:C	0	0	0	0	0	0	0	0
chr5:178964859:G:A	0	0	0	0	0	0	0	0
chr5:178964901:A:C	0	0	0	0	0	0	0	0
chr5:178986815:T:C	0	0	0	0	0	0	0	0
chr5:178986946:T:C	0	0	0	0	0	0	0	0
chr5:178988936:A:G	0	0	0	0	0	0	0	0
chr5:178989062:G:A	0	0	0	0	0	0	0	0
chr5:179113974:G:A	0	0	0	0	0	0	0	0
chr5:179122790:G:A	0	0	0	0	0	0	0	0
chr5:179128044:G:A	0	0	0	0	0	0	0	0
chr5:179135966:G:A	0	0	0	0	0	0	0	0
chr5:179154858:G:A	4	2	6	2	4	1.5	0.5	1.0
chr5:179181111:G:A	0	0	0	0	0	0	0	0
chr5:179207671:C:T	0	0	0	0	0	0	0	0
chr5:179559977:C:G	10	4	14	6	8	1.0	1.0	0.0
chr5:179559986:C:T	10	6	16	4	12	2.0	0.0	2.0
chr5:179593621:T:C	46	21	69	26	43	1.0	1.0	0.0
chr5:179598788:G:A	41	18	61	23	38	1	1	0
chr5:179609456:G:C	50	27	78	24	54	2.0	0.0	2.0
chr5:179621204:T:C	71	28	101	43	58	1	1	0
chr5:179623187:A:C	10	6	16	4	12	2.0	0.0	2.0
chr5:179642911:C:T	0	0	0	0	0	0	0	0
chr5:179644946:A:G	0	0	0	0	0	0	0	0
chr5:179774887:T:G	2	1	3	1	2	1.5	0.5	1.0
chr5:179800286:G:T	3	1	4	2	2	1	1	0
chr5:179833153:C:T	712	367	1200	423	777	2.0	1.0	2.0
chr5:179833213:G:A	718	368	1204	424	780	2.0	1.0	2.0
chr5:179837731:T:C	400	231	654	177	477	2.0	0.0	2.0
chr5:179837915:G:T	206	114	329	95	234	2.0	0.0	2.0
chr5:179840949:T:C	476	286	800	208	592	2.0	0.0	2.0
chr5:179853379:T:C	500	297	843	223	620	2.0	0.0	2.0
chr5:179858752:G:A	530	315	890	238	652	2.0	0.0	2.0
chr5:179863845:T:G	27	16	43	11	32	2	0	2
chr5:180102124:G:A	0	0	0	0	0	0	0	0
chr5:180136435:T:C	0	0	0	0	0	0	0	0
chr5:180136532:G:C	0	0	0	0	0	0	0	0
chr5:180236614:C:T	3	0	3	3	0	1	1	0
chr5:180302519:A:G	0	0	0	0	0	0	0	0
chr5:180324390:A:G	0	0	0	0	0	0	0	0
chr5:180616388:G:A	0	0	0	0	0	0	0	0
chr5:180624003:T:C	0	0	0	0	0	0	0	0
chr5:180791829:C:T	84	40	128	44	84	1.0	1.0	0.0
chr5:180792304:C:T	80	42	124	40	84	2.0	0.0	2.0
chr5:181155604:A:G	0	0	0	0	0	0	0	0
chr6:30064745:A:C	484	267	791	236	555	2.0	0.0	2.0
chr6:30071572:C:T	1	0	1	1	0	1	1	0
chr6:30108978:G:A	0	0	0	0	0	0	0	0
chr6:30137006:A:G	0	0	0	0	0	0	0	0
chr6:30153683:C:T	0	0	0	0	0	0	0	0
chr6:30171922:G:A	0	0	0	0	0	0	0	0
chr6:30198489:C:T	31	15	46	16	30	1	1	0
chr6:30199109:C:T	28	14	42	14	28	1.5	0.5	1.0
chr6:30547266:T:C	185	100	298	92	206	2	0	2
chr6:30603694:T:C	0	0	0	0	0	0	0	0
chr6:30685004:C:T	18	12	30	6	24	2.0	0.0	2.0
chr6:30730764:A:G	38	33	74	6	68	2.0	0.0	2.0
chr6:30741580:G:A	348	244	621	107	514	2.0	0.0	2.0
chr6:30894646:C:T	6	3	9	3	6	1.5	0.5	1.0
chr6:30897052:T:C	4	1	5	3	2	1.0	1.0	0.0
chr6:30912210:C:T	0	0	0	0	0	0	0	0
chr6:30914500:C:T	3	2	5	1	4	2	0	2
chr6:30915004:G:T	21	13	34	8	26	2	0	2
chr6:30920211:C:T	18	10	28	8	20	2.0	0.0	2.0
chr6:30925651:G:A	32	19	51	13	38	2.0	0.0	2.0
chr6:30926164:G:A	35	13	48	22	26	1	1	0
chr6:30931747:T:C	0	0	0	0	0	0	0	0
chr6:30931873:G:A	0	0	0	0	0	0	0	0
chr6:30951614:G:A	0	0	0	0	0	0	0	0
chr6:30951924:T:C	0	0	0	0	0	0	0	0
chr6:30952347:G:A	0	0	0	0	0	0	0	0
chr6:31025536:C:T	0	0	0	0	0	0	0	0
chr6:31025722:C:T	0	0	0	0	0	0	0	0
chr6:31025756:A:G	0	0	0	0	0	0	0	0
chr6:31112117:A:G	0	0	0	0	0	0	0	0
chr6:31112239:C:G	0	0	0	0	0	0	0	0
chr6:31138491:A:G	3	3	6	0	6	2	0	2
chr6:31138632:A:G	3	3	6	0	6	2	0	2
chr6:31138866:G:A	1	1	2	0	2	2	0	2
chr6:31142614:G:C	54	33	90	22	68	2.0	0.0	2.0
chr6:31144825:G:C	10	8	18	2	16	2.0	0.0	2.0
chr6:31144960:C:A	44	25	69	19	50	2.0	0.0	2.0
chr6:31154705:G:A	30	13	43	17	26	1.0	1.0	0.0
chr6:31154723:G:A	30	13	43	17	26	1.0	1.0	0.0
chr6:31157381:C:T	1	0	1	1	0	1	1	0
chr6:31161533:C:T	11	7	18	4	14	2	0	2
chr6:31170330:G:A	0	0	0	0	0	0	0	0
chr6:31170600:C:T	1	0	1	1	0	1	1	0
chr6:31280814:A:C	0	0	0	0	0	0	0	0
chr6:31505784:A:G	33	13	46	20	26	1	1	0
chr6:31505969:G:A	3	2	5	1	4	2	0	2
chr6:31506180:C:G	33	12	45	21	24	1	1	0
chr6:31506223:G:A	33	12	45	21	24	1	1	0
chr6:31615922:C:T	7	4	11	3	8	2	0	2
chr6:31625488:G:T	72	35	107	37	70	1.0	1.0	0.0
chr6:31628105:C:A	18	10	28	8	20	2.0	0.0	2.0
chr6:31630712:A:G	15	6	21	9	12	1	1	0
chr6:31633567:T:C	8	4	12	4	8	1.5	0.5	1.0
chr6:31633958:G:A	11	6	17	5	12	2	0	2
chr6:31635190:G:A	28	12	41	17	24	1.0	1.0	0.0
chr6:31636814:C:T	77	29	106	49	57	1	1	0
chr6:31637422:G:C	38	22	62	16	46	2.0	0.0	2.0
chr6:31641495:T:C	11	5	16	6	10	1	1	0
chr6:31642909:A:G	84	46	131	39	92	2.0	0.0	2.0
chr6:31651799:A:G	56	22	78	34	44	1.0	1.0	0.0
chr6:31659746:C:T	61	32	93	29	64	2	0	2
chr6:31662218:G:A	60	29	90	32	58	1.0	1.0	0.0
chr6:31664357:C:A	220	109	339	117	222	2.0	1.0	0.0
chr6:31689636:T:C	105	55	161	51	110	2	0	2
chr6:31759697:A:G	1	1	2	0	2	2	0	2
chr6:31760120:C:T	10	6	16	4	12	2.0	0.0	2.0
chr6:31760212:A:G	10	4	14	6	8	1.0	1.0	0.0
chr6:31761582:A:G	13	5	18	8	10	1	1	0
chr6:31765689:T:C	3	2	5	1	4	2	0	2
chr6:31766568:G:T	0	0	0	0	0	0	0	0
chr6:31781407:G:A	2	0	2	2	0	1.0	1.0	0.0
chr6:31795066:GG:CT	38	21	59	17	42	2.0	0.0	2.0
chr6:31815730:G:C	77	47	124	31	93	2	0	2
chr6:31817451:G:C	84	50	135	35	100	2.0	0.0	2.0
chr6:31870664:T:C	0	0	0	0	0	0	0	0
chr6:31883036:T:C	0	0	0	0	0	0	0	0
chr6:31883457:A:G	0	0	0	0	0	0	0	0
chr6:31892560:T:C	61	27	88	34	54	1	1	0
chr6:31951083:A:G	0	0	0	0	0	0	0	0
chr6:31951801:A:G	0	0	0	0	0	0	0	0
chr6:31961237:A:C	12	7	19	5	14	2.0	0.0	2.0
chr6:31968891:T:C	35	21	56	14	42	2	0	2
chr6:31979683:G:T	21	11	32	10	22	1	0	1
chr6:32058086:C:T	0	0	0	0	0	0	0	0
chr6:32061428:G:A	0	0	0	0	0	0	0	0
chr6:32061638:T:C	0	0	0	0	0	0	0	0
chr6:32064966:G:A	0	0	0	0	0	0	0	0
chr6:32067917:C:T	0	0	0	0	0	0	0	0
chr6:32082290:T:C	0	0	0	0	0	0	0	0
chr6:32096949:T:C	0	0	0	0	0	0	0	0
chr6:32121077:G:C	324	173	511	161	350	2.0	0.0	2.0
chr6:32128224:C:A	157	80	241	81	160	2	1	2
chr6:32154695:C:A	9	3	21	7	14	1	1	0
chr6:32166733:G:A	1	0	1	1	0	1	1	0
chr6:32179919:G:A	270	70	360	216	144	1.0	1.0	0.0
chr6:32180254:A:G	278	75	369	218	151	1.0	1.0	0.0
chr6:32184157:A:G	3	1	4	2	2	1	1	0
chr6:32186508:A:G	1	1	2	0	2	2	0	2
chr6:32187221:C:T	3	2	5	1	4	2	0	2
chr6:32192179:T:C	1387	740	2583	907	1676	2	1	2
chr6:32200994:G:T	0	0	0	0	0	0	0	0
chr6:32220520:G:C	1	1	2	0	2	2	0	2
chr6:32220826:C:T	1	1	2	0	2	2	0	2
chr6:32221255:T:C	1	1	2	0	2	2	0	2
chr6:32222613:T:G	1	0	1	1	0	1	1	0
chr6:32222629:A:G	1	0	1	1	0	1	1	0
chr6:32293475:T:G	2	1	3	1	2	1.5	0.5	1.0
chr6:32293730:T:C	2	1	3	1	2	1.5	0.5	1.0
chr6:32335915:T:A	1	0	1	1	0	1	1	0
chr6:32349690:T:C	25	18	43	7	36	2	0	2
chr6:32349694:A:C	25	7	32	18	14	1	1	0
chr6:32349858:G:A	25	18	43	7	36	2	0	2
chr6:32394044:C:T	3	1	4	2	2	1	1	0
chr6:32439932:C:A	4800	4167	39998	13763	26235	7.0	2.0	4.0
chr6:32443258:A:C	4765	4134	39568	13548	26020	7	2	4
chr6:32443869:T:G	4797	4176	40320	13899	26421	7	2	4
chr6:32661939:T:C	64	32	96	32	64	1.5	0.5	1.0
chr6:32662025:A:G	1808	1124	4031	1185	2846	2.0	1.0	2.0
chr6:32662070:A:G	1796	1118	3994	1167	2827	2.0	1.0	2.0
chr6:32815309:A:G	657	278	1027	445	582	1	1	0
chr6:32816976:T:C	796	506	1455	353	1102	2.0	0.0	2.0
chr6:32828908:A:G	108	56	165	54	111	2.0	0.5	2.0
chr6:32828974:T:C	107	56	165	53	112	2	0	2
chr6:32829520:T:C	98	47	147	53	94	1.0	1.0	0.0
chr6:32832447:C:A	81	40	122	42	80	1	1	0
chr6:32842666:G:A	54	36	90	18	72	2.0	0.0	2.0
chr6:32849181:G:A	5	2	7	3	4	1	1	0
chr6:32857313:G:A	1942	1284	4237	1159	3078	2.0	1.0	2.0
chr6:32858456:A:G	2033	1061	4081	1626	2455	2	1	2
chr6:32937309:G:T	1333	713	2466	875	1591	2	1	2
chr6:32972844:C:T	307	155	475	161	314	2	1	2
chr6:32974525:G:A	214	106	323	111	212	1.5	1.0	0.0
chr6:32978454:C:G	33	13	49	21	28	1	1	0
chr6:33068728:G:C	4605	3707	30106	11409	18697	5	2	4
chr6:33068840:C:T	17	3	21	15	6	1	1	0
chr6:33068853:GA:TC	17	3	21	15	6	1	1	0
chr6:33068931:CA:TG	17	3	21	15	6	1	1	0
chr6:33068940:C:G	17	3	21	15	6	1	1	0
chr6:33069076:A:C	4598	3710	29982	11313	18669	5.0	2.0	4.0
chr6:33069635:GC:CA	48	37	85	11	74	2.0	0.0	2.0
chr6:33069642:G:A	4585	3695	29603	11213	18390	5	2	4
chr6:33069647:T:C	4584	3693	29579	11212	18367	5.0	2.0	4.0
chr6:33073449:C:T	60	20	81	41	40	1.0	1.0	0.0
chr6:33080884:ATG:GTA	3879	2887	16560	5412	11148	3	1	2
chr6:33365669:C:T	0	0	0	0	0	0	0	0
chr6:33366139:G:T	0	0	0	0	0	0	0	0
chr6:33391939:G:C	0	0	0	0	0	0	0	0
chr6:33438523:T:C	4	2	6	2	4	1.5	0.5	1.0
chr6:33440765:G:A	1	0	1	1	0	1	1	0
chr6:33577563:G:A	52	18	70	34	36	1.0	1.0	0.0
chr6:33669130:C:T	1	0	1	1	0	1	1	0
chr6:33673602:T:C	1	0	1	1	0	1	1	0
chr6:33675781:G:A	0	0	0	0	0	0	0	0
chr6:33683352:C:T	1	0	1	1	0	1	1	0
chr6:33685671:C:T	1	1	2	0	2	2	0	2
chr6:33691695:C:G	10	7	17	3	14	2.0	0.0	2.0
chr6:33723019:CA:TG	0	0	0	0	0	0	0	0
chr6:33735617:G:T	0	0	0	0	0	0	0	0
chr6:33772548:G:C	22	6	28	16	12	1.0	1.0	0.0
chr6:33772605:G:A	20	15	34	5	29	2.0	0.0	2.0
chr6:33801120:A:G	0	0	0	0	0	0	0	0
chr6:34061803:G:A	0	0	0	0	0	0	0	0
chr6:35510835:G:A	0	0	0	0	0	0	0	0
chr6:35787881:A:G	0	0	0	0	0	0	0	0
chr6:35835415:C:A	13	3	16	10	6	1	1	0
chr6:35835506:C:T	4	2	6	2	4	1.5	0.5	1.0
chr6:36301948:A:G	0	0	0	0	0	0	0	0
chr6:36302353:C:A	0	0	0	0	0	0	0	0
chr6:36319535:G:C	0	0	0	0	0	0	0	0
chr6:36387595:T:C	0	0	0	0	0	0	0	0
chr6:36426039:A:G	0	0	0	0	0	0	0	0
chr6:36677811:A:C	0	0	0	0	0	0	0	0
chr6:36677919:A:G	0	0	0	0	0	0	0	0
chr6:36718495:C:T	0	0	0	0	0	0	0	0
chr6:36721253:A:C	0	0	0	0	0	0	0	0
chr6:36721853:C:T	0	0	0	0	0	0	0	0
chr6:36722184:A:C	0	0	0	0	0	0	0	0
chr6:36745486:A:G	210	132	354	85	269	2.0	0.0	2.0
chr6:36765355:G:A	0	0	0	0	0	0	0	0
chr6:36914577:A:G	133	74	208	60	148	2	0	2
chr6:36968864:G:A	312	144	467	177	290	1.0	1.0	0.0
chr6:37008861:G:C	453	269	754	200	554	2	0	2
chr6:37011058:A:G	168	104	274	66	208	2.0	0.0	2.0
chr6:37011103:T:C	168	104	274	66	208	2.0	0.0	2.0
chr6:37020588:C:T	69	26	95	44	51	1	1	0
chr6:37021615:G:C	8	3	11	5	6	1.0	1.0	0.0
chr6:37480218:C:G	13	6	19	7	12	1	1	0
chr6:37483138:T:C	558	337	979	266	713	2.0	0.0	2.0
chr6:38984222:C:T	0	0	0	0	0	0	0	0
chr6:38990077:A:G	0	0	0	0	0	0	0	0
chr6:39066296:G:A	0	0	0	0	0	0	0	0
chr6:39072878:A:C	0	0	0	0	0	0	0	0
chr6:39073726:A:C	0	0	0	0	0	0	0	0
chr6:39080715:A:C	0	0	0	0	0	0	0	0
chr6:39357302:A:G	0	0	0	0	0	0	0	0
chr6:39596087:C:T	0	0	0	0	0	0	0	0
chr6:39913358:A:T	0	0	0	0	0	0	0	0
chr6:39927671:T:C	0	0	0	0	0	0	0	0
chr6:40392252:C:T	0	0	0	0	0	0	0	0
chr6:41030428:T:C	7	2	9	5	4	1	1	0
chr6:41236591:A:T	0	0	0	0	0	0	0	0
chr6:41649888:G:C	0	0	0	0	0	0	0	0
chr6:41649920:G:A	0	0	0	0	0	0	0	0
chr6:41684866:T:C	153	78	237	81	156	2	1	2
chr6:41771435:C:T	6	0	6	6	0	1.0	1.0	0.0
chr6:41927412:G:A	18	11	30	8	22	2.0	0.0	2.0
chr6:41932668:C:T	18	12	31	8	23	2.0	0.0	2.0
chr6:42077207:G:A	16	11	27	5	22	2.0	0.0	2.0
chr6:42104954:G:T	0	0	0	0	0	0	0	0
chr6:42106368:A:G	0	0	0	0	0	0	0	0
chr6:42173531:G:A	0	0	0	0	0	0	0	0
chr6:42185690:C:A	1	0	1	1	0	1	1	0
chr6:42194650:A:G	7	6	13	1	12	2	0	2
chr6:42217826:A:C	332	175	527	164	363	2.0	0.0	2.0
chr6:42938646:G:T	870	470	1542	518	1024	2.0	1.0	2.0
chr6:43142013:G:A	0	0	0	0	0	0	0	0
chr6:43144644:C:T	0	0	0	0	0	0	0	0
chr6:43216394:A:C	6	4	10	2	8	2.0	0.0	2.0
chr6:43284142:C:G	0	0	0	0	0	0	0	0
chr6:43445127:T:C	7	2	9	5	4	1	1	0
chr6:43450953:G:A	0	0	0	0	0	0	0	0
chr6:43450995:G:A	0	0	0	0	0	0	0	0
chr6:43501503:T:G	0	0	0	0	0	0	0	0
chr6:43503743:C:G	1	1	2	0	2	2	0	2
chr6:43512569:A:G	1	1	2	0	2	2	0	2
chr6:43521098:C:T	13	5	18	8	10	1	1	0
chr6:43521156:G:T	14	5	19	9	10	1.0	1.0	0.0
chr6:43556002:A:G	2	0	2	2	0	1.0	1.0	0.0
chr6:43567281:C:T	14	9	24	6	18	2.0	0.0	2.0
chr6:43614198:A:G	5	3	8	2	6	2	0	2
chr6:43622671:G:A	3	1	4	2	2	1	1	0
chr6:43636430:A:G	68	32	101	37	64	1.0	1.0	0.0
chr6:43640311:C:T	66	34	101	33	68	2.0	0.0	2.0
chr6:43670899:G:A	2	1	3	1	2	1.5	0.5	1.0
chr6:43778432:C:T	0	0	0	0	0	0	0	0
chr6:44089351:C:T	2	1	3	1	2	1.5	0.5	1.0
chr6:44113773:C:T	539	259	862	321	541	2	1	0
chr6:44140413:T:C	1	0	1	1	0	1	1	0
chr6:44180084:A:G	0	0	0	0	0	0	0	0
chr6:44180831:C:T	0	0	0	0	0	0	0	0
chr6:44184028:G:A	0	0	0	0	0	0	0	0
chr6:44217785:TC:GA	0	0	0	0	0	0	0	0
chr6:44275822:A:G	0	0	0	0	0	0	0	0
chr6:44282428:A:G	0	0	0	0	0	0	0	0
chr6:44286028:A:G	0	0	0	0	0	0	0	0
chr6:44287722:G:A	1	1	2	0	2	2	0	2
chr6:44301456:C:T	3	2	5	1	4	2	0	2
chr6:44311052:C:T	5	3	8	2	6	2	0	2
chr6:44403977:C:T	207	114	332	100	232	2	0	2
chr6:44445726:T:A	34	20	55	15	40	2.0	0.0	2.0
chr6:46652515:C:G	0	0	0	0	0	0	0	0
chr6:46655961:T:C	0	0	0	0	0	0	0	0
chr6:46689320:A:G	0	0	0	0	0	0	0	0
chr6:46705206:A:G	0	0	0	0	0	0	0	0
chr6:46716485:C:T	0	0	0	0	0	0	0	0
chr6:46839029:G:A	0	0	0	0	0	0	0	0
chr6:47582147:T:C	3	1	4	2	2	1	1	0
chr6:47609328:G:A	21	7	28	14	14	1	1	0
chr6:47679012:T:C	0	0	0	0	0	0	0	0
chr6:47679106:A:G	0	0	0	0	0	0	0	0
chr6:47681486:T:G	0	0	0	0	0	0	0	0
chr6:47681529:T:A	0	0	0	0	0	0	0	0
chr6:47681837:CA:TG	0	0	0	0	0	0	0	0
chr6:47681958:A:G	0	0	0	0	0	0	0	0
chr6:47682452:A:G	0	0	0	0	0	0	0	0
chr6:47781992:T:G	0	0	0	0	0	0	0	0
chr6:47878273:A:G	0	0	0	0	0	0	0	0
chr6:47879665:A:G	0	0	0	0	0	0	0	0
chr6:49435569:T:C	24	18	44	6	38	2.0	0.0	2.0
chr6:49444720:C:T	17	12	31	5	26	2	0	2
chr6:49472092:G:A	126	92	221	37	184	2.0	0.0	2.0
chr6:49550886:T:C	0	0	0	0	0	0	0	0
chr6:49551456:T:C	0	0	0	0	0	0	0	0
chr6:49551566:G:C	0	0	0	0	0	0	0	0
chr6:49692705:A:C	0	0	0	0	0	0	0	0
chr6:49733810:A:G	0	0	0	0	0	0	0	0
chr6:50715296:T:C	0	0	0	0	0	0	0	0
chr6:50818858:G:A	0	0	0	0	0	0	0	0
chr6:50913130:G:A	0	0	0	0	0	0	0	0
chr6:51410244:T:C	0	0	0	0	0	0	0	0
chr6:51619163:T:C	0	0	0	0	0	0	0	0
chr6:51627086:T:C	0	0	0	0	0	0	0	0
chr6:51659605:G:A	0	0	0	0	0	0	0	0
chr6:51748379:C:T	0	0	0	0	0	0	0	0
chr6:51868009:C:T	0	0	0	0	0	0	0	0
chr6:52046107:T:C	0	0	0	0	0	0	0	0
chr6:52055687:G:A	0	0	0	0	0	0	0	0
chr6:52056905:A:G	0	0	0	0	0	0	0	0
chr6:52082439:G:A	0	0	0	0	0	0	0	0
chr6:52277602:C:T	76	37	115	41	74	1.0	1.0	0.0
chr6:52752933:C:G	0	0	0	0	0	0	0	0
chr6:53294292:G:T	619	270	968	400	568	1	1	0
chr6:53654264:A:G	0	0	0	0	0	0	0	0
chr6:53654807:C:T	0	0	0	0	0	0	0	0
chr6:53655059:G:A	0	0	0	0	0	0	0	0
chr6:53655290:T:C	0	0	0	0	0	0	0	0
chr6:54941581:A:G	0	0	0	0	0	0	0	0
chr6:55277539:A:G	0	0	0	0	0	0	0	0
chr6:56508738:C:T	0	0	0	0	0	0	0	0
chr6:56598612:T:C	0	0	0	0	0	0	0	0
chr6:56619960:C:T	0	0	0	0	0	0	0	0
chr6:56642337:T:C	0	0	0	0	0	0	0	0
chr6:57008247:A:C	0	0	0	0	0	0	0	0
chr6:57046776:A:G	80	37	123	43	80	1.0	1.0	0.0
chr6:57054645:A:G	4	2	6	2	4	1.5	0.5	1.0
chr6:57148132:C:T	4	2	6	2	4	1.5	0.5	1.0
chr6:57190556:C:T	1	1	2	0	2	2	0	2
chr6:62177194:C:T	215	114	341	105	236	2	0	2
chr6:62286015:T:G	314	147	482	186	296	1.0	1.0	0.0
chr6:63211948:A:G	0	0	0	0	0	0	0	0
chr6:63984461:C:T	0	0	0	0	0	0	0	0
chr6:64590250:G:C	0	0	0	0	0	0	0	0
chr6:64591324:G:A	0	0	0	0	0	0	0	0
chr6:64591515:A:G	0	0	0	0	0	0	0	0
chr6:64593207:T:C	0	0	0	0	0	0	0	0
chr6:65335034:T:C	0	0	0	0	0	0	0	0
chr6:69361105:C:A	0	0	0	0	0	0	0	0
chr6:70207184:A:C	2	1	4	2	2	2.0	1.0	1.0
chr6:70252130:T:C	0	0	0	0	0	0	0	0
chr6:70526513:C:T	0	0	0	0	0	0	0	0
chr6:70559756:C:T	5	2	7	3	4	1	1	0
chr6:70559929:G:A	5	2	7	3	4	1	1	0
chr6:70956279:GGGCG:CGGCA	0	0	0	0	0	0	0	0
chr6:70956443:T:C	0	0	0	0	0	0	0	0
chr6:70956524:G:A	0	0	0	0	0	0	0	0
chr6:73363214:G:C	0	0	0	0	0	0	0	0
chr6:73363808:C:G	0	0	0	0	0	0	0	0
chr6:73369301:A:G	0	0	0	0	0	0	0	0
chr6:73394834:C:G	0	0	0	0	0	0	0	0
chr6:73518283:A:G	109	38	151	71	80	1	1	0
chr6:73518326:A:G	105	38	147	68	79	1	1	0
chr6:73520069:A:G	147	58	207	92	115	1	1	0
chr6:73783709:A:C	0	0	0	0	0	0	0	0
chr6:73823468:G:T	0	0	0	0	0	0	0	0
chr6:75138465:A:G	0	0	0	0	0	0	0	0
chr6:75647710:C:T	39	15	54	24	30	1	1	0
chr6:75666836:G:A	27	17	44	10	34	2	0	2
chr6:75715572:A:G	36	25	61	11	50	2.0	0.0	2.0
chr6:75848478:C:T	0	0	0	0	0	0	0	0
chr6:75915024:C:T	0	0	0	0	0	0	0	0
chr6:75931064:C:T	0	0	0	0	0	0	0	0
chr6:78965984:A:G	18	9	27	9	18	1.5	0.5	1.0
chr6:79487131:C:T	0	0	0	0	0	0	0	0
chr6:79518818:T:G	0	0	0	0	0	0	0	0
chr6:79518824:A:G	0	0	0	0	0	0	0	0
chr6:79916658:T:C	0	0	0	0	0	0	0	0
chr6:80065613:G:A	0	0	0	0	0	0	0	0
chr6:83153863:C:T	4	2	6	2	4	1.5	0.5	1.0
chr6:83524425:C:T	0	0	0	0	0	0	0	0
chr6:84764040:C:T	0	0	0	0	0	0	0	0
chr6:87255810:T:C	10	2	12	8	4	1.0	1.0	0.0
chr6:87258847:A:G	18	12	30	6	24	2.0	0.0	2.0
chr6:87260019:C:T	63	29	92	34	58	1	1	0
chr6:87284297:A:G	1	1	2	0	2	2	0	2
chr6:87284854:G:A	0	0	0	0	0	0	0	0
chr6:87472986:G:C	23	9	32	14	18	1	1	0
chr6:89084175:G:C	1384	759	2569	849	1720	2.0	1.0	2.0
chr6:89179025:C:T	0	0	0	0	0	0	0	0
chr6:89198154:G:A	0	0	0	0	0	0	0	0
chr6:89271694:T:C	0	0	0	0	0	0	0	0
chr6:89606070:A:G	1	1	2	0	2	2	0	2
chr6:89618154:G:A	0	0	0	0	0	0	0	0
chr6:89630727:C:T	1	0	1	1	0	1	1	0
chr6:89637792:T:C	599	293	949	343	606	2	1	0
chr6:89658661:G:A	2	0	2	2	0	1.0	1.0	0.0
chr6:89661483:G:A	5	2	7	3	4	1	1	0
chr6:89662855:A:C	18	5	23	13	10	1.0	1.0	0.0
chr6:89672431:C:A	2	2	4	0	4	2.0	0.0	2.0
chr6:89674487:C:G	3	2	5	1	4	2	0	2
chr6:89698870:A:G	2	2	4	0	4	2.0	0.0	2.0
chr6:89708612:A:G	3	1	4	2	2	1	1	0
chr6:89749735:G:A	6	4	10	2	8	2.0	0.0	2.0
chr6:89789783:G:A	35	18	53	17	36	2	0	2
chr6:89819624:C:T	65	27	95	39	56	1	1	0
chr6:89867883:C:T	12	7	19	5	14	2.0	0.0	2.0
chr6:89896117:T:A	0	0	0	0	0	0	0	0
chr6:89950600:T:C	11	6	17	5	12	2	0	2
chr6:89951857:T:C	12	5	17	7	10	1.0	1.0	0.0
chr6:95606046:T:A	12	9	20	3	17	2.0	0.0	2.0
chr6:96521818:C:A	165	99	276	66	210	2	0	2
chr6:96604878:C:T	0	0	0	0	0	0	0	0
chr6:96610677:A:G	0	0	0	0	0	0	0	0
chr6:96610691:A:G	0	0	0	0	0	0	0	0
chr6:96610698:G:A	0	0	0	0	0	0	0	0
chr6:96891202:A:G	412	227	700	208	492	2.0	0.0	2.0
chr6:99175083:A:G	0	0	0	0	0	0	0	0
chr6:99323664:T:C	0	0	0	0	0	0	0	0
chr6:99446002:T:C	6	2	8	4	4	1.0	1.0	0.0
chr6:99947926:A:G	0	0	0	0	0	0	0	0
chr6:100661817:G:C	3	2	5	1	4	2	0	2
chr6:102055442:G:A	0	0	0	0	0	0	0	0
chr6:104750392:A:G	5	3	8	2	6	2	0	2
chr6:105373574:A:G	21	9	30	12	18	1	1	0
chr6:106099606:C:G	13	6	19	7	12	1	1	0
chr6:106519310:A:C	58	20	78	38	40	1.0	1.0	0.0
chr6:106543486:T:C	54	28	84	26	58	2.0	0.0	2.0
chr6:106628908:A:T	68	36	104	32	72	2.0	0.0	2.0
chr6:106629627:G:A	96	55	155	43	112	2.0	0.0	2.0
chr6:106655635:G:T	280	139	444	154	290	2.0	1.0	0.0
chr6:106665840:G:A	254	134	412	136	276	2.0	1.0	2.0
chr6:106971734:G:A	260	118	414	162	252	1.0	1.0	0.0
chr6:107030089:G:T	20	8	28	12	16	1.0	1.0	0.0
chr6:107069751:G:A	0	0	0	0	0	0	0	0
chr6:107746799:C:T	0	0	0	0	0	0	0	0
chr6:107772376:C:T	1	0	1	1	0	1	1	0
chr6:110246206:G:A	3	2	5	1	4	2	0	2
chr6:110456759:A:G	0	0	0	0	0	0	0	0
chr6:110456925:T:C	0	0	0	0	0	0	0	0
chr6:112139163:C:T	0	0	0	0	0	0	0	0
chr6:112172670:A:G	0	0	0	0	0	0	0	0
chr6:116253292:G:A	4	0	4	4	0	1.0	1.0	0.0
chr6:116253920:C:A	57	31	89	27	62	2	0	2
chr6:116279611:C:G	89	55	144	34	110	2	0	2
chr6:116279647:G:A	90	55	145	35	110	2.0	0.0	2.0
chr6:116433293:G:T	0	0	0	0	0	0	0	0
chr6:116453096:C:T	0	0	0	0	0	0	0	0
chr6:116453101:T:C	0	0	0	0	0	0	0	0
chr6:116554330:T:C	0	0	0	0	0	0	0	0
chr6:116765215:C:A	0	0	0	0	0	0	0	0
chr6:117404285:T:G	0	0	0	0	0	0	0	0
chr6:117425756:A:T	0	0	0	0	0	0	0	0
chr6:118565798:G:T	81	31	112	50	62	1	1	0
chr6:118566140:T:C	89	35	124	54	70	1	1	0
chr6:118815596:A:C	2	1	3	1	2	1.5	0.5	1.0
chr6:118827986:C:G	22	9	31	13	18	1.0	1.0	0.0
chr6:118894238:A:C	232	116	352	117	235	1.0	1.0	0.5
chr6:123218539:CT:TC	0	0	0	0	0	0	0	0
chr6:123377897:T:C	0	0	0	0	0	0	0	0
chr6:123548462:G:C	0	0	0	0	0	0	0	0
chr6:125252048:A:G	0	0	0	0	0	0	0	0
chr6:125277053:TG:CA	2	1	3	1	2	1.5	0.5	1.0
chr6:125300472:A:G	1	1	2	0	2	2	0	2
chr6:125300499:C:T	1	1	2	0	2	2	0	2
chr6:127447617:G:A	1	1	2	0	2	2	0	2
chr6:129157850:G:A	0	0	0	0	0	0	0	0
chr6:129192705:T:A	0	0	0	0	0	0	0	0
chr6:129291663:A:G	0	0	0	0	0	0	0	0
chr6:129369987:C:G	0	0	0	0	0	0	0	0
chr6:129710070:T:C	67	28	95	39	56	1	1	0
chr6:130052957:C:A	74	8	82	66	16	1.0	1.0	0.0
chr6:130060101:T:C	7	4	11	3	8	2	0	2
chr6:130184139:C:T	0	0	0	0	0	0	0	0
chr6:130440653:T:C	0	0	0	0	0	0	0	0
chr6:130441142:G:T	0	0	0	0	0	0	0	0
chr6:130827504:G:A	0	0	0	0	0	0	0	0
chr6:130827597:G:A	0	0	0	0	0	0	0	0
chr6:130834962:G:T	0	0	0	0	0	0	0	0
chr6:130869698:G:A	0	0	0	0	0	0	0	0
chr6:131579250:C:T	0	0	0	0	0	0	0	0
chr6:131593092:A:G	7	4	11	3	8	2	0	2
chr6:131637345:A:C	0	0	0	0	0	0	0	0
chr6:132713959:G:A	0	0	0	0	0	0	0	0
chr6:132724763:A:G	0	0	0	0	0	0	0	0
chr6:132751511:A:G	62	30	92	33	59	1.0	1.0	0.0
chr6:132752705:C:T	45	15	60	30	30	1	1	0
chr6:132755924:T:C	65	31	97	35	62	1	1	0
chr6:132814747:A:G	5083	4954	113362	37693	75669	19	6	12
chr6:133987049:T:G	227	110	344	120	224	1	1	0
chr6:134966395:A:G	35	20	55	15	40	2	0	2
chr6:135037778:G:A	24	10	34	14	20	1.0	1.0	0.0
chr6:135318506:C:T	7	6	13	1	12	2	0	2
chr6:136278255:G:C	357	0	380	380	0	1	1	0
chr6:136278266:T:C	359	0	382	382	0	1	1	0
chr6:136567751:A:G	50	25	75	25	50	1.5	0.5	1.0
chr6:136592526:C:T	8	3	11	5	6	1.0	1.0	0.0
chr6:138092132:A:G	0	0	0	0	0	0	0	0
chr6:138336546:A:C	0	0	0	0	0	0	0	0
chr6:138403521:G:T	3	0	3	3	0	1	1	0
chr6:138403531:C:G	3	0	3	3	0	1	1	0
chr6:139166257:T:C	45	20	65	25	40	1	1	0
chr6:139166699:T:C	2	1	3	1	2	1.5	0.5	1.0
chr6:142078827:T:C	0	0	0	0	0	0	0	0
chr6:142370412:A:C	0	0	0	0	0	0	0	0
chr6:142753563:T:C	9	7	16	2	14	2	0	2
chr6:142759898:A:G	8	5	13	3	10	2.0	0.0	2.0
chr6:142771358:C:T	4	3	7	1	6	2.0	0.0	2.0
chr6:143485139:A:G	2	2	4	0	4	2.0	0.0	2.0
chr6:143495722:C:T	113	54	174	64	110	1	1	0
chr6:143823738:G:A	11	5	18	6	12	1	1	0
chr6:144437663:A:G	51	27	78	24	54	2	0	2
chr6:144548649:A:G	5	2	7	3	4	1	1	0
chr6:145955127:C:A	102	52	158	52	106	2.0	0.0	2.0
chr6:146726160:T:C	0	0	0	0	0	0	0	0
chr6:146785705:A:G	0	0	0	0	0	0	0	0
chr6:146815108:A:G	0	0	0	0	0	0	0	0
chr6:147359223:A:G	3	2	5	1	4	2	0	2
chr6:147382977:A:G	7	5	12	2	10	2	0	2
chr6:148508816:G:C	0	0	0	0	0	0	0	0
chr6:148964583:A:G	0	0	0	0	0	0	0	0
chr6:148964632:T:C	0	0	0	0	0	0	0	0
chr6:149400554:G:A	47	23	70	24	46	1	1	0
chr6:149461711:G:A	1	1	2	0	2	2	0	2
chr6:149461772:A:G	2	2	4	0	4	2.0	0.0	2.0
chr6:150021096:G:A	0	0	0	0	0	0	0	0
chr6:150025396:T:C	0	0	0	0	0	0	0	0
chr6:150064594:T:G	0	0	0	0	0	0	0	0
chr6:150831121:A:G	10	3	13	7	6	1.0	1.0	0.0
chr6:150831520:T:C	14	7	21	7	14	1.5	0.5	1.0
chr6:150935314:C:T	3	1	4	2	2	1	1	0
chr6:151015603:C:G	9	1	10	8	2	1	1	0
chr6:152098960:G:A	0	0	0	0	0	0	0	0
chr6:152168159:T:C	2	2	4	0	4	2.0	0.0	2.0
chr6:152294065:G:A	35	18	54	18	36	2	0	2
chr6:152339316:G:A	0	0	0	0	0	0	0	0
chr6:152344126:C:A	0	0	0	0	0	0	0	0
chr6:152354719:A:G	0	0	0	0	0	0	0	0
chr6:152362278:G:T	0	0	0	0	0	0	0	0
chr6:152369424:G:A	0	0	0	0	0	0	0	0
chr6:152373049:T:C	0	0	0	0	0	0	0	0
chr6:152376571:C:T	0	0	0	0	0	0	0	0
chr6:152447591:T:G	0	0	0	0	0	0	0	0
chr6:154450143:A:G	0	0	0	0	0	0	0	0
chr6:155130218:G:A	0	0	0	0	0	0	0	0
chr6:155240662:C:T	0	0	0	0	0	0	0	0
chr6:155256689:C:T	2	1	3	1	2	1.5	0.5	1.0
chr6:155260485:G:A	11	9	22	2	20	2	0	2
chr6:155275767:T:C	5	2	7	3	4	1	1	0
chr6:155314451:A:C	226	101	333	129	204	1.0	1.0	0.0
chr6:155314490:A:G	30	8	38	22	16	1.0	1.0	0.0
chr6:157542711:G:A	1	0	1	1	0	1	1	0
chr6:157873152:G:C	626	338	1065	337	728	2.0	1.0	2.0
chr6:157874990:C:G	52	22	74	30	44	1.0	1.0	0.0
chr6:158076685:T:C	0	0	0	0	0	0	0	0
chr6:158078270:G:T	0	0	0	0	0	0	0	0
chr6:158086949:G:A	0	0	0	0	0	0	0	0
chr6:158096276:A:G	0	0	0	0	0	0	0	0
chr6:158117715:C:T	0	0	0	0	0	0	0	0
chr6:158605295:G:A	9	3	12	6	6	1	1	0
chr6:158644726:C:G	802	468	1365	381	984	2.0	0.0	2.0
chr6:158757313:C:T	19	9	30	10	20	1	1	0
chr6:158763430:A:G	15	7	22	8	14	1	1	0
chr6:158764531:T:A	14	8	22	6	16	2.0	0.0	2.0
chr6:158986383:C:T	6	4	10	2	8	2.0	0.0	2.0
chr6:158986415:G:A	6	4	10	2	8	2.0	0.0	2.0
chr6:158999542:T:C	23	12	35	11	24	2	0	2
chr6:159040899:C:T	84	51	140	36	104	2.0	0.0	2.0
chr6:159041392:C:T	750	375	1340	497	843	2.0	1.0	0.5
chr6:159042189:G:A	696	345	1237	462	775	2.0	1.0	0.0
chr6:159780128:A:T	6	3	9	3	6	1.5	0.5	1.0
chr6:159809020:A:G	0	0	0	0	0	0	0	0
chr6:160027292:C:G	4	2	6	2	4	1.5	0.5	1.0
chr6:160032946:A:G	4	2	6	2	4	1.5	0.5	1.0
chr6:160043257:G:A	0	0	0	0	0	0	0	0
chr6:160047246:A:G	0	0	0	0	0	0	0	0
chr6:160130061:T:G	1	0	1	1	0	1	1	0
chr6:160258368:C:A	0	0	0	0	0	0	0	0
chr6:160585140:T:G	0	0	0	0	0	0	0	0
chr6:165301971:G:C	0	0	0	0	0	0	0	0
chr6:165302184:A:G	0	0	0	0	0	0	0	0
chr6:166165782:C:T	26	3	29	23	6	1.0	1.0	0.0
chr6:166166700:G:A	27	3	30	24	6	1	1	0
chr6:166167659:T:C	26	3	29	23	6	1.0	1.0	0.0
chr6:166412767:G:A	17	11	30	6	24	2	0	2
chr6:166448745:T:C	19	8	27	11	16	1	1	0
chr6:166929653:G:A	1914	1128	3943	1231	2712	2.0	1.0	2.0
chr6:166931095:A:G	1862	1092	3792	1194	2598	2.0	1.0	2.0
chr6:167177053:G:A	0	0	0	0	0	0	0	0
chr6:167179036:T:C	0	0	0	0	0	0	0	0
chr6:167179088:G:A	0	0	0	0	0	0	0	0
chr6:167305948:G:A	0	0	0	0	0	0	0	0
chr6:167315286:TG:CA	0	0	0	0	0	0	0	0
chr6:167341173:A:G	0	0	0	0	0	0	0	0
chr6:167375916:C:G	0	0	0	0	0	0	0	0
chr6:167375952:TCG:CCT	0	0	0	0	0	0	0	0
chr6:167376005:T:C	0	0	0	0	0	0	0	0
chr6:167376102:C:T	0	0	0	0	0	0	0	0
chr6:167376127:C:T	0	0	0	0	0	0	0	0
chr6:167378036:C:T	0	0	0	0	0	0	0	0
chr6:167922984:A:G	3	3	6	0	6	2	0	2
chr6:167943158:T:C	2	2	4	0	4	2.0	0.0	2.0
chr6:167948331:C:T	1	1	2	0	2	2	0	2
chr6:168042007:A:C	0	0	0	0	0	0	0	0
chr6:168307365:T:C	0	0	0	0	0	0	0	0
chr6:168308071:A:G	0	0	0	0	0	0	0	0
chr6:168308113:C:G	0	0	0	0	0	0	0	0
chr6:168308136:T:G	0	0	0	0	0	0	0	0
chr6:168308705:T:C	0	0	0	0	0	0	0	0
chr6:169217745:A:G	0	0	0	0	0	0	0	0
chr6:169221441:A:G	0	0	0	0	0	0	0	0
chr6:169222395:G:A	0	0	0	0	0	0	0	0
chr6:169234714:C:T	0	0	0	0	0	0	0	0
chr6:169239806:C:T	0	0	0	0	0	0	0	0
chr6:169241876:C:T	0	0	0	0	0	0	0	0
chr6:169248672:G:A	0	0	0	0	0	0	0	0
chr6:169632990:G:A	2	2	4	0	4	2.0	0.0	2.0
chr6:169638600:G:A	1	1	2	0	2	2	0	2
chr6:169668084:A:G	3	1	4	2	2	1	1	0
chr6:169670627:A:G	12	3	15	9	6	1.0	1.0	0.0
chr6:169702408:T:C	46	27	73	19	54	2.0	0.0	2.0
chr6:169702954:A:G	46	25	71	21	50	2.0	0.0	2.0
chr6:170318563:G:A	7	4	13	3	10	2	0	2
chr6:170553212:G:C	2094	1233	4353	1463	2890	2.0	1.0	2.0
chr6:170569705:T:C	59	35	96	24	72	2	0	2
chr6:170577443:T:C	197	100	303	99	204	2	0	2
chr6:170583012:T:C	33	10	43	23	20	1	1	0
chr7:31273:G:C	0	0	0	0	0	0	0	0
chr7:246436:A:G	0	0	0	0	0	0	0	0
chr7:256591:T:C	0	0	0	0	0	0	0	0
chr7:257139:C:A	0	0	0	0	0	0	0	0
chr7:259974:G:A	0	0	0	0	0	0	0	0
chr7:260021:C:G	0	0	0	0	0	0	0	0
chr7:291461:C:A	0	0	0	0	0	0	0	0
chr7:498554:C:T	6	3	9	3	6	1.5	0.5	1.0
chr7:550562:A:G	59	34	97	27	70	2	0	2
chr7:579301:A:G	114	69	202	51	151	2.0	0.0	2.0
chr7:756793:C:T	3	1	4	2	2	1	1	0
chr7:857855:A:G	21	9	30	12	18	1	1	0
chr7:886080:G:A	134	68	203	67	136	2.0	0.5	2.0
chr7:900630:T:C	0	0	0	0	0	0	0	0
chr7:904048:A:G	1	1	2	0	2	2	0	2
chr7:904074:T:C	1	1	2	0	2	2	0	2
chr7:904231:G:A	2	2	4	0	4	2.0	0.0	2.0
chr7:983377:C:T	0	0	0	0	0	0	0	0
chr7:988812:C:T	0	0	0	0	0	0	0	0
chr7:997389:C:A	234	107	362	140	222	1.0	1.0	0.0
chr7:1057547:G:A	1	1	2	0	2	2	0	2
chr7:1057758:T:C	1	1	2	0	2	2	0	2
chr7:1058259:A:G	1	1	2	0	2	2	0	2
chr7:1091775:C:T	0	0	0	0	0	0	0	0
chr7:1092820:C:T	0	0	0	0	0	0	0	0
chr7:1092869:G:A	0	0	0	0	0	0	0	0
chr7:1155579:A:C	315	172	500	152	348	2	0	2
chr7:1434706:A:T	2	1	3	1	2	1.5	0.5	1.0
chr7:1436884:C:A	1	0	1	1	0	1	1	0
chr7:1437477:T:C	1	0	1	1	0	1	1	0
chr7:1437507:C:T	1	0	1	1	0	1	1	0
chr7:1438771:G:A	0	0	0	0	0	0	0	0
chr7:1438859:A:G	2	0	2	2	0	1.0	1.0	0.0
chr7:1439008:G:A	0	0	0	0	0	0	0	0
chr7:1548700:G:A	0	0	0	0	0	0	0	0
chr7:1555432:G:A	0	0	0	0	0	0	0	0
chr7:1746102:G:A	0	0	0	0	0	0	0	0
chr7:2250887:C:T	536	272	889	299	590	2.0	1.0	2.0
chr7:2255077:C:T	285	152	473	155	318	2	1	2
chr7:2257371:A:G	277	148	459	149	310	2	1	2
chr7:2257577:C:T	21	13	34	8	26	2	0	2
chr7:2264351:T:C	264	140	435	141	294	2.0	1.0	2.0
chr7:2355356:C:T	13	8	21	5	16	2	0	2
chr7:2374507:A:G	1	0	1	1	0	1	1	0
chr7:2475153:C:T	0	0	0	0	0	0	0	0
chr7:2526884:G:A	10	5	16	6	10	2.0	0.5	1.0
chr7:2700381:T:G	0	0	0	0	0	0	0	0
chr7:2702729:C:T	0	0	0	0	0	0	0	0
chr7:2906827:T:C	96	46	140	50	90	1.0	1.0	0.0
chr7:2917371:T:C	63	28	92	36	56	1	1	0
chr7:3987312:C:G	0	0	0	0	0	0	0	0
chr7:4114192:A:G	0	0	0	0	0	0	0	0
chr7:4268695:C:T	0	0	0	0	0	0	0	0
chr7:4268730:C:T	0	0	0	0	0	0	0	0
chr7:4740883:G:T	5	2	8	4	4	1	1	0
chr7:4834789:G:C	0	0	0	0	0	0	0	0
chr7:4836426:C:T	0	0	0	0	0	0	0	0
chr7:4860710:G:A	0	0	0	0	0	0	0	0
chr7:4861754:A:C	0	0	0	0	0	0	0	0
chr7:4907342:A:G	0	0	0	0	0	0	0	0
chr7:4920176:G:A	0	0	0	0	0	0	0	0
chr7:5217942:G:A	161	96	261	67	194	2	0	2
chr7:5222754:G:A	7	4	10	3	7	1	0	1
chr7:5299062:C:T	2	1	3	1	2	1.5	0.5	1.0
chr7:5308115:C:T	0	0	0	0	0	0	0	0
chr7:5308118:G:A	0	0	0	0	0	0	0	0
chr7:5308283:G:A	0	0	0	0	0	0	0	0
chr7:5359413:C:G	4	1	5	3	2	1.0	1.0	0.0
chr7:5370382:C:G	0	0	0	0	0	0	0	0
chr7:5394504:A:G	9	5	14	4	10	2	0	2
chr7:5528735:A:G	183	109	305	77	228	2	0	2
chr7:5986899:C:T	7	3	10	4	6	1	1	0
chr7:5987144:T:C	9	3	12	6	6	1	1	0
chr7:5997349:G:C	8	2	10	6	4	1.0	1.0	0.0
chr7:6330563:C:T	14	8	22	6	16	2.0	0.0	2.0
chr7:6330674:C:G	13	7	20	6	14	2	0	2
chr7:6330775:C:T	10	6	16	4	12	2.0	0.0	2.0
chr7:6409865:T:C	20	12	32	8	24	2.0	0.0	2.0
chr7:6416688:G:C	15	6	21	9	12	1	1	0
chr7:6416716:G:T	14	6	19	8	11	1.0	1.0	0.0
chr7:6421903:C:T	2	1	3	1	2	1.5	0.5	1.0
chr7:6551410:C:G	0	0	0	0	0	0	0	0
chr7:6600322:G:A	49	23	75	27	48	1	1	0
chr7:6617199:G:A	1	0	1	1	0	1	1	0
chr7:6617266:A:G	1	0	1	1	0	1	1	0
chr7:6643823:A:G	5	1	6	4	2	1	1	0
chr7:6804943:C:G	87	0	87	87	0	1	1	0
chr7:6930775:G:A	0	0	0	0	0	0	0	0
chr7:8086564:A:G	12	3	15	9	6	1.0	1.0	0.0
chr7:9727336:T:G	0	0	0	0	0	0	0	0
chr7:9727625:AT:TG	0	0	0	0	0	0	0	0
chr7:9727794:C:G	0	0	0	0	0	0	0	0
chr7:9728004:G:C	0	0	0	0	0	0	0	0
chr7:9728157:A:C	0	0	0	0	0	0	0	0
chr7:9728253:A:G	0	0	0	0	0	0	0	0
chr7:11379304:T:C	0	0	0	0	0	0	0	0
chr7:11379751:T:C	0	0	0	0	0	0	0	0
chr7:11460745:C:T	0	0	0	0	0	0	0	0
chr7:11481801:A:G	0	0	0	0	0	0	0	0
chr7:11481915:T:C	0	0	0	0	0	0	0	0
chr7:11636750:G:A	0	0	0	0	0	0	0	0
chr7:12229791:C:G	93	45	138	48	90	1	1	0
chr7:12370486:G:A	0	0	0	0	0	0	0	0
chr7:12570825:G:A	0	0	0	0	0	0	0	0
chr7:12570968:A:G	0	0	0	0	0	0	0	0
chr7:12581179:C:T	0	0	0	0	0	0	0	0
chr7:12688201:G:C	230	126	372	112	260	2.0	0.0	2.0
chr7:12688864:A:G	184	102	294	88	206	2.0	0.0	2.0
chr7:13939184:T:C	0	0	0	0	0	0	0	0
chr7:14176817:A:G	0	0	0	0	0	0	0	0
chr7:14178048:G:A	0	0	0	0	0	0	0	0
chr7:16615762:C:T	35	18	54	18	36	2	0	2
chr7:16783470:G:A	1	0	1	1	0	1	1	0
chr7:17880990:C:T	1	1	2	0	2	2	0	2
chr7:18954247:C:T	0	0	0	0	0	0	0	0
chr7:20159909:G:A	2	2	4	0	4	2.0	0.0	2.0
chr7:20643261:C:T	0	0	0	0	0	0	0	0
chr7:20643581:G:T	0	0	0	0	0	0	0	0
chr7:20647558:C:T	0	0	0	0	0	0	0	0
chr7:20651424:T:C	0	0	0	0	0	0	0	0
chr7:20658647:A:G	0	0	0	0	0	0	0	0
chr7:20659181:C:A	0	0	0	0	0	0	0	0
chr7:20728390:G:A	0	0	0	0	0	0	0	0
chr7:20739023:G:A	0	0	0	0	0	0	0	0
chr7:21543345:GA:TT	0	0	0	0	0	0	0	0
chr7:21543664:T:G	0	0	0	0	0	0	0	0
chr7:21564268:A:G	0	0	0	0	0	0	0	0
chr7:21582013:G:A	0	0	0	0	0	0	0	0
chr7:21599954:A:G	0	0	0	0	0	0	0	0
chr7:21639025:A:G	0	0	0	0	0	0	0	0
chr7:21725834:C:T	0	0	0	0	0	0	0	0
chr7:21725879:G:A	0	0	0	0	0	0	0	0
chr7:21735751:G:A	0	0	0	0	0	0	0	0
chr7:21892426:C:T	0	0	0	0	0	0	0	0
chr7:21899414:C:A	2	0	2	2	0	1.0	1.0	0.0
chr7:21901342:A:G	95	36	134	62	72	1	1	0
chr7:22220051:C:A	0	0	0	0	0	0	0	0
chr7:22438588:G:T	0	0	0	0	0	0	0	0
chr7:22818063:A:G	6	3	9	3	6	1.5	0.5	1.0
chr7:22822848:G:A	838	244	1213	709	504	1.0	1.0	0.0
chr7:23317702:C:T	3	1	4	2	2	1	1	0
chr7:24285140:T:G	0	0	0	0	0	0	0	0
chr7:24285390:G:A	0	0	0	0	0	0	0	0
chr7:24289514:C:T	0	0	0	0	0	0	0	0
chr7:24687648:C:T	5	4	8	1	7	2	0	2
chr7:24698996:G:A	66	37	105	31	74	2.0	0.0	2.0
chr7:25155134:C:T	27	19	46	8	38	2	0	2
chr7:25226781:G:A	0	0	0	0	0	0	0	0
chr7:26646315:T:C	2	0	2	2	0	1.0	1.0	0.0
chr7:27182790:G:A	0	0	0	0	0	0	0	0
chr7:27662771:C:A	136	74	213	63	150	2.0	0.0	2.0
chr7:27787484:T:A	183	81	271	107	164	1	1	0
chr7:27833056:A:G	1	0	1	1	0	1	1	0
chr7:28956604:G:A	0	0	0	0	0	0	0	0
chr7:28957328:T:C	0	0	0	0	0	0	0	0
chr7:28958075:A:T	0	0	0	0	0	0	0	0
chr7:29030593:G:A	0	0	0	0	0	0	0	0
chr7:29030704:C:T	0	0	0	0	0	0	0	0
chr7:29146640:A:G	0	0	0	0	0	0	0	0
chr7:29888072:C:T	0	0	0	0	0	0	0	0
chr7:29990098:T:C	2	0	2	2	0	1.0	1.0	0.0
chr7:30074090:A:G	5	4	9	1	8	2	0	2
chr7:30078892:C:T	0	0	0	0	0	0	0	0
chr7:30451695:C:T	3	2	5	1	4	2	0	2
chr7:30452621:C:T	3	2	5	1	4	2	0	2
chr7:30452934:G:A	3	2	5	1	4	2	0	2
chr7:30456766:G:C	89	41	131	49	82	1	1	0
chr7:30595014:G:C	221	101	332	122	210	1	1	0
chr7:30595148:C:T	73	41	118	32	86	2	0	2
chr7:30655586:C:T	0	0	0	0	0	0	0	0
chr7:30699909:G:A	0	0	0	0	0	0	0	0
chr7:30700075:A:G	0	0	0	0	0	0	0	0
chr7:30752232:G:A	0	0	0	0	0	0	0	0
chr7:30755715:A:G	0	0	0	0	0	0	0	0
chr7:30791466:C:T	0	0	0	0	0	0	0	0
chr7:30969071:G:A	0	0	0	0	0	0	0	0
chr7:30969961:G:T	0	0	0	0	0	0	0	0
chr7:31106841:A:G	0	0	0	0	0	0	0	0
chr7:31707223:C:T	0	0	0	0	0	0	0	0
chr7:32169847:C:T	0	0	0	0	0	0	0	0
chr7:32869348:T:C	16	8	24	8	16	1.5	0.5	1.0
chr7:32974792:G:A	0	0	0	0	0	0	0	0
chr7:33099263:A:T	8	3	11	5	6	1.0	1.0	0.0
chr7:33605329:T:C	19	13	34	6	28	2	0	2
chr7:33605336:C:T	19	13	34	6	28	2	0	2
chr7:34085808:G:T	0	0	0	0	0	0	0	0
chr7:34658310:C:T	0	0	0	0	0	0	0	0
chr7:34658370:A:G	0	0	0	0	0	0	0	0
chr7:34878156:G:A	0	0	0	0	0	0	0	0
chr7:36299232:T:C	0	0	0	0	0	0	0	0
chr7:36406246:AG:CA	0	0	0	0	0	0	0	0
chr7:36513048:G:A	3	0	3	3	0	1	1	0
chr7:36724067:C:T	19	1	21	19	2	1	1	0
chr7:37896928:T:C	0	0	0	0	0	0	0	0
chr7:37907501:C:T	0	0	0	0	0	0	0	0
chr7:37907562:G:T	0	0	0	0	0	0	0	0
chr7:37912124:G:A	0	0	0	0	0	0	0	0
chr7:37914238:C:T	0	0	0	0	0	0	0	0
chr7:38391835:C:T	0	0	0	0	0	0	0	0
chr7:38391880:C:A	0	0	0	0	0	0	0	0
chr7:38726185:T:C	24	11	36	14	22	1.5	1.0	0.0
chr7:40860368:G:C	1	1	2	0	2	2	0	2
chr7:40860576:A:G	1	1	2	0	2	2	0	2
chr7:42048623:T:C	0	0	0	0	0	0	0	0
chr7:43552233:G:A	0	0	0	0	0	0	0	0
chr7:43608280:C:T	615	290	995	375	620	2	1	0
chr7:43624599:A:G	360	195	593	182	411	2.0	0.0	2.0
chr7:43624878:T:C	347	161	537	199	338	1	1	0
chr7:43877128:T:G	14	9	23	5	18	2.0	0.0	2.0
chr7:43877414:G:A	12	7	19	5	14	2.0	0.0	2.0
chr7:43877675:A:G	12	7	19	5	14	2.0	0.0	2.0
chr7:43952827:C:G	45	25	71	21	50	2	0	2
chr7:43965929:C:T	11	7	18	4	14	2	0	2
chr7:43987723:G:A	17	10	27	7	20	2	0	2
chr7:43987749:A:G	17	10	27	7	20	2	0	2
chr7:44000025:C:T	6	4	10	2	8	2.0	0.0	2.0
chr7:44029279:TGGA:CGGG	17	8	25	9	16	1	1	0
chr7:44034099:C:G	5	0	5	5	0	1	1	0
chr7:44050305:A:G	19	8	26	11	15	1	1	0
chr7:44058097:T:C	25	10	35	15	20	1	1	0
chr7:44058543:C:T	6	3	9	3	6	1.5	0.5	1.0
chr7:44060065:T:C	581	273	942	356	586	1	1	0
chr7:44073095:C:T	79	37	116	42	74	1	1	0
chr7:44073274:G:T	77	37	116	42	74	2	1	0
chr7:44074057:T:C	6	3	9	3	6	1.5	0.5	1.0
chr7:44074256:G:C	20	8	28	12	16	1.0	1.0	0.0
chr7:44082337:C:A	322	169	506	166	340	2.0	1.0	2.0
chr7:44107886:C:A	9	2	11	7	4	1	1	0
chr7:44114181:A:G	51	34	84	17	67	2	0	2
chr7:44146057:G:T	1	0	1	1	0	1	1	0
chr7:44220107:G:A	0	0	0	0	0	0	0	0
chr7:44220272:C:T	0	0	0	0	0	0	0	0
chr7:44243269:A:G	0	0	0	0	0	0	0	0
chr7:44243278:A:G	0	0	0	0	0	0	0	0
chr7:44404523:G:A	23	11	34	12	22	1	1	0
chr7:44490594:T:G	146	61	214	90	124	1.0	1.0	0.0
chr7:44513639:A:G	0	0	0	0	0	0	0	0
chr7:44515807:G:A	0	0	0	0	0	0	0	0
chr7:44566499:C:T	105	55	166	52	114	2	0	2
chr7:44581237:C:A	506	258	802	270	532	2.0	1.0	2.0
chr7:44760577:G:T	49	28	79	21	58	2	0	2
chr7:44969726:G:A	90	48	139	43	96	2.0	0.0	2.0
chr7:44970124:G:A	84	46	131	39	92	2.0	0.0	2.0
chr7:45027668:G:C	30	15	48	16	32	2.0	0.5	1.0
chr7:45068366:C:T	25	18	43	7	36	2	0	2
chr7:45073571:G:A	478	225	727	269	458	1.0	1.0	0.0
chr7:45082865:A:C	0	0	0	0	0	0	0	0
chr7:45085867:G:C	0	0	0	0	0	0	0	0
chr7:45086066:G:A	0	0	0	0	0	0	0	0
chr7:45101315:C:T	79	33	112	46	66	1	1	0
chr7:45101366:C:T	79	46	125	33	92	2	0	2
chr7:45183419:C:G	0	0	0	0	0	0	0	0
chr7:47368702:G:A	1	0	1	1	0	1	1	0
chr7:47808356:T:C	0	0	0	0	0	0	0	0
chr7:47873981:T:C	0	0	0	0	0	0	0	0
chr7:47929330:C:A	3	0	3	3	0	1	1	0
chr7:47931978:A:G	3	0	3	3	0	1	1	0
chr7:47965365:C:T	89	38	129	51	78	1	1	0
chr7:47978368:C:T	136	86	232	50	182	2.0	0.0	2.0
chr7:47978392:T:C	136	86	232	50	182	2.0	0.0	2.0
chr7:47978858:T:A	20	13	33	7	26	2.0	0.0	2.0
chr7:48041498:G:T	0	0	0	0	0	0	0	0
chr7:48245888:C:T	0	0	0	0	0	0	0	0
chr7:48524317:A:G	0	0	0	0	0	0	0	0
chr7:48847039:C:G	0	0	0	0	0	0	0	0
chr7:50540055:G:A	0	0	0	0	0	0	0	0
chr7:51028339:G:C	0	0	0	0	0	0	0	0
chr7:53035678:G:T	0	0	0	0	0	0	0	0
chr7:53035689:G:T	0	0	0	0	0	0	0	0
chr7:53035861:C:G	0	0	0	0	0	0	0	0
chr7:53035878:G:A	0	0	0	0	0	0	0	0
chr7:53035980:C:A	0	0	0	0	0	0	0	0
chr7:53036253:G:C	0	0	0	0	0	0	0	0
chr7:53036385:G:A	0	0	0	0	0	0	0	0
chr7:53188631:T:C	0	0	0	0	0	0	0	0
chr7:55165396:C:T	0	0	0	0	0	0	0	0
chr7:55170560:G:A	0	0	0	0	0	0	0	0
chr7:55170575:G:A	0	0	0	0	0	0	0	0
chr7:55171181:T:A	0	0	0	0	0	0	0	0
chr7:55181233:T:C	0	0	0	0	0	0	0	0
chr7:55391870:A:G	52	29	81	23	58	2.0	0.0	2.0
chr7:55428294:T:C	2	0	2	2	0	1.0	1.0	0.0
chr7:55682697:A:G	0	0	0	0	0	0	0	0
chr7:55923599:G:A	0	0	0	0	0	0	0	0
chr7:55954996:G:A	167	87	262	84	178	2	0	2
chr7:57121011:T:C	0	0	0	0	0	0	0	0
chr7:63560100:T:G	0	0	0	0	0	0	0	0
chr7:63562529:A:G	0	0	0	0	0	0	0	0
chr7:63580089:G:A	0	0	0	0	0	0	0	0
chr7:64207119:A:C	0	0	0	0	0	0	0	0
chr7:64219720:CC:TA	0	0	0	0	0	0	0	0
chr7:64219755:T:A	0	0	0	0	0	0	0	0
chr7:64562993:T:C	172	78	261	101	160	1.0	1.0	0.0
chr7:64794523:T:C	265	119	393	153	240	1	1	0
chr7:64831598:G:A	180	106	289	75	214	2.0	0.0	2.0
chr7:64979235:T:G	9	4	13	5	8	1	1	0
chr7:64992452:C:T	1	1	2	0	2	2	0	2
chr7:66988473:G:A	1338	742	2468	814	1654	2.0	1.0	2.0
chr7:67067248:A:G	1	0	1	1	0	1	1	0
chr7:67309617:G:C	79	38	119	41	78	1	1	0
chr7:70787199:A:G	0	0	0	0	0	0	0	0
chr7:71132898:G:A	0	0	0	0	0	0	0	0
chr7:72628972:A:G	3	1	4	2	2	1	1	0
chr7:72829753:A:G	464	261	769	222	547	2.0	0.0	2.0
chr7:73303936:T:C	97	41	143	59	84	1	1	0
chr7:73477424:C:T	57	26	85	33	52	1	1	0
chr7:73573024:C:T	1	0	1	1	0	1	1	0
chr7:73578528:C:G	88	56	148	32	116	2.0	0.0	2.0
chr7:73596730:C:T	0	0	0	0	0	0	0	0
chr7:73769649:G:A	0	0	0	0	0	0	0	0
chr7:74056384:G:A	0	0	0	0	0	0	0	0
chr7:74338920:T:C	0	0	0	0	0	0	0	0
chr7:74389314:T:A	0	0	0	0	0	0	0	0
chr7:74602296:A:G	0	0	0	0	0	0	0	0
chr7:75007959:C:T	0	0	0	0	0	0	0	0
chr7:75424216:G:A	17	10	27	7	20	2	0	2
chr7:75813412:T:G	0	0	0	0	0	0	0	0
chr7:75980359:A:G	50	24	73	26	47	1.0	1.0	0.0
chr7:75983485:C:T	1	1	2	0	2	2	0	2
chr7:75985688:C:T	62	31	93	32	61	1.5	1.0	0.5
chr7:76000956:T:C	126	67	176	60	116	1.0	0.0	1.0
chr7:76048186:C:T	964	494	1665	592	1073	2.0	1.0	2.0
chr7:76267275:G:A	0	0	0	0	0	0	0	0
chr7:76329871:G:A	69	30	103	41	62	1	1	0
chr7:76393900:T:G	0	0	0	0	0	0	0	0
chr7:76400378:C:T	0	0	0	0	0	0	0	0
chr7:76429450:G:T	0	0	0	0	0	0	0	0
chr7:76440494:T:C	8	3	11	5	6	1.0	1.0	0.0
chr7:76482518:G:A	32	13	45	19	26	1.0	1.0	0.0
chr7:76482743:C:T	32	13	45	19	26	1.0	1.0	0.0
chr7:76510869:T:C	1	0	1	1	0	1	1	0
chr7:76980778:C:T	14	7	21	7	14	1.5	0.5	1.0
chr7:77004920:G:A	1	0	1	1	0	1	1	0
chr7:77121935:C:G	46	33	83	13	70	2.0	0.0	2.0
chr7:77287502:G:A	2	0	2	2	0	1.0	1.0	0.0
chr7:77293173:C:T	3	0	3	3	0	1	1	0
chr7:80789373:A:G	0	0	0	0	0	0	0	0
chr7:81742840:A:G	0	0	0	0	0	0	0	0
chr7:82805717:C:T	0	0	0	0	0	0	0	0
chr7:82915671:A:G	0	0	0	0	0	0	0	0
chr7:82952543:C:T	0	0	0	0	0	0	0	0
chr7:82953530:C:T	0	0	0	0	0	0	0	0
chr7:83135109:C:G	0	0	0	0	0	0	0	0
chr7:83961536:T:C	0	0	0	0	0	0	0	0
chr7:84999673:T:G	0	0	0	0	0	0	0	0
chr7:85015184:C:T	0	0	0	0	0	0	0	0
chr7:86786671:C:T	0	0	0	0	0	0	0	0
chr7:87403297:A:G	2	1	3	1	2	1.5	0.5	1.0
chr7:87423834:A:G	7	2	9	5	4	1	1	0
chr7:87423890:G:A	7	2	9	5	4	1	1	0
chr7:87450090:T:A	27	10	37	17	20	1	1	0
chr7:87509329:A:G	0	0	0	0	0	0	0	0
chr7:87550285:A:G	1	0	1	1	0	1	1	0
chr7:87600877:A:G	4	1	5	3	2	1.0	1.0	0.0
chr7:87934962:A:C	0	0	0	0	0	0	0	0
chr7:87935182:C:G	2	2	4	0	4	2.0	0.0	2.0
chr7:88284046:C:T	0	0	0	0	0	0	0	0
chr7:90227294:C:T	0	0	0	0	0	0	0	0
chr7:90282987:G:A	0	0	0	0	0	0	0	0
chr7:90355095:A:G	51	12	65	39	26	1	1	0
chr7:90385094:G:A	118	50	173	73	100	1.0	1.0	0.0
chr7:93994146:A:G	45	21	67	25	42	1	1	0
chr7:95308134:T:C	2	0	2	2	0	1.0	1.0	0.0
chr7:95372243:C:T	0	0	0	0	0	0	0	0
chr7:95394734:A:G	0	0	0	0	0	0	0	0
chr7:95396288:G:A	0	0	0	0	0	0	0	0
chr7:95869922:A:G	1	0	1	1	0	1	1	0
chr7:97734160:C:G	0	0	0	0	0	0	0	0
chr7:98217728:G:A	15	11	26	4	22	2	0	2
chr7:98223087:G:A	10	7	17	3	14	2.0	0.0	2.0
chr7:98244682:G:A	12	6	18	6	12	1.5	0.5	1.0
chr7:98307946:T:C	0	0	0	0	0	0	0	0
chr7:99008483:C:T	8	4	12	4	8	1.5	0.5	1.0
chr7:99047749:G:A	20	9	29	11	18	1.0	1.0	0.0
chr7:99861633:C:T	0	0	0	0	0	0	0	0
chr7:99986027:G:A	0	0	0	0	0	0	0	0
chr7:100099174:T:C	27	11	38	16	22	1	1	0
chr7:100102003:T:C	22	14	38	8	30	2.0	0.0	2.0
chr7:100107173:A:T	120	52	175	71	104	1.0	1.0	0.0
chr7:100107204:A:G	119	52	174	70	104	1	1	0
chr7:100110089:A:G	17	7	24	10	14	1	1	0
chr7:100110327:C:T	3	0	3	3	0	1	1	0
chr7:100113417:G:A	3	2	5	1	4	2	0	2
chr7:100149507:G:A	2064	1194	4184	1369	2815	2.0	1.0	2.0
chr7:100155498:A:G	1	0	1	1	0	1	1	0
chr7:100159989:G:A	4	2	6	2	4	1.5	0.5	1.0
chr7:100160513:T:G	4	3	7	1	6	2.0	0.0	2.0
chr7:100198523:A:C	4	3	7	1	6	2.0	0.0	2.0
chr7:100199408:C:G	5	3	8	2	6	2	0	2
chr7:100202222:T:A	3	2	5	1	4	2	0	2
chr7:100220236:A:G	132	55	191	79	112	1.0	1.0	0.0
chr7:100220514:G:A	15	6	23	11	12	1	1	0
chr7:100224062:C:T	10	4	14	6	8	1.0	1.0	0.0
chr7:100684145:T:C	2	1	3	1	2	1.5	0.5	1.0
chr7:100755399:G:A	0	0	0	0	0	0	0	0
chr7:100758262:C:T	0	0	0	0	0	0	0	0
chr7:100779460:T:C	0	0	0	0	0	0	0	0
chr7:100793959:T:C	0	0	0	0	0	0	0	0
chr7:100797381:G:C	0	0	0	0	0	0	0	0
chr7:100812975:G:A	1	0	1	1	0	1	1	0
chr7:100818628:A:G	0	0	0	0	0	0	0	0
chr7:100858973:G:A	1	1	2	0	2	2	0	2
chr7:100858989:G:C	1	1	2	0	2	2	0	2
chr7:100861173:T:C	39	21	60	18	42	2	0	2
chr7:100870662:A:G	99	61	160	38	122	2	0	2
chr7:100884405:T:C	118	63	193	61	132	2.0	0.0	2.0
chr7:100886110:A:G	2	1	3	1	2	1.5	0.5	1.0
chr7:100886760:T:G	4	4	8	0	8	2.0	0.0	2.0
chr7:100888664:G:T	39	0	39	39	0	1	1	0
chr7:100889035:T:G	1	0	1	1	0	1	1	0
chr7:100889133:G:C	2	0	2	2	0	1.0	1.0	0.0
chr7:100891037:G:C	0	0	0	0	0	0	0	0
chr7:100955225:T:A	0	0	0	0	0	0	0	0
chr7:100964852:A:G	0	0	0	0	0	0	0	0
chr7:100965208:C:T	0	0	0	0	0	0	0	0
chr7:100965216:G:C	0	0	0	0	0	0	0	0
chr7:100965345:C:A	0	0	0	0	0	0	0	0
chr7:100966333:G:C	0	0	0	0	0	0	0	0
chr7:100991195:C:G	0	0	0	0	0	0	0	0
chr7:100991359:T:G	0	0	0	0	0	0	0	0
chr7:101004639:A:C	0	0	0	0	0	0	0	0
chr7:101004748:G:A	0	0	0	0	0	0	0	0
chr7:101004836:C:G	0	0	0	0	0	0	0	0
chr7:101032695:G:A	0	0	0	0	0	0	0	0
chr7:101034805:T:C	0	0	0	0	0	0	0	0
chr7:101036621:A:G	0	0	0	0	0	0	0	0
chr7:101038078:C:G	0	0	0	0	0	0	0	0
chr7:101038481:A:G	0	0	0	0	0	0	0	0
chr7:101088548:T:C	16	9	25	7	18	2.0	0.0	2.0
chr7:101557447:G:A	0	0	0	0	0	0	0	0
chr7:102111780:A:G	36	26	62	10	52	2.0	0.0	2.0
chr7:102193869:G:A	12	7	19	5	14	2.0	0.0	2.0
chr7:102201571:A:G	0	0	0	0	0	0	0	0
chr7:102327280:A:C	0	0	0	0	0	0	0	0
chr7:102425204:C:T	103	58	166	46	120	2	0	2
chr7:102457563:G:A	53	38	91	16	75	2	0	2
chr7:102467705:C:T	2	1	3	1	2	1.5	0.5	1.0
chr7:102469919:T:A	0	0	0	0	0	0	0	0
chr7:102472533:G:A	53	24	78	30	48	1	1	0
chr7:102472646:T:C	1	0	1	1	0	1	1	0
chr7:102472779:C:T	54	30	85	25	60	2.0	0.0	2.0
chr7:102472809:T:C	1	0	1	1	0	1	1	0
chr7:102473640:C:T	1020	514	1712	617	1095	2.0	1.0	2.0
chr7:102478875:T:C	1004	557	1735	541	1194	2.0	1.0	2.0
chr7:102572648:G:T	7	4	11	3	8	2	0	2
chr7:102822189:T:C	2	1	3	1	2	1.5	0.5	1.0
chr7:102934473:G:C	0	0	0	0	0	0	0	0
chr7:102975904:C:T	0	0	0	0	0	0	0	0
chr7:102976068:G:A	0	0	0	0	0	0	0	0
chr7:103515417:A:G	0	0	0	0	0	0	0	0
chr7:103540425:A:G	0	0	0	0	0	0	0	0
chr7:104207965:G:C	63	35	100	30	70	2	0	2
chr7:105109057:A:G	28	12	41	17	24	1.0	1.0	0.0
chr7:105613638:T:C	1	1	2	0	2	2	0	2
chr7:105974960:G:A	0	0	0	0	0	0	0	0
chr7:105974980:G:C	0	0	0	0	0	0	0	0
chr7:105981066:G:T	0	0	0	0	0	0	0	0
chr7:106022244:T:C	0	0	0	0	0	0	0	0
chr7:107577588:T:C	20	8	28	12	16	1.0	1.0	0.0
chr7:107929072:A:G	3	2	5	1	4	2	0	2
chr7:107940394:A:G	0	0	0	0	0	0	0	0
chr7:107953544:T:C	0	0	0	0	0	0	0	0
chr7:108098437:G:A	0	0	0	0	0	0	0	0
chr7:108098503:G:A	0	0	0	0	0	0	0	0
chr7:108103219:A:G	0	0	0	0	0	0	0	0
chr7:108209464:G:A	0	0	0	0	0	0	0	0
chr7:108571909:G:A	236	122	365	117	248	2.0	0.0	2.0
chr7:108572918:T:C	230	110	346	122	224	1.0	1.0	0.0
chr7:112462300:T:G	55	25	80	30	50	1	1	0
chr7:112467944:T:C	1	1	2	0	2	2	0	2
chr7:112472224:G:A	99	47	146	52	94	1	1	0
chr7:112489954:A:C	1	1	2	0	2	2	0	2
chr7:113084740:G:T	0	0	0	0	0	0	0	0
chr7:116500221:T:C	0	0	0	0	0	0	0	0
chr7:116795714:C:T	0	0	0	0	0	0	0	0
chr7:116795968:G:A	0	0	0	0	0	0	0	0
chr7:116796043:G:A	0	0	0	0	0	0	0	0
chr7:120788553:G:A	0	0	0	0	0	0	0	0
chr7:120788745:C:A	0	0	0	0	0	0	0	0
chr7:120970847:C:T	34	21	55	13	42	2.0	0.0	2.0
chr7:121329715:G:A	430	240	727	227	500	2.0	0.0	2.0
chr7:121339035:C:T	19	11	30	8	22	2	0	2
chr7:121976196:G:A	0	0	0	0	0	0	0	0
chr7:122013344:G:A	0	0	0	0	0	0	0	0
chr7:122304225:G:A	0	0	0	0	0	0	0	0
chr7:122304473:T:C	0	0	0	0	0	0	0	0
chr7:122438360:T:G	0	0	0	0	0	0	0	0
chr7:122994970:C:T	0	0	0	0	0	0	0	0
chr7:123874842:G:T	0	0	0	0	0	0	0	0
chr7:124747038:C:G	0	0	0	0	0	0	0	0
chr7:124777459:C:A	0	0	0	0	0	0	0	0
chr7:124858948:AT:CA	1	1	2	0	2	2	0	2
chr7:127582103:G:A	8	5	13	3	10	2.0	0.0	2.0
chr7:127584232:A:G	12	5	17	7	10	1.0	1.0	0.0
chr7:127584818:G:A	25	16	41	9	32	2	0	2
chr7:127589644:G:A	125	68	195	59	136	2	0	2
chr7:127611134:T:G	0	0	0	0	0	0	0	0
chr7:127611738:G:A	0	0	0	0	0	0	0	0
chr7:127615231:C:G	0	0	0	0	0	0	0	0
chr7:128029531:T:C	0	0	0	0	0	0	0	0
chr7:128029804:A:T	0	0	0	0	0	0	0	0
chr7:128081455:T:C	104	52	160	56	104	1.5	1.0	1.0
chr7:128325871:T:G	14	6	20	8	12	1.0	1.0	0.0
chr7:128476994:C:G	33	20	53	13	40	2	0	2
chr7:128672396:C:T	0	0	0	0	0	0	0	0
chr7:128719079:C:T	0	0	0	0	0	0	0	0
chr7:128807554:C:T	0	0	0	0	0	0	0	0
chr7:128892926:T:C	0	0	0	0	0	0	0	0
chr7:128894224:C:T	0	0	0	0	0	0	0	0
chr7:128914021:C:T	0	0	0	0	0	0	0	0
chr7:128942202:A:C	63	20	84	44	40	1	1	0
chr7:128967330:G:A	21	9	30	12	18	1	1	0
chr7:128972498:C:T	26	13	39	13	26	1.5	0.5	1.0
chr7:128974936:G:A	25	13	38	12	26	2	0	2
chr7:129657492:T:G	91	39	130	52	78	1	1	0
chr7:130023656:C:T	28	14	42	14	28	1.5	0.5	1.0
chr7:130308173:G:T	0	0	0	0	0	0	0	0
chr7:130310900:G:T	0	0	0	0	0	0	0	0
chr7:130346497:C:T	0	0	0	0	0	0	0	0
chr7:130350037:T:C	0	0	0	0	0	0	0	0
chr7:130381647:G:C	0	0	0	0	0	0	0	0
chr7:130440971:T:G	39	26	65	13	52	2	0	2
chr7:130500925:C:A	4	0	4	4	0	1.0	1.0	0.0
chr7:130505102:G:C	43	13	56	30	26	1	1	0
chr7:130550642:C:T	27	9	37	19	18	1	1	0
chr7:130669266:G:C	0	0	0	0	0	0	0	0
chr7:131506777:A:G	1	1	2	0	2	2	0	2
chr7:131509104:G:C	0	0	0	0	0	0	0	0
chr7:131509126:C:T	0	0	0	0	0	0	0	0
chr7:131510953:G:A	0	0	0	0	0	0	0	0
chr7:131511200:C:T	0	0	0	0	0	0	0	0
chr7:131511303:C:T	0	0	0	0	0	0	0	0
chr7:132179832:T:C	0	0	0	0	0	0	0	0
chr7:132507536:G:A	0	0	0	0	0	0	0	0
chr7:132508190:T:C	0	0	0	0	0	0	0	0
chr7:133081944:G:T	407	194	628	230	398	1	1	0
chr7:133895694:G:A	27	14	41	13	28	2	0	2
chr7:134064411:G:A	9	4	13	5	8	1	1	0
chr7:134294793:A:T	11	5	16	6	10	1	1	0
chr7:134294800:C:T	11	5	16	6	10	1	1	0
chr7:134294826:A:G	11	5	16	6	10	1	1	0
chr7:134295043:T:C	8	5	13	3	10	2.0	0.0	2.0
chr7:134451467:G:T	3	0	3	3	0	1	1	0
chr7:135129101:G:A	0	0	0	0	0	0	0	0
chr7:135164461:G:A	32	16	48	16	32	1.5	0.5	1.0
chr7:135164825:A:C	31	16	47	15	32	2	0	2
chr7:135444838:T:C	3	2	5	1	4	2	0	2
chr7:135594567:A:C	2	2	4	0	4	2.0	0.0	2.0
chr7:135721428:A:G	0	0	0	0	0	0	0	0
chr7:137915944:C:T	265	141	421	129	292	2	0	2
chr7:138580565:A:G	5	3	8	2	6	2	0	2
chr7:138596610:A:G	1	0	1	1	0	1	1	0
chr7:138771243:A:G	0	0	0	0	0	0	0	0
chr7:139076288:G:C	79	41	121	40	81	2	1	2
chr7:139079314:G:A	12	7	19	5	14	2.0	0.0	2.0
chr7:139079399:T:C	12	7	19	5	14	2.0	0.0	2.0
chr7:139079487:C:T	82	43	125	40	85	2.0	0.0	2.0
chr7:140024558:G:A	40	25	69	15	54	2.0	0.0	2.0
chr7:140024755:C:T	38	23	65	15	50	2.0	0.0	2.0
chr7:140027335:G:A	11	5	15	6	9	1	1	0
chr7:140382563:G:A	35	22	62	14	48	2	0	2
chr7:140425950:T:C	0	0	0	0	0	0	0	0
chr7:140459051:C:G	182	93	278	90	188	2.0	0.0	2.0
chr7:140518664:C:A	0	0	0	0	0	0	0	0
chr7:140544760:C:T	0	0	0	0	0	0	0	0
chr7:140558200:T:C	0	0	0	0	0	0	0	0
chr7:140601931:G:T	0	0	0	0	0	0	0	0
chr7:140673526:A:G	16	13	29	3	26	2.0	0.0	2.0
chr7:140674249:T:C	17	14	31	3	28	2	0	2
chr7:140694787:C:T	46	23	70	24	46	1.5	1.0	1.0
chr7:141074667:C:G	2	2	4	0	4	2.0	0.0	2.0
chr7:141664912:G:A	3	1	4	2	2	1	1	0
chr7:142052413:C:A	0	0	0	0	0	0	0	0
chr7:142172723:T:A	0	0	0	0	0	0	0	0
chr7:142252290:A:G	0	0	0	0	0	0	0	0
chr7:142957921:G:A	0	0	0	0	0	0	0	0
chr7:143139110:A:T	0	0	0	0	0	0	0	0
chr7:143391730:T:C	2	1	3	1	2	1.5	0.5	1.0
chr7:143391774:T:C	2	1	3	1	2	1.5	0.5	1.0
chr7:143400007:A:G	0	0	0	0	0	0	0	0
chr7:143444382:T:C	0	0	0	0	0	0	0	0
chr7:143478061:G:A	0	0	0	0	0	0	0	0
chr7:143478252:C:T	0	0	0	0	0	0	0	0
chr7:143511121:C:A	0	0	0	0	0	0	0	0
chr7:143511875:A:G	0	0	0	0	0	0	0	0
chr7:144050777:A:G	0	0	0	0	0	0	0	0
chr7:144051005:G:T	0	0	0	0	0	0	0	0
chr7:144051164:G:A	0	0	0	0	0	0	0	0
chr7:144051271:T:C	0	0	0	0	0	0	0	0
chr7:144074443:G:A	0	0	0	0	0	0	0	0
chr7:144074844:G:C	0	0	0	0	0	0	0	0
chr7:144095898:G:A	0	0	0	0	0	0	0	0
chr7:144109595:C:A	0	0	0	0	0	0	0	0
chr7:144110211:T:C	0	0	0	0	0	0	0	0
chr7:144129510:G:T	0	0	0	0	0	0	0	0
chr7:144259649:C:G	0	0	0	0	0	0	0	0
chr7:144267174:A:G	0	0	0	0	0	0	0	0
chr7:148615428:T:C	0	0	0	0	0	0	0	0
chr7:149003757:C:T	189	81	275	111	164	1	1	0
chr7:149103999:G:A	3	1	4	2	2	1	1	0
chr7:149104245:T:C	3	2	5	1	4	2	0	2
chr7:149104566:C:T	3	1	4	2	2	1	1	0
chr7:149154121:G:A	25	17	42	8	34	2	0	2
chr7:149436825:C:T	2	0	2	2	0	1.0	1.0	0.0
chr7:149455679:A:G	2	1	3	1	2	1.5	0.5	1.0
chr7:149621318:T:C	111	50	163	61	102	1	1	0
chr7:149731722:G:A	2	2	4	0	4	2.0	0.0	2.0
chr7:149764685:G:T	0	0	0	0	0	0	0	0
chr7:149765434:C:G	0	0	0	0	0	0	0	0
chr7:149777304:A:G	0	0	0	0	0	0	0	0
chr7:149778837:G:A	0	0	0	0	0	0	0	0
chr7:149787710:C:T	0	0	0	0	0	0	0	0
chr7:149832881:G:T	0	0	0	0	0	0	0	0
chr7:149859429:C:T	0	0	0	0	0	0	0	0
chr7:149861320:G:C	0	0	0	0	0	0	0	0
chr7:149862184:C:T	1	0	1	1	0	1	1	0
chr7:149862376:C:T	1	0	1	1	0	1	1	0
chr7:149878795:T:C	13	7	20	6	14	2	0	2
chr7:149879729:A:G	125	61	189	65	124	1	1	0
chr7:150466749:A:G	0	0	0	0	0	0	0	0
chr7:150467067:T:C	0	0	0	0	0	0	0	0
chr7:150474622:T:C	0	0	0	0	0	0	0	0
chr7:150520001:G:A	0	0	0	0	0	0	0	0
chr7:150572829:G:A	0	0	0	0	0	0	0	0
chr7:150742661:A:G	0	0	0	0	0	0	0	0
chr7:150791528:A:G	2	0	2	2	0	1.0	1.0	0.0
chr7:150793288:C:T	2	0	2	2	0	1.0	1.0	0.0
chr7:150793996:T:G	2	0	2	2	0	1.0	1.0	0.0
chr7:150801721:G:A	0	0	0	0	0	0	0	0
chr7:150802179:C:A	0	0	0	0	0	0	0	0
chr7:150804367:G:T	0	0	0	0	0	0	0	0
chr7:150804987:G:C	0	0	0	0	0	0	0	0
chr7:151028635:A:C	126	61	187	65	122	1.0	1.0	0.0
chr7:151050850:C:A	1	0	1	1	0	1	1	0
chr7:151064593:C:A	7	3	11	5	6	2	1	0
chr7:151066568:T:A	6	3	9	3	6	1.5	0.5	1.0
chr7:151071699:G:A	12	7	19	5	14	2.0	0.0	2.0
chr7:151075985:G:C	3	2	5	1	4	2	0	2
chr7:151076720:A:T	203	93	304	115	189	1	1	0
chr7:151181173:C:G	0	0	0	0	0	0	0	0
chr7:151219142:G:A	75	37	112	38	74	1	1	0
chr7:151224864:A:G	97	50	148	48	100	2	0	2
chr7:151233879:C:T	28	16	44	12	32	2.0	0.0	2.0
chr7:151234182:C:G	28	16	44	12	32	2.0	0.0	2.0
chr7:151237889:C:G	41	20	62	22	40	2	1	0
chr7:152229936:C:A	22	0	22	22	0	1.0	1.0	0.0
chr7:152229941:T:C	22	0	22	22	0	1.0	1.0	0.0
chr7:152273771:T:A	52	0	52	52	0	1.0	1.0	0.0
chr7:152814513:C:T	2	0	2	2	0	1.0	1.0	0.0
chr7:154880936:T:C	0	0	0	0	0	0	0	0
chr7:154880969:A:T	0	0	0	0	0	0	0	0
chr7:154880993:G:A	0	0	0	0	0	0	0	0
chr7:154881007:G:A	0	0	0	0	0	0	0	0
chr7:154892443:T:C	0	0	0	0	0	0	0	0
chr7:154944240:C:T	24	10	34	14	20	1.0	1.0	0.0
chr7:154946699:T:C	21	9	30	12	18	1	1	0
chr7:154968956:C:T	10	5	15	5	10	1.5	0.5	1.0
chr7:155070942:C:T	0	0	0	0	0	0	0	0
chr7:155509086:A:G	0	0	0	0	0	0	0	0
chr7:155806606:C:T	0	0	0	0	0	0	0	0
chr7:155963132:A:G	0	0	0	0	0	0	0	0
chr7:156676402:C:T	4	2	6	2	4	1.5	0.5	1.0
chr7:156676439:C:G	16	3	19	13	6	1.0	1.0	0.0
chr7:156676485:C:T	16	3	19	13	6	1.0	1.0	0.0
chr7:156676496:A:G	16	3	19	13	6	1.0	1.0	0.0
chr7:156683989:T:A	15	5	20	10	10	1	1	0
chr7:157604005:G:A	0	0	0	0	0	0	0	0
chr7:157621372:G:A	0	0	0	0	0	0	0	0
chr7:158110846:A:G	0	0	0	0	0	0	0	0
chr7:158167187:C:T	0	0	0	0	0	0	0	0
chr7:158167203:C:T	0	0	0	0	0	0	0	0
chr7:158734189:G:A	5	4	9	1	8	2	0	2
chr7:158735542:A:G	6	5	11	1	10	2.0	0.0	2.0
chr7:158741681:G:A	6	5	11	1	10	2.0	0.0	2.0
chr7:158741690:G:C	5	5	10	0	10	2	0	2
chr7:158743576:T:C	7	5	12	2	10	2	0	2
chr8:246274:T:G	3	2	5	1	4	2	0	2
chr8:492389:G:A	0	0	0	0	0	0	0	0
chr8:1668552:A:G	0	0	0	0	0	0	0	0
chr8:1678361:C:A	0	0	0	0	0	0	0	0
chr8:1858063:A:C	22	9	31	13	18	1.0	1.0	0.0
chr8:1909382:T:C	0	0	0	0	0	0	0	0
chr8:1956966:G:A	1	0	1	1	0	1	1	0
chr8:2073341:G:T	0	0	0	0	0	0	0	0
chr8:2090010:C:G	0	0	0	0	0	0	0	0
chr8:2090052:G:A	0	0	0	0	0	0	0	0
chr8:2101041:G:A	0	0	0	0	0	0	0	0
chr8:2102729:C:T	0	0	0	0	0	0	0	0
chr8:2963223:G:C	0	0	0	0	0	0	0	0
chr8:3106684:T:C	0	0	0	0	0	0	0	0
chr8:3107722:T:C	0	0	0	0	0	0	0	0
chr8:3367039:T:C	0	0	0	0	0	0	0	0
chr8:3396246:C:T	0	0	0	0	0	0	0	0
chr8:3408068:C:T	0	0	0	0	0	0	0	0
chr8:6445504:G:A	80	45	128	36	92	2.0	0.0	2.0
chr8:6532368:C:G	16	6	23	11	12	1.0	1.0	0.0
chr8:6621657:C:A	13	8	21	5	16	2	0	2
chr8:6708665:G:A	772	231	1121	624	497	1.0	1.0	0.0
chr8:6877877:C:T	0	0	0	0	0	0	0	0
chr8:6877909:C:T	0	0	0	0	0	0	0	0
chr8:6936018:C:T	0	0	0	0	0	0	0	0
chr8:7297395:A:C	0	0	0	0	0	0	0	0
chr8:9556539:G:A	127	59	190	72	118	1	1	0
chr8:9556649:G:C	26	12	38	14	24	1.0	1.0	0.0
chr8:9706927:A:G	40	26	68	14	54	2.0	0.0	2.0
chr8:9751821:G:A	13	7	20	6	14	2	0	2
chr8:10532942:C:T	0	0	0	0	0	0	0	0
chr8:10538544:A:C	0	0	0	0	0	0	0	0
chr8:10610078:TT:CC	0	0	0	0	0	0	0	0
chr8:10611277:T:C	0	0	0	0	0	0	0	0
chr8:10611782:C:T	0	0	0	0	0	0	0	0
chr8:10612778:G:A	0	0	0	0	0	0	0	0
chr8:10725693:A:G	1	0	1	1	0	1	1	0
chr8:11285116:T:C	42	20	63	23	40	1.5	1.0	0.0
chr8:11304987:A:C	7	4	11	3	8	2	0	2
chr8:11319863:T:C	3	2	5	1	4	2	0	2
chr8:11319901:G:A	3	1	4	2	2	1	1	0
chr8:11331031:A:G	1	0	1	1	0	1	1	0
chr8:11331077:C:T	1	0	1	1	0	1	1	0
chr8:11331194:C:T	2	1	3	1	2	1.5	0.5	1.0
chr8:11331234:C:T	2	1	3	1	2	1.5	0.5	1.0
chr8:11331243:G:A	2	1	3	1	2	1.5	0.5	1.0
chr8:11331835:C:G	4	1	5	3	2	1.0	1.0	0.0
chr8:11332024:A:C	5	1	6	4	2	1	1	0
chr8:11332026:T:C	5	4	9	1	8	2	0	2
chr8:11444552:A:G	3	0	3	3	0	1	1	0
chr8:11549084:T:C	441	239	727	232	495	2	1	2
chr8:11556728:T:C	448	226	727	253	474	2.0	1.0	2.0
chr8:11561257:G:A	41	26	67	15	52	2	0	2
chr8:11561264:C:T	41	15	56	27	29	1	1	0
chr8:11756807:T:C	0	0	0	0	0	0	0	0
chr8:11761995:T:A	0	0	0	0	0	0	0	0
chr8:11831610:G:C	423	184	664	286	378	1	1	0
chr8:11848168:C:G	0	0	0	0	0	0	0	0
chr8:11849072:T:G	90	51	142	41	101	2.0	0.0	2.0
chr8:11850846:G:A	14	6	20	8	12	1.0	1.0	0.0
chr8:11853379:G:C	104	57	163	50	113	2.0	0.0	2.0
chr8:12379209:G:A	0	0	0	0	0	0	0	0
chr8:12415267:C:T	0	0	0	0	0	0	0	0
chr8:13099966:C:T	0	0	0	0	0	0	0	0
chr8:13100516:C:A	0	0	0	0	0	0	0	0
chr8:17210065:C:T	10	8	18	2	16	2.0	0.0	2.0
chr8:17284556:C:T	62	31	94	32	62	2.0	0.5	1.0
chr8:17286511:C:A	22	12	35	11	24	2.0	0.0	2.0
chr8:17646103:C:G	0	0	0	0	0	0	0	0
chr8:17754377:G:A	0	0	0	0	0	0	0	0
chr8:17755009:A:G	0	0	0	0	0	0	0	0
chr8:17868510:A:G	0	0	0	0	0	0	0	0
chr8:17874575:GC:CA	0	0	0	0	0	0	0	0
chr8:17882029:T:C	0	0	0	0	0	0	0	0
chr8:17938873:AC:GT	257	100	360	160	200	1	1	0
chr8:18057410:A:T	159	80	241	82	159	1	1	1
chr8:18063114:C:T	10	6	16	4	12	2.0	0.0	2.0
chr8:18400344:T:C	0	0	0	0	0	0	0	0
chr8:18867918:A:G	8	1	9	7	2	1.0	1.0	0.0
chr8:18871949:T:C	10	1	11	9	2	1.0	1.0	0.0
chr8:18872019:C:G	10	1	11	9	2	1.0	1.0	0.0
chr8:19313717:G:A	18	0	18	18	0	1.0	1.0	0.0
chr8:19332980:A:G	56	0	58	58	0	1.0	1.0	0.0
chr8:19458575:G:A	0	0	0	0	0	0	0	0
chr8:19505257:C:T	0	0	0	0	0	0	0	0
chr8:19505914:C:T	0	0	0	0	0	0	0	0
chr8:19824089:A:G	10	5	17	5	12	1.5	0.5	1.0
chr8:20179202:A:G	0	0	0	0	0	0	0	0
chr8:20179316:C:G	0	0	0	0	0	0	0	0
chr8:20253130:C:T	0	0	0	0	0	0	0	0
chr8:21693326:C:T	5	4	9	1	8	2	0	2
chr8:21909764:C:G	102	76	181	27	154	2.0	0.0	2.0
chr8:21990344:G:C	33	14	43	19	24	1	1	0
chr8:22005040:A:G	21	10	31	11	20	1	1	0
chr8:22048261:G:C	0	0	0	0	0	0	0	0
chr8:22094715:T:C	9	4	13	5	8	1	1	0
chr8:22097605:C:T	10	4	14	6	8	1.0	1.0	0.0
chr8:22098041:T:C	0	0	0	0	0	0	0	0
chr8:22098597:A:G	10	4	14	6	8	1.0	1.0	0.0
chr8:22102585:C:T	22	9	31	13	18	1.0	1.0	0.0
chr8:22107291:C:T	42	21	64	22	42	2.0	0.5	1.0
chr8:22125478:T:C	0	0	0	0	0	0	0	0
chr8:22125484:A:G	0	0	0	0	0	0	0	0
chr8:22127137:A:G	0	0	0	0	0	0	0	0
chr8:22127252:C:T	0	0	0	0	0	0	0	0
chr8:22140225:A:T	37	13	51	25	26	1	1	0
chr8:22154274:C:T	0	0	0	0	0	0	0	0
chr8:22163524:C:A	0	0	0	0	0	0	0	0
chr8:22163776:C:T	0	0	0	0	0	0	0	0
chr8:22163875:C:G	0	0	0	0	0	0	0	0
chr8:22164004:G:A	0	0	0	0	0	0	0	0
chr8:22404808:T:C	4	1	5	3	2	1.0	1.0	0.0
chr8:22404866:C:T	4	1	5	3	2	1.0	1.0	0.0
chr8:22404905:A:G	4	1	5	3	2	1.0	1.0	0.0
chr8:22416174:T:C	3	1	4	2	2	1	1	0
chr8:22585148:A:G	238	122	375	124	251	2.0	1.0	2.0
chr8:22602691:A:G	0	0	0	0	0	0	0	0
chr8:22614279:A:G	26	12	38	14	24	1.0	1.0	0.0
chr8:22614311:G:A	25	14	38	11	27	2	0	2
chr8:22615645:C:T	7	5	12	2	10	2	0	2
chr8:22615952:T:C	9	6	16	4	12	2	0	2
chr8:22616337:T:C	7	4	11	3	8	2	0	2
chr8:22623936:A:G	41	18	59	23	36	1	1	0
chr8:22629875:C:G	2	2	4	0	4	2.0	0.0	2.0
chr8:22629909:T:C	2	2	4	0	4	2.0	0.0	2.0
chr8:22669046:G:A	49	29	78	20	58	2	0	2
chr8:22713331:G:A	1	1	2	0	2	2	0	2
chr8:22713422:T:C	1	1	2	0	2	2	0	2
chr8:22713505:A:G	1	1	2	0	2	2	0	2
chr8:23144475:A:G	5	3	8	2	6	2	0	2
chr8:23144594:C:T	5	3	8	2	6	2	0	2
chr8:23260130:T:C	33	16	52	18	34	1	1	0
chr8:23260642:T:C	125	68	194	59	135	2	0	2
chr8:23294821:A:G	144	70	214	74	140	1.0	1.0	0.0
chr8:23333428:T:C	0	0	0	0	0	0	0	0
chr8:23368232:C:T	0	0	0	0	0	0	0	0
chr8:23432938:C:T	51	17	69	35	34	1	1	0
chr8:23434566:G:C	9	4	13	5	8	1	1	0
chr8:23435472:A:G	42	18	60	24	36	1.0	1.0	0.0
chr8:23566156:A:G	383	189	606	220	386	2	1	0
chr8:25302369:G:A	0	0	0	0	0	0	0	0
chr8:25410106:A:G	0	0	0	0	0	0	0	0
chr8:25423284:C:G	2	1	3	1	2	1.5	0.5	1.0
chr8:25429881:T:C	28	16	44	12	32	2.0	0.0	2.0
chr8:25460308:A:T	1	0	1	1	0	1	1	0
chr8:25507318:A:T	0	0	0	0	0	0	0	0
chr8:25507444:A:G	0	0	0	0	0	0	0	0
chr8:25507762:G:A	0	0	0	0	0	0	0	0
chr8:26383130:A:G	490	242	767	273	494	2.0	1.0	0.0
chr8:26508200:C:T	5	1	6	4	2	1	1	0
chr8:26653276:T:C	6	2	8	4	4	1.0	1.0	0.0
chr8:27011600:G:A	0	0	0	0	0	0	0	0
chr8:27420020:G:A	26	15	41	11	30	2.0	0.0	2.0
chr8:27436348:C:T	17	11	28	6	22	2	0	2
chr8:27451068:A:C	46	17	63	29	34	1.0	1.0	0.0
chr8:27544447:A:C	9	0	9	9	0	1	1	0
chr8:27544557:A:G	9	0	9	9	0	1	1	0
chr8:27604964:A:G	0	0	0	0	0	0	0	0
chr8:27736133:T:C	57	38	95	19	76	2	0	2
chr8:27776547:C:T	1	0	1	1	0	1	1	0
chr8:27871776:C:T	0	0	0	0	0	0	0	0
chr8:27871889:G:C	0	0	0	0	0	0	0	0
chr8:27872015:G:A	0	0	0	0	0	0	0	0
chr8:27909714:C:G	0	0	0	0	0	0	0	0
chr8:27921779:G:A	0	0	0	0	0	0	0	0
chr8:27922028:C:T	0	0	0	0	0	0	0	0
chr8:28029386:C:T	1	0	1	1	0	1	1	0
chr8:28045552:C:T	3	3	6	0	6	2	0	2
chr8:28129489:A:T	3	2	4	1	3	1	0	1
chr8:28428607:C:G	0	0	0	0	0	0	0	0
chr8:28527195:A:G	61	34	94	27	67	2	0	2
chr8:28717286:G:A	0	0	0	0	0	0	0	0
chr8:28743055:G:C	0	0	0	0	0	0	0	0
chr8:29190960:C:T	3	1	4	2	2	1	1	0
chr8:30352758:T:C	0	0	0	0	0	0	0	0
chr8:30689259:C:T	19	6	25	13	12	1	1	0
chr8:31167122:C:T	3	1	4	2	2	1	1	0
chr8:32756465:T:C	0	0	0	0	0	0	0	0
chr8:33498556:A:G	11	6	17	5	12	2	0	2
chr8:33512426:T:C	15	7	22	8	14	1	1	0
chr8:33512476:A:G	15	7	22	8	14	1	1	0
chr8:33551383:C:G	16	9	25	7	18	2.0	0.0	2.0
chr8:33558671:G:A	35	18	54	17	37	1	0	1
chr8:37872938:G:T	20	9	29	11	18	1.0	1.0	0.0
chr8:38238144:C:T	228	124	359	109	250	2.0	0.0	2.0
chr8:38601178:T:C	0	0	0	0	0	0	0	0
chr8:38742375:G:A	0	0	0	0	0	0	0	0
chr8:38819804:C:T	144	62	212	85	127	1.0	1.0	0.0
chr8:39584608:C:T	0	0	0	0	0	0	0	0
chr8:39982715:A:G	0	0	0	0	0	0	0	0
chr8:39985620:A:G	0	0	0	0	0	0	0	0
chr8:39987746:C:T	0	0	0	0	0	0	0	0
chr8:40697223:C:T	0	0	0	0	0	0	0	0
chr8:41690230:G:A	0	0	0	0	0	0	0	0
chr8:41696410:C:G	0	0	0	0	0	0	0	0
chr8:41714174:G:T	0	0	0	0	0	0	0	0
chr8:41717037:C:T	0	0	0	0	0	0	0	0
chr8:41933348:G:C	6	2	8	4	4	1.0	1.0	0.0
chr8:41937416:C:T	8	5	13	3	10	2.0	0.0	2.0
chr8:42048994:T:C	44	24	67	20	47	2.0	0.0	2.0
chr8:42154668:T:C	49	29	79	21	58	2	0	2
chr8:42179059:A:G	0	0	0	0	0	0	0	0
chr8:42180112:C:T	0	0	0	0	0	0	0	0
chr8:42187379:C:T	0	0	0	0	0	0	0	0
chr8:49075351:G:A	0	0	0	0	0	0	0	0
chr8:49075406:A:C	0	0	0	0	0	0	0	0
chr8:51320848:C:T	0	0	0	0	0	0	0	0
chr8:51339760:A:G	0	0	0	0	0	0	0	0
chr8:51408678:G:A	0	0	0	0	0	0	0	0
chr8:51809398:T:C	4	2	6	2	4	1.5	0.5	1.0
chr8:51820490:T:A	171	55	229	119	110	1	1	0
chr8:51833593:C:T	501	247	789	281	508	2	1	0
chr8:52158901:G:A	0	0	0	0	0	0	0	0
chr8:52409462:A:G	0	0	0	0	0	0	0	0
chr8:54626497:G:A	0	0	0	0	0	0	0	0
chr8:56073255:T:C	1652	987	3250	988	2262	2.0	1.0	2.0
chr8:56073858:A:G	29	20	49	9	40	2	0	2
chr8:56073972:C:G	30	21	51	9	42	2.0	0.0	2.0
chr8:56074178:A:G	54	27	81	27	54	1.5	0.5	1.0
chr8:56113670:C:A	0	0	0	0	0	0	0	0
chr8:56166374:G:T	0	0	0	0	0	0	0	0
chr8:60266015:T:C	49	27	78	24	54	2	0	2
chr8:60852201:G:A	3	1	4	2	2	1	1	0
chr8:60852836:C:T	2	1	3	1	2	1.5	0.5	1.0
chr8:60853001:G:A	3	1	4	2	2	1	1	0
chr8:61578776:A:G	0	0	0	0	0	0	0	0
chr8:61578792:T:C	0	0	0	0	0	0	0	0
chr8:61578873:T:C	0	0	0	0	0	0	0	0
chr8:61578903:CGAAA:TGAAG	0	0	0	0	0	0	0	0
chr8:61579153:T:C	0	0	0	0	0	0	0	0
chr8:61579166:A:G	0	0	0	0	0	0	0	0
chr8:62249053:C:G	0	0	0	0	0	0	0	0
chr8:64616207:G:A	0	0	0	0	0	0	0	0
chr8:66445275:C:T	24	13	39	11	28	2.0	0.0	2.0
chr8:67952493:G:A	0	0	0	0	0	0	0	0
chr8:68108261:T:C	0	0	0	0	0	0	0	0
chr8:68521960:T:C	0	0	0	0	0	0	0	0
chr8:69832577:G:A	27	13	41	15	26	2	1	0
chr8:70126883:C:G	2	0	2	2	0	1.0	1.0	0.0
chr8:70138137:C:A	1	1	2	0	2	2	0	2
chr8:70681190:G:A	9	7	16	2	14	2	0	2
chr8:72053889:A:G	0	0	0	0	0	0	0	0
chr8:72069092:A:G	0	0	0	0	0	0	0	0
chr8:72230147:C:T	0	0	0	0	0	0	0	0
chr8:72937968:G:A	0	0	0	0	0	0	0	0
chr8:73257102:T:C	1	0	1	1	0	1	1	0
chr8:73297511:T:C	0	0	0	0	0	0	0	0
chr8:74361906:T:G	51	31	83	21	62	2	0	2
chr8:75540078:G:A	0	0	0	0	0	0	0	0
chr8:75564161:G:A	0	0	0	0	0	0	0	0
chr8:76833399:G:A	0	0	0	0	0	0	0	0
chr8:76849683:C:T	0	0	0	0	0	0	0	0
chr8:76854100:A:G	0	0	0	0	0	0	0	0
chr8:76983629:A:G	186	94	285	95	190	2.0	1.0	2.0
chr8:84873178:A:G	0	0	0	0	0	0	0	0
chr8:86048443:A:G	0	0	0	0	0	0	0	0
chr8:86064291:C:A	0	0	0	0	0	0	0	0
chr8:86472411:T:C	36	8	44	28	16	1.0	1.0	0.0
chr8:86472440:C:T	36	28	64	8	56	2.0	0.0	2.0
chr8:86507086:T:G	279	148	439	137	302	2	0	2
chr8:86508665:C:A	161	68	234	98	136	1	1	0
chr8:86528644:G:A	275	135	426	152	274	1	1	0
chr8:86544925:C:T	12	2	14	10	4	1.0	1.0	0.0
chr8:90017300:A:G	719	414	1280	394	886	2	0	2
chr8:91334295:A:G	7	6	7	1	6	1	0	1
chr8:93134427:G:T	0	0	0	0	0	0	0	0
chr8:94130910:A:G	0	0	0	0	0	0	0	0
chr8:94130944:T:G	0	0	0	0	0	0	0	0
chr8:94146031:G:A	0	0	0	0	0	0	0	0
chr8:94146154:C:T	0	0	0	0	0	0	0	0
chr8:94176622:T:C	0	0	0	0	0	0	0	0
chr8:94641815:C:T	0	0	0	0	0	0	0	0
chr8:94643357:C:G	0	0	0	0	0	0	0	0
chr8:94643368:T:C	0	0	0	0	0	0	0	0
chr8:94646298:T:C	0	0	0	0	0	0	0	0
chr8:94668001:C:T	0	0	0	0	0	0	0	0
chr8:94678351:T:C	0	0	0	0	0	0	0	0
chr8:94865559:T:C	21	6	27	15	12	1	1	0
chr8:96231492:G:A	129	63	197	69	128	2	1	0
chr8:96593572:C:T	0	0	0	0	0	0	0	0
chr8:96835130:G:T	140	64	209	79	130	1.0	1.0	0.0
chr8:97277758:C:T	1	1	2	0	2	2	0	2
chr8:97776033:G:T	3	1	4	2	2	1	1	0
chr8:97931317:A:G	0	0	0	0	0	0	0	0
chr8:97978993:A:G	0	0	0	0	0	0	0	0
chr8:98003864:A:G	0	0	0	0	0	0	0	0
chr8:98018052:T:C	0	0	0	0	0	0	0	0
chr8:98044922:C:A	550	322	930	262	668	2.0	0.0	2.0
chr8:98045298:G:A	546	241	833	338	495	1.0	1.0	0.0
chr8:98883712:G:A	0	0	0	0	0	0	0	0
chr8:99121478:T:G	19	6	25	13	12	1	1	0
chr8:99832530:T:C	9	1	9	8	1	1	1	0
chr8:100527925:A:G	15	5	20	10	10	1	1	0
chr8:100948629:C:T	1803	977	3432	1199	2233	2	1	2
chr8:101666744:G:A	0	0	0	0	0	0	0	0
chr8:102238763:C:T	127	69	204	62	142	2	0	2
chr8:102295305:T:C	32	14	47	19	28	1.0	1.0	0.0
chr8:102829481:G:A	87	37	127	53	74	1	1	0
chr8:102838824:T:C	121	65	192	58	134	2	0	2
chr8:103300113:A:G	20	9	29	11	18	1.0	1.0	0.0
chr8:103324868:A:G	4	2	6	2	4	1.5	0.5	1.0
chr8:103325139:A:C	4	3	7	1	6	2.0	0.0	2.0
chr8:103331458:G:A	2	1	3	1	2	1.5	0.5	1.0
chr8:103382516:T:C	0	0	0	0	0	0	0	0
chr8:103415131:A:C	90	46	137	44	93	1.5	0.0	1.5
chr8:103415313:C:T	47	23	70	24	46	1	1	0
chr8:103415350:T:C	48	23	71	25	46	1.0	1.0	0.0
chr8:103420317:A:G	242	128	377	117	260	2.0	0.0	2.0
chr8:103975543:G:A	0	0	0	0	0	0	0	0
chr8:109400290:G:A	0	0	0	0	0	0	0	0
chr8:109404584:C:T	0	0	0	0	0	0	0	0
chr8:109448259:G:T	0	0	0	0	0	0	0	0
chr8:109464764:A:G	0	0	0	0	0	0	0	0
chr8:109579879:G:A	14	6	20	8	12	1.0	1.0	0.0
chr8:112295843:T:A	0	0	0	0	0	0	0	0
chr8:113173774:T:C	0	0	0	0	0	0	0	0
chr8:113376716:G:A	0	0	0	0	0	0	0	0
chr8:116770146:C:T	4	3	7	1	6	2.0	0.0	2.0
chr8:117807339:C:T	2	1	3	1	2	1.5	0.5	1.0
chr8:117835543:G:A	1	0	1	1	0	1	1	0
chr8:118379552:T:C	6	6	12	0	12	2.0	0.0	2.0
chr8:118951813:G:C	0	0	0	0	0	0	0	0
chr8:119221670:C:T	0	0	0	0	0	0	0	0
chr8:119873814:C:A	2	0	2	2	0	1.0	1.0	0.0
chr8:120049640:G:A	0	0	0	0	0	0	0	0
chr8:120049838:A:G	0	0	0	0	0	0	0	0
chr8:120197830:T:C	0	0	0	0	0	0	0	0
chr8:120203752:T:C	0	0	0	0	0	0	0	0
chr8:120216440:A:C	0	0	0	0	0	0	0	0
chr8:120445137:A:G	308	174	498	145	353	2.0	0.0	2.0
chr8:120517950:A:G	2	0	2	2	0	1.0	1.0	0.0
chr8:122952191:G:A	6	3	9	3	6	1.5	0.5	1.0
chr8:122952713:C:T	8	4	12	4	8	1.5	0.5	1.0
chr8:122953919:G:C	19	6	25	13	12	1	1	0
chr8:123183196:G:C	0	0	0	0	0	0	0	0
chr8:123437226:C:T	108	52	163	59	104	1.0	1.0	0.0
chr8:123441422:T:C	103	48	154	58	96	1	1	0
chr8:123645912:C:T	0	0	0	0	0	0	0	0
chr8:123645970:C:T	0	0	0	0	0	0	0	0
chr8:123651655:G:A	0	0	0	0	0	0	0	0
chr8:123651890:C:T	0	0	0	0	0	0	0	0
chr8:123651927:T:C	0	0	0	0	0	0	0	0
chr8:123652552:C:T	0	0	0	0	0	0	0	0
chr8:123652633:AT:GC	0	0	0	0	0	0	0	0
chr8:123681204:C:T	0	0	0	0	0	0	0	0
chr8:123684627:C:T	0	0	0	0	0	0	0	0
chr8:123698489:C:T	0	0	0	0	0	0	0	0
chr8:124023548:G:C	0	0	0	0	0	0	0	0
chr8:124049654:G:A	0	0	0	0	0	0	0	0
chr8:124450857:A:T	44	30	75	15	60	2.0	0.0	2.0
chr8:124451009:T:C	49	34	84	16	68	2	0	2
chr8:124451303:T:C	44	31	76	14	62	2.0	0.0	2.0
chr8:124486306:C:T	171	72	249	103	146	1	1	0
chr8:124555921:A:G	13	4	17	9	8	1	1	0
chr8:125436547:G:A	30	10	40	20	20	1.0	1.0	0.0
chr8:127416393:G:A	0	0	0	0	0	0	0	0
chr8:127416550:G:A	0	0	0	0	0	0	0	0
chr8:127416578:G:C	6	3	9	3	6	1.5	0.5	1.0
chr8:127738294:A:G	156	58	229	109	120	1.0	1.0	0.0
chr8:129748528:C:T	0	0	0	0	0	0	0	0
chr8:129751858:T:A	0	0	0	0	0	0	0	0
chr8:129762651:T:C	0	0	0	0	0	0	0	0
chr8:131040211:C:T	0	0	0	0	0	0	0	0
chr8:132079891:G:A	0	0	0	0	0	0	0	0
chr8:132710920:A:G	50	38	88	12	76	2.0	0.0	2.0
chr8:132888007:T:G	0	0	0	0	0	0	0	0
chr8:132888141:T:C	0	0	0	0	0	0	0	0
chr8:132897729:A:G	0	0	0	0	0	0	0	0
chr8:132908273:A:G	0	0	0	0	0	0	0	0
chr8:132919503:T:C	0	0	0	0	0	0	0	0
chr8:132971813:C:T	0	0	0	0	0	0	0	0
chr8:133047816:T:C	5	1	6	4	2	1	1	0
chr8:133096209:C:T	0	0	0	0	0	0	0	0
chr8:133096302:T:C	0	0	0	0	0	0	0	0
chr8:133102529:A:G	0	0	0	0	0	0	0	0
chr8:133113438:G:A	0	0	0	0	0	0	0	0
chr8:133284281:C:T	20	12	32	8	24	2.0	0.0	2.0
chr8:133408117:A:G	0	0	0	0	0	0	0	0
chr8:133461905:C:T	67	30	98	38	60	1	1	0
chr8:133475764:G:A	52	25	79	27	52	1.0	1.0	0.0
chr8:134509727:G:A	13	8	21	5	16	2	0	2
chr8:134512554:G:T	9	3	12	6	6	1	1	0
chr8:134590338:A:G	16	11	31	5	26	2.0	0.0	2.0
chr8:134600502:A:G	18	13	33	5	28	2.0	0.0	2.0
chr8:134602462:A:G	3	2	5	1	4	2	0	2
chr8:134602729:A:G	3	2	5	1	4	2	0	2
chr8:134637605:G:A	15	10	25	5	20	2	0	2
chr8:137831795:A:G	0	0	0	0	0	0	0	0
chr8:138083137:T:C	0	0	0	0	0	0	0	0
chr8:138151949:G:A	0	0	0	0	0	0	0	0
chr8:138152825:C:T	0	0	0	0	0	0	0	0
chr8:138685235:T:C	0	0	0	0	0	0	0	0
chr8:138688966:G:T	0	0	0	0	0	0	0	0
chr8:138826669:T:C	0	0	0	0	0	0	0	0
chr8:139618747:A:G	0	0	0	0	0	0	0	0
chr8:140549259:G:A	2	1	3	1	2	1.5	0.5	1.0
chr8:140556212:C:T	2	1	3	1	2	1.5	0.5	1.0
chr8:140572797:T:C	5	4	9	1	8	2	0	2
chr8:141175481:G:A	0	0	0	0	0	0	0	0
chr8:141190368:G:A	0	0	0	0	0	0	0	0
chr8:141192757:C:T	0	0	0	0	0	0	0	0
chr8:141194227:C:G	0	0	0	0	0	0	0	0
chr8:141215891:G:A	0	0	0	0	0	0	0	0
chr8:141218050:G:A	0	0	0	0	0	0	0	0
chr8:141218587:G:A	0	0	0	0	0	0	0	0
chr8:141219735:G:A	0	0	0	0	0	0	0	0
chr8:141228240:C:A	1	1	2	0	2	2	0	2
chr8:141357235:T:C	0	0	0	0	0	0	0	0
chr8:141357300:G:A	0	0	0	0	0	0	0	0
chr8:141434680:G:C	0	0	0	0	0	0	0	0
chr8:141436837:C:T	0	0	0	0	0	0	0	0
chr8:141447953:A:G	0	0	0	0	0	0	0	0
chr8:141449638:G:A	0	0	0	0	0	0	0	0
chr8:141477438:A:G	0	0	0	0	0	0	0	0
chr8:141480347:A:C	0	0	0	0	0	0	0	0
chr8:141490245:C:T	0	0	0	0	0	0	0	0
chr8:141507122:A:G	0	0	0	0	0	0	0	0
chr8:141507127:C:T	0	0	0	0	0	0	0	0
chr8:142300449:T:C	16	11	27	5	22	2.0	0.0	2.0
chr8:142331775:C:T	20	14	34	6	28	2.0	0.0	2.0
chr8:142343993:C:T	23	7	30	16	14	1	1	0
chr8:142344045:C:T	23	7	30	16	14	1	1	0
chr8:142539461:T:C	0	0	0	0	0	0	0	0
chr8:142542098:G:T	1	0	1	1	0	1	1	0
chr8:142680513:C:T	0	0	0	0	0	0	0	0
chr8:142681514:G:A	0	0	0	0	0	0	0	0
chr8:142681625:A:G	0	0	0	0	0	0	0	0
chr8:142681665:A:G	0	0	0	0	0	0	0	0
chr8:142681691:A:G	0	0	0	0	0	0	0	0
chr8:142682072:T:C	0	0	0	0	0	0	0	0
chr8:142682129:C:A	0	0	0	0	0	0	0	0
chr8:142700440:G:A	0	0	0	0	0	0	0	0
chr8:142700626:A:G	0	0	0	0	0	0	0	0
chr8:142703082:T:G	0	0	0	0	0	0	0	0
chr8:142727775:C:T	11	5	18	6	12	1	1	0
chr8:143043131:G:A	0	0	0	0	0	0	0	0
chr8:143213907:G:T	0	0	0	0	0	0	0	0
chr8:143275822:A:G	0	0	0	0	0	0	0	0
chr8:143296014:C:G	1	1	2	0	2	2	0	2
chr8:143310198:G:A	346	164	525	193	332	1.0	1.0	0.0
chr8:143321279:G:A	302	163	474	144	330	2.0	0.0	2.0
chr8:143331246:G:A	304	159	475	151	324	2.0	0.0	2.0
chr8:143375576:C:A	3	2	5	1	4	2	0	2
chr8:143437977:G:A	67	32	101	35	66	1	1	0
chr8:143440287:G:A	58	32	91	27	64	2.0	0.0	2.0
chr8:143560999:C:T	17	7	24	10	14	1	1	0
chr8:143568333:G:A	0	0	0	0	0	0	0	0
chr8:143568340:G:A	0	0	0	0	0	0	0	0
chr8:143649856:G:A	0	0	0	0	0	0	0	0
chr8:143650280:G:A	17	10	27	7	20	2	0	2
chr8:143722129:T:C	0	0	0	0	0	0	0	0
chr8:143792307:G:A	11	6	17	5	12	2	0	2
chr8:143820544:C:T	5	3	8	2	6	2	0	2
chr8:143866611:G:A	0	0	0	0	0	0	0	0
chr8:143867251:C:T	0	0	0	0	0	0	0	0
chr8:143916167:G:A	100	35	135	65	70	1.0	1.0	0.0
chr8:143916360:A:G	77	24	101	53	48	1	1	0
chr8:143917008:T:C	27	7	34	20	14	1	1	0
chr8:143917935:T:C	4	1	5	3	2	1.0	1.0	0.0
chr8:143918694:A:G	2	0	2	2	0	1.0	1.0	0.0
chr8:143919156:C:T	2	0	2	2	0	1.0	1.0	0.0
chr8:143919209:A:G	2	0	2	2	0	1.0	1.0	0.0
chr8:143921326:C:T	1	1	2	0	2	2	0	2
chr8:143921568:G:A	1	1	2	0	2	2	0	2
chr8:143921861:A:G	1	1	2	0	2	2	0	2
chr8:143922240:T:G	0	0	0	0	0	0	0	0
chr8:143923488:C:T	1	1	2	0	2	2	0	2
chr8:143923759:G:A	0	0	0	0	0	0	0	0
chr8:143924001:C:T	0	0	0	0	0	0	0	0
chr8:143924022:A:G	0	0	0	0	0	0	0	0
chr8:143925249:C:T	1	0	1	1	0	1	1	0
chr8:143925453:C:T	1	0	1	1	0	1	1	0
chr8:143925474:A:C	1	0	1	1	0	1	1	0
chr8:143925516:A:G	1	0	1	1	0	1	1	0
chr8:143926863:T:C	0	0	0	0	0	0	0	0
chr8:143927420:C:T	1	0	1	1	0	1	1	0
chr8:143927616:A:G	1	0	1	1	0	1	1	0
chr8:143927902:G:A	1	0	1	1	0	1	1	0
chr8:143933019:G:A	3	1	4	2	2	1	1	0
chr8:143934392:A:G	4	1	5	3	2	1.0	1.0	0.0
chr8:143937036:A:G	4	1	5	3	2	1.0	1.0	0.0
chr8:144109615:C:A	2	2	4	0	4	2.0	0.0	2.0
chr8:144354164:C:G	0	0	0	0	0	0	0	0
chr8:144354169:A:C	0	0	0	0	0	0	0	0
chr8:144379425:C:A	18	11	31	7	24	2.0	0.0	2.0
chr8:144393094:GGCG:AGCA	26	12	39	15	24	1.5	1.0	0.0
chr8:144396341:G:A	2	0	2	2	0	1.0	1.0	0.0
chr8:144398573:G:A	5	3	8	2	6	2	0	2
chr8:144399250:C:T	0	0	0	0	0	0	0	0
chr8:144414342:T:C	1	1	2	0	2	2	0	2
chr8:144416727:C:G	2	0	2	2	0	1.0	1.0	0.0
chr8:144468640:G:A	16	8	24	8	16	1.5	0.5	1.0
chr8:144498892:T:C	0	0	0	0	0	0	0	0
chr8:144504344:C:A	0	0	0	0	0	0	0	0
chr8:144504947:G:A	0	0	0	0	0	0	0	0
chr8:144511903:G:A	0	0	0	0	0	0	0	0
chr8:144512433:C:T	3	2	5	1	4	2	0	2
chr8:144513286:C:T	3	1	4	2	2	1	1	0
chr8:144516318:C:G	0	0	0	0	0	0	0	0
chr8:144522536:T:G	12	4	16	8	8	1.0	1.0	0.0
chr8:144524754:T:C	45	22	68	24	44	1	1	0
chr8:144530786:G:A	0	0	0	0	0	0	0	0
chr8:144807457:G:A	0	0	0	0	0	0	0	0
chr8:144843209:T:C	153	74	238	86	152	2	1	0
chr8:144889982:A:G	48	29	77	19	58	2.0	0.0	2.0
chr8:144930861:C:A	6	4	10	2	8	2.0	0.0	2.0
chr8:144931953:T:C	4	3	7	1	6	2.0	0.0	2.0
chr8:144945899:G:A	43	21	66	22	44	1	1	0
chr8:144946051:A:G	46	23	71	23	48	1.5	0.5	1.0
chr9:116800:C:G	0	0	0	0	0	0	0	0
chr9:116832:T:C	0	0	0	0	0	0	0	0
chr9:117371:C:G	0	0	0	0	0	0	0	0
chr9:117428:G:C	0	0	0	0	0	0	0	0
chr9:154795:T:C	155	69	232	92	140	1	1	0
chr9:214706:G:C	21	20	41	1	40	2	0	2
chr9:215057:T:C	60	55	115	5	110	2.0	0.0	2.0
chr9:215269:A:C	66	60	126	6	120	2.0	0.0	2.0
chr9:271638:C:T	16	15	31	1	30	2.0	0.0	2.0
chr9:286593:C:A	319	181	514	150	364	2	0	2
chr9:368030:T:C	79	41	120	38	82	2	0	2
chr9:441952:G:A	30	18	48	12	36	2.0	0.0	2.0
chr9:676954:T:C	2	1	3	1	2	1.5	0.5	1.0
chr9:712060:G:C	2	0	2	2	0	1.0	1.0	0.0
chr9:712599:C:T	2	0	2	2	0	1.0	1.0	0.0
chr9:841825:C:T	0	0	0	0	0	0	0	0
chr9:841971:T:A	0	0	0	0	0	0	0	0
chr9:990076:G:A	0	0	0	0	0	0	0	0
chr9:990840:C:T	0	0	0	0	0	0	0	0
chr9:1056101:T:G	0	0	0	0	0	0	0	0
chr9:1056728:G:C	0	0	0	0	0	0	0	0
chr9:1056959:G:C	0	0	0	0	0	0	0	0
chr9:1057294:C:A	0	0	0	0	0	0	0	0
chr9:2029199:G:A	90	44	139	49	90	1.5	1.0	0.0
chr9:2191404:A:G	33	15	48	18	30	1	1	0
chr9:2718534:C:G	1	1	2	0	2	2	0	2
chr9:4285986:G:C	0	0	0	0	0	0	0	0
chr9:4564432:G:A	0	0	0	0	0	0	0	0
chr9:4662369:A:C	7	5	12	2	10	2	0	2
chr9:5231712:T:A	0	0	0	0	0	0	0	0
chr9:5969249:A:G	113	52	169	63	106	1	1	0
chr9:6012734:A:C	21	8	29	13	16	1	1	0
chr9:6984236:G:A	26	9	35	17	18	1.0	1.0	0.0
chr9:7076586:G:A	8	3	11	5	6	1.0	1.0	0.0
chr9:7103816:C:T	18	7	25	11	14	1.0	1.0	0.0
chr9:7174673:G:A	11	5	16	6	10	1	1	0
chr9:13150532:T:C	0	0	0	0	0	0	0	0
chr9:13176313:C:T	0	0	0	0	0	0	0	0
chr9:13219571:T:C	0	0	0	0	0	0	0	0
chr9:15591374:T:A	20	10	30	10	20	1.5	0.5	1.0
chr9:15784633:A:G	1	0	1	1	0	1	1	0
chr9:15874747:T:G	2	0	2	2	0	1.0	1.0	0.0
chr9:18504918:T:A	0	0	0	0	0	0	0	0
chr9:18777270:C:T	0	0	0	0	0	0	0	0
chr9:18777306:C:T	0	0	0	0	0	0	0	0
chr9:18928041:A:G	0	0	0	0	0	0	0	0
chr9:19032909:A:G	0	0	0	0	0	0	0	0
chr9:19058427:G:A	5	2	7	3	4	1	1	0
chr9:19058485:C:A	4	2	6	2	4	1.5	0.5	1.0
chr9:19058823:A:G	3	1	4	2	2	1	1	0
chr9:19346712:A:G	3	2	5	1	4	2	0	2
chr9:19576951:T:G	0	0	0	0	0	0	0	0
chr9:20953050:A:G	1	0	1	1	0	1	1	0
chr9:21186932:A:G	0	0	0	0	0	0	0	0
chr9:21187122:T:A	0	0	0	0	0	0	0	0
chr9:21187312:C:T	0	0	0	0	0	0	0	0
chr9:21227623:A:C	0	0	0	0	0	0	0	0
chr9:21227652:A:G	0	0	0	0	0	0	0	0
chr9:21227943:G:T	0	0	0	0	0	0	0	0
chr9:21228041:C:G	0	0	0	0	0	0	0	0
chr9:21228183:GC:TG	0	0	0	0	0	0	0	0
chr9:21304804:G:A	0	0	0	0	0	0	0	0
chr9:21350621:G:A	0	0	0	0	0	0	0	0
chr9:21440491:T:C	0	0	0	0	0	0	0	0
chr9:33001443:G:A	151	71	228	84	144	1	1	0
chr9:33442274:G:A	0	0	0	0	0	0	0	0
chr9:33442954:G:A	10	3	13	7	6	1.0	1.0	0.0
chr9:33442988:A:C	0	0	0	0	0	0	0	0
chr9:33473895:T:G	10	4	14	6	8	1.0	1.0	0.0
chr9:33524686:G:A	0	0	0	0	0	0	0	0
chr9:33568791:T:G	0	0	0	0	0	0	0	0
chr9:34256541:A:G	0	0	0	0	0	0	0	0
chr9:34371790:A:T	0	0	0	0	0	0	0	0
chr9:34397547:A:G	0	0	0	0	0	0	0	0
chr9:34622392:A:C	0	0	0	0	0	0	0	0
chr9:34627943:C:T	0	0	0	0	0	0	0	0
chr9:34655737:G:T	4	2	6	2	4	1.5	0.5	1.0
chr9:34723184:G:A	0	0	0	0	0	0	0	0
chr9:34723747:C:A	0	0	0	0	0	0	0	0
chr9:34723938:C:T	0	0	0	0	0	0	0	0
chr9:34724244:C:A	0	0	0	0	0	0	0	0
chr9:34724789:G:A	0	0	0	0	0	0	0	0
chr9:34725050:C:T	0	0	0	0	0	0	0	0
chr9:34725745:T:C	0	0	0	0	0	0	0	0
chr9:34726674:G:A	0	0	0	0	0	0	0	0
chr9:34729455:A:G	0	0	0	0	0	0	0	0
chr9:34832922:C:T	0	0	0	0	0	0	0	0
chr9:34895011:T:C	0	0	0	0	0	0	0	0
chr9:34895601:A:C	0	0	0	0	0	0	0	0
chr9:35043294:G:T	1	1	2	0	2	2	0	2
chr9:35060749:A:G	10	5	15	5	10	1.5	0.5	1.0
chr9:35074920:T:C	1	1	2	0	2	2	0	2
chr9:35079364:G:T	1	1	2	0	2	2	0	2
chr9:35093023:T:C	1	1	4	0	4	4	0	4
chr9:35107768:C:A	10	4	14	6	8	1.0	1.0	0.0
chr9:35563364:G:A	0	0	0	0	0	0	0	0
chr9:35607904:G:A	0	0	0	0	0	0	0	0
chr9:35612981:G:A	270	165	467	117	350	2.0	0.0	2.0
chr9:35657841:G:A	5	3	8	2	6	2	0	2
chr9:35657862:C:G	5	3	8	2	6	2	0	2
chr9:35660904:C:T	348	183	556	175	381	2.0	0.0	2.0
chr9:35663231:G:C	0	0	0	0	0	0	0	0
chr9:35665156:C:A	2	2	4	0	4	2.0	0.0	2.0
chr9:35674056:G:A	0	0	0	0	0	0	0	0
chr9:35674104:T:C	0	0	0	0	0	0	0	0
chr9:35679254:A:G	0	0	0	0	0	0	0	0
chr9:35683151:C:T	9	9	18	0	18	2	0	2
chr9:35704153:C:T	10	3	13	7	6	1.0	1.0	0.0
chr9:35870004:T:C	0	0	0	0	0	0	0	0
chr9:35870228:G:A	0	0	0	0	0	0	0	0
chr9:35906474:C:T	0	0	0	0	0	0	0	0
chr9:35910693:G:A	0	0	0	0	0	0	0	0
chr9:35957358:G:A	0	0	0	0	0	0	0	0
chr9:35957672:T:C	0	0	0	0	0	0	0	0
chr9:35958050:T:C	0	0	0	0	0	0	0	0
chr9:35971567:C:T	0	0	0	0	0	0	0	0
chr9:35971582:C:T	0	0	0	0	0	0	0	0
chr9:36169497:G:A	0	0	0	0	0	0	0	0
chr9:36169601:T:C	0	0	0	0	0	0	0	0
chr9:36191007:C:T	717	393	1230	387	843	2	1	2
chr9:36191152:T:C	717	393	1231	387	844	2	1	2
chr9:37486606:A:G	18	5	23	13	10	1.0	1.0	0.0
chr9:37486632:C:G	18	13	31	5	26	2.0	0.0	2.0
chr9:37500898:T:C	77	30	108	48	60	1	1	0
chr9:37503090:G:A	81	32	114	50	64	1	1	0
chr9:37537560:G:A	22	12	34	10	24	2.0	0.0	2.0
chr9:41074407:C:T	0	0	0	0	0	0	0	0
chr9:63379956:G:A	0	0	0	0	0	0	0	0
chr9:63379977:T:C	0	0	0	0	0	0	0	0
chr9:138175392:T:C	4	4	8	0	8	2.0	0.0	2.0
chr10:48005:G:A	0	0	0	0	0	0	0	0
chr10:277343:A:G	20	11	31	9	22	2.0	0.0	2.0
chr10:384037:G:A	0	0	0	0	0	0	0	0
chr10:1019770:C:T	14	4	18	10	8	1.0	1.0	0.0
chr10:1022699:C:T	3	2	5	1	4	2	0	2
chr10:3108781:C:T	243	104	362	150	212	1	1	0
chr10:3113428:A:G	263	154	435	114	321	2	0	2
chr10:3129803:G:T	2	2	4	0	4	2.0	0.0	2.0
chr10:3129929:C:T	283	171	479	121	358	2	0	2
chr10:3129953:C:T	283	171	478	122	356	2	0	2
chr10:3136622:T:A	325	196	551	141	410	2	0	2
chr10:3137983:C:T	34	17	53	17	36	1.5	0.5	1.0
chr10:3138124:T:C	31	15	48	16	32	1	1	0
chr10:3147821:G:C	0	0	0	0	0	0	0	0
chr10:3147974:C:A	0	0	0	0	0	0	0	0
chr10:3148073:A:G	0	0	0	0	0	0	0	0
chr10:3148106:C:T	0	0	0	0	0	0	0	0
chr10:3148307:A:T	0	0	0	0	0	0	0	0
chr10:3149631:C:T	7	5	12	2	10	2	0	2
chr10:3165440:A:G	7	4	11	3	8	2	0	2
chr10:4995526:A:G	0	0	0	0	0	0	0	0
chr10:5096415:G:A	0	0	0	0	0	0	0	0
chr10:5097493:G:A	0	0	0	0	0	0	0	0
chr10:5161901:C:T	0	0	0	0	0	0	0	0
chr10:5162965:C:T	0	0	0	0	0	0	0	0
chr10:5200201:A:G	0	0	0	0	0	0	0	0
chr10:5373991:A:G	0	0	0	0	0	0	0	0
chr10:5499218:TTC:CTT	0	0	0	0	0	0	0	0
chr10:5739665:T:G	5	4	9	1	8	2	0	2
chr10:5740006:A:T	6	5	11	1	10	2.0	0.0	2.0
chr10:5746645:G:C	3	0	3	3	0	1	1	0
chr10:5813262:G:A	1325	718	2470	869	1601	2	1	2
chr10:5878158:T:C	21	8	29	13	16	1	1	0
chr10:5882979:C:G	2	1	3	1	2	1.5	0.5	1.0
chr10:5884008:C:A	17	8	25	9	16	1	1	0
chr10:5894462:C:G	5	2	7	3	4	1	1	0
chr10:5924229:A:G	6	3	8	3	5	1.0	0.5	0.5
chr10:5936448:T:C	4	0	4	4	0	1.0	1.0	0.0
chr10:5960405:T:G	81	40	123	41	82	1	1	0
chr10:6146375:A:G	3	1	4	2	2	1	1	0
chr10:7563105:C:T	0	0	0	0	0	0	0	0
chr10:7579808:A:G	0	0	0	0	0	0	0	0
chr10:7730072:A:G	3	2	5	1	4	2	0	2
chr10:7732395:C:G	1	1	2	0	2	2	0	2
chr10:7964835:A:G	137	76	218	64	154	2	0	2
chr10:11755518:C:T	5	5	10	0	10	2	0	2
chr10:11763250:T:C	3	0	3	3	0	1	1	0
chr10:11763355:ATCG:GTCA	3	0	3	3	0	1	1	0
chr10:12089082:T:G	6	3	9	3	6	1.5	0.5	1.0
chr10:12101106:C:G	8	3	11	5	6	1.0	1.0	0.0
chr10:12246303:A:G	7	4	11	3	8	2	0	2
chr10:13109224:G:A	260	112	392	162	230	1.0	1.0	0.0
chr10:13188950:C:T	0	0	0	0	0	0	0	0
chr10:13204439:C:G	0	0	0	0	0	0	0	0
chr10:13278236:C:T	100	55	155	45	110	2.0	0.0	2.0
chr10:13288402:T:C	102	57	161	45	116	2.0	0.0	2.0
chr10:13439427:T:A	0	0	0	0	0	0	0	0
chr10:13651883:C:T	1	1	2	0	2	2	0	2
chr10:14934415:G:A	80	43	123	37	86	2.0	0.0	2.0
chr10:15214195:G:A	0	0	0	0	0	0	0	0
chr10:15214460:C:T	0	0	0	0	0	0	0	0
chr10:16876998:T:C	0	0	0	0	0	0	0	0
chr10:16877053:T:C	0	0	0	0	0	0	0	0
chr10:16890385:G:A	0	0	0	0	0	0	0	0
chr10:16925587:C:G	0	0	0	0	0	0	0	0
chr10:16937662:T:C	0	0	0	0	0	0	0	0
chr10:16937715:T:C	0	0	0	0	0	0	0	0
chr10:17115573:G:A	0	0	0	0	0	0	0	0
chr10:17123546:G:A	5	5	10	0	10	2	0	2
chr10:17123553:T:G	5	5	10	0	10	2	0	2
chr10:17153429:G:C	1	0	1	1	0	1	1	0
chr10:17229401:G:C	3846	2853	17742	5668	12074	3.0	1.0	2.0
chr10:17603815:C:T	11	6	17	5	12	2	0	2
chr10:17827578:C:T	20	18	38	2	36	2.0	0.0	2.0
chr10:17833817:T:A	20	17	37	3	34	2.0	0.0	2.0
chr10:18150997:T:C	278	169	465	122	343	2.0	0.0	2.0
chr10:19136602:A:G	0	0	0	0	0	0	0	0
chr10:19136775:A:G	0	0	0	0	0	0	0	0
chr10:19389520:A:G	0	0	0	0	0	0	0	0
chr10:19389568:G:A	0	0	0	0	0	0	0	0
chr10:19607901:C:A	0	0	0	0	0	0	0	0
chr10:19817007:T:C	0	0	0	0	0	0	0	0
chr10:20217489:G:A	0	0	0	0	0	0	0	0
chr10:20819448:C:T	0	0	0	0	0	0	0	0
chr10:21538867:G:A	128	72	204	60	144	2.0	0.0	2.0
chr10:23119349:C:T	178	78	265	105	160	1.0	1.0	0.0
chr10:24524525:G:A	0	0	0	0	0	0	0	0
chr10:24543956:C:T	0	0	0	0	0	0	0	0
chr10:24584440:C:G	3	1	4	2	2	1	1	0
chr10:24584504:C:T	3	1	4	2	2	1	1	0
chr10:24619757:T:C	3	1	4	2	2	1	1	0
chr10:25024889:C:T	6	3	9	3	6	1.5	0.5	1.0
chr10:25412412:C:G	0	0	0	0	0	0	0	0
chr10:26021750:A:C	0	0	0	0	0	0	0	0
chr10:26157383:G:A	0	0	0	0	0	0	0	0
chr10:26173861:G:A	1	1	2	0	2	2	0	2
chr10:26174114:A:T	2	2	4	0	4	2.0	0.0	2.0
chr10:26501207:T:A	88	40	128	49	79	1.0	1.0	0.0
chr10:26751707:T:G	258	121	380	144	236	1.0	1.0	0.0
chr10:27077263:A:C	0	0	0	0	0	0	0	0
chr10:27413240:C:T	0	0	0	0	0	0	0	0
chr10:27413759:C:T	0	0	0	0	0	0	0	0
chr10:27413796:A:G	0	0	0	0	0	0	0	0
chr10:27413797:G:A	0	0	0	0	0	0	0	0
chr10:27675541:G:A	0	0	0	0	0	0	0	0
chr10:29292564:A:C	0	0	0	0	0	0	0	0
chr10:29292598:C:T	0	0	0	0	0	0	0	0
chr10:29458488:C:T	1	0	1	1	0	1	1	0
chr10:29465680:T:C	0	0	0	0	0	0	0	0
chr10:29470296:A:G	0	0	0	0	0	0	0	0
chr10:29523493:C:A	0	0	0	0	0	0	0	0
chr10:29523673:G:T	0	0	0	0	0	0	0	0
chr10:29550935:A:C	0	0	0	0	0	0	0	0
chr10:30027143:C:G	0	0	0	0	0	0	0	0
chr10:30027279:T:C	0	0	0	0	0	0	0	0
chr10:30027943:T:C	0	0	0	0	0	0	0	0
chr10:30028144:G:A	0	0	0	0	0	0	0	0
chr10:30028897:A:G	0	0	0	0	0	0	0	0
chr10:30028909:A:G	0	0	0	0	0	0	0	0
chr10:30029020:C:T	0	0	0	0	0	0	0	0
chr10:30340207:G:A	50	30	82	20	62	2.0	0.0	2.0
chr10:30340297:G:A	58	35	95	23	72	2.0	0.0	2.0
chr10:30612827:G:A	0	0	0	0	0	0	0	0
chr10:30689277:G:C	0	0	0	0	0	0	0	0
chr10:30849888:G:A	9	6	15	3	12	2	0	2
chr10:32286865:A:G	7	4	11	3	8	2	0	2
chr10:32346906:G:A	1187	574	1962	749	1213	2	1	0
chr10:32456334:T:C	50	20	69	30	39	1.0	1.0	0.0
chr10:33334323:G:A	0	0	0	0	0	0	0	0
chr10:38055772:C:G	6	3	9	3	6	1.5	0.5	1.0
chr10:38118591:A:G	29	16	45	13	32	1	0	1
chr10:42566985:G:A	0	0	0	0	0	0	0	0
chr10:42594517:G:A	10	6	16	4	12	2.0	0.0	2.0
chr10:42785641:T:C	119	64	187	57	130	2	0	2
chr10:42831179:A:C	36	14	52	22	30	1.0	1.0	0.0
chr10:43100520:A:G	0	0	0	0	0	0	0	0
chr10:43111239:A:G	0	0	0	0	0	0	0	0
chr10:43114671:G:A	0	0	0	0	0	0	0	0
chr10:43118395:G:T	0	0	0	0	0	0	0	0
chr10:43120185:C:G	0	0	0	0	0	0	0	0
chr10:43126769:T:C	0	0	0	0	0	0	0	0
chr10:43196243:C:T	0	0	0	0	0	0	0	0
chr10:43387894:T:A	604	317	983	325	658	2.0	1.0	2.0
chr10:43616352:T:C	13	4	17	9	8	1	1	0
chr10:43616358:G:A	13	9	22	4	18	2	0	2
chr10:43616797:G:A	12	9	21	3	18	2.0	0.0	2.0
chr10:44293378:C:T	0	0	0	0	0	0	0	0
chr10:44935014:C:T	0	0	0	0	0	0	0	0
chr10:45648510:T:G	27	15	44	12	32	2	0	2
chr10:45678964:G:A	0	0	0	0	0	0	0	0
chr10:46046326:A:G	0	0	0	0	0	0	0	0
chr10:46330039:G:A	0	0	0	0	0	0	0	0
chr10:46358188:G:A	0	0	0	0	0	0	0	0
chr10:46549296:C:T	0	0	0	0	0	0	0	0
chr10:46549378:G:A	0	0	0	0	0	0	0	0
chr10:46549471:G:A	0	0	0	0	0	0	0	0
chr10:46549538:A:G	0	0	0	0	0	0	0	0
chr10:46549546:C:T	0	0	0	0	0	0	0	0
chr10:46550419:C:A	0	0	0	0	0	0	0	0
chr10:46550466:A:G	0	0	0	0	0	0	0	0
chr10:46550587:G:A	0	0	0	0	0	0	0	0
chr10:46550598:C:T	0	0	0	0	0	0	0	0
chr10:46550618:C:T	0	0	0	0	0	0	0	0
chr10:46550622:G:C	0	0	0	0	0	0	0	0
chr10:46550723:C:T	0	0	0	0	0	0	0	0
chr10:47368085:G:A	0	0	0	0	0	0	0	0
chr10:47368615:G:A	0	0	0	0	0	0	0	0
chr10:48010528:C:T	0	0	0	0	0	0	0	0
chr10:48010536:C:G	0	0	0	0	0	0	0	0
chr10:48446360:C:T	0	0	0	0	0	0	0	0
chr10:48913739:T:C	2	1	3	1	2	1.5	0.5	1.0
chr10:48914136:C:A	5	2	7	3	4	1	1	0
chr10:48976904:C:T	125	65	196	66	130	2	0	2
chr10:48978370:C:T	150	74	230	82	148	2.0	1.0	0.0
chr10:50132965:T:G	50	28	78	22	56	2.0	0.0	2.0
chr10:50343947:A:G	31	19	49	12	37	2	0	2
chr10:50676822:T:C	0	0	0	0	0	0	0	0
chr10:52062541:A:G	0	0	0	0	0	0	0	0
chr10:52412851:C:T	0	0	0	0	0	0	0	0
chr10:52771475:C:T	0	0	0	0	0	0	0	0
chr10:53806646:T:G	0	0	0	0	0	0	0	0
chr10:54195684:T:G	0	0	0	0	0	0	0	0
chr10:54664208:A:C	0	0	0	0	0	0	0	0
chr10:56358869:T:C	5	2	7	3	4	1	1	0
chr10:58803193:A:C	0	0	0	0	0	0	0	0
chr10:59792934:G:T	16	7	23	9	14	1.0	1.0	0.0
chr10:59793016:C:T	14	5	19	9	10	1.0	1.0	0.0
chr10:59906128:C:A	124	57	184	68	116	1.0	1.0	0.0
chr10:60134369:G:A	0	0	0	0	0	0	0	0
chr10:60205867:A:G	0	0	0	0	0	0	0	0
chr10:60270176:G:C	0	0	0	0	0	0	0	0
chr10:60871385:C:T	0	0	0	0	0	0	0	0
chr10:60911547:G:A	0	0	0	0	0	0	0	0
chr10:61760940:T:C	0	0	0	0	0	0	0	0
chr10:62218221:C:T	0	0	0	0	0	0	0	0
chr10:62399574:G:T	0	0	0	0	0	0	0	0
chr10:62655424:A:G	0	0	0	0	0	0	0	0
chr10:62805132:G:T	9	4	13	5	8	1	1	0
chr10:62805174:C:G	9	4	13	5	8	1	1	0
chr10:63185604:G:A	105	52	159	53	106	1	1	0
chr10:63214777:A:T	38	12	51	27	24	1.0	1.0	0.0
chr10:67521943:A:T	0	0	0	0	0	0	0	0
chr10:68174501:C:G	0	0	0	0	0	0	0	0
chr10:68284159:G:A	4	2	6	2	4	1.5	0.5	1.0
chr10:68284274:T:C	4	2	6	2	4	1.5	0.5	1.0
chr10:68292171:A:G	3	1	4	2	2	1	1	0
chr10:68345803:G:A	11	4	15	7	8	1	1	0
chr10:68468207:C:T	7	6	13	1	12	2	0	2
chr10:68471944:A:G	1	1	2	0	2	2	0	2
chr10:68572823:A:G	0	0	0	0	0	0	0	0
chr10:68572915:T:A	0	0	0	0	0	0	0	0
chr10:68573105:C:T	0	0	0	0	0	0	0	0
chr10:68645480:G:A	3	3	6	0	6	2	0	2
chr10:68645782:A:G	3	3	6	0	6	2	0	2
chr10:68646098:A:G	3	0	3	3	0	1	1	0
chr10:68686538:G:A	0	0	0	0	0	0	0	0
chr10:68885351:C:T	0	0	0	0	0	0	0	0
chr10:68885620:A:C	1	1	2	0	2	2	0	2
chr10:68885941:C:T	1	1	2	0	2	2	0	2
chr10:69124257:G:A	483	240	755	263	492	2	1	0
chr10:69232908:C:T	0	0	0	0	0	0	0	0
chr10:69382664:G:A	28	8	36	20	16	1.0	1.0	0.0
chr10:69631782:T:C	14	0	14	14	0	1.0	1.0	0.0
chr10:70114163:C:T	21	13	34	8	26	2	0	2
chr10:70121102:A:G	23	15	38	8	30	2	0	2
chr10:70145939:A:G	23	11	34	12	22	1	1	0
chr10:70146394:T:C	12	5	17	7	10	1.0	1.0	0.0
chr10:70255653:C:A	0	0	0	0	0	0	0	0
chr10:70266198:G:A	0	0	0	0	0	0	0	0
chr10:70530022:C:T	0	0	0	0	0	0	0	0
chr10:70598899:G:A	17	2	19	15	4	1	1	0
chr10:70753926:C:T	0	0	0	0	0	0	0	0
chr10:70758081:C:T	0	0	0	0	0	0	0	0
chr10:70760503:C:T	0	0	0	0	0	0	0	0
chr10:70760574:A:G	0	0	0	0	0	0	0	0
chr10:70760811:A:G	0	0	0	0	0	0	0	0
chr10:70777180:A:G	0	0	0	0	0	0	0	0
chr10:70871869:C:T	0	0	0	0	0	0	0	0
chr10:70883914:C:T	355	179	570	196	374	2	1	2
chr10:71322806:A:G	33	15	48	18	30	1	1	0
chr10:71509957:T:C	0	0	0	0	0	0	0	0
chr10:71511149:T:C	0	0	0	0	0	0	0	0
chr10:71675131:G:C	0	0	0	0	0	0	0	0
chr10:71777857:G:A	0	0	0	0	0	0	0	0
chr10:71803310:G:C	1	1	2	0	2	2	0	2
chr10:73504779:T:A	8	2	10	6	4	1.0	1.0	0.0
chr10:73647154:G:T	0	0	0	0	0	0	0	0
chr10:73647891:A:C	0	0	0	0	0	0	0	0
chr10:73655919:C:T	0	0	0	0	0	0	0	0
chr10:73697761:G:A	2	0	2	2	0	1.0	1.0	0.0
chr10:73746916:T:C	116	62	184	58	126	2.0	0.0	2.0
chr10:73767950:A:G	27	14	41	13	28	2	0	2
chr10:73770255:C:T	9	3	12	6	6	1	1	0
chr10:73771204:C:T	40	13	53	27	26	1.0	1.0	0.0
chr10:73799109:G:A	10	3	13	7	6	1.0	1.0	0.0
chr10:73799319:G:A	14	7	21	7	14	1.5	0.5	1.0
chr10:73807071:A:G	6	3	9	3	6	1.5	0.5	1.0
chr10:74105307:G:A	9	4	13	5	8	1	1	0
chr10:75782800:C:T	0	0	0	0	0	0	0	0
chr10:77090562:C:G	0	0	0	0	0	0	0	0
chr10:77184832:G:A	0	0	0	0	0	0	0	0
chr10:77792393:T:C	0	0	0	0	0	0	0	0
chr10:77793915:T:C	0	0	0	0	0	0	0	0
chr10:77805897:G:A	0	0	0	0	0	0	0	0
chr10:77806874:G:A	0	0	0	0	0	0	0	0
chr10:77819493:G:A	0	0	0	0	0	0	0	0
chr10:77869117:A:G	0	0	0	0	0	0	0	0
chr10:78033930:C:T	11	6	18	6	12	2	0	2
chr10:79557289:G:T	0	0	0	0	0	0	0	0
chr10:79557536:G:A	0	0	0	0	0	0	0	0
chr10:79941966:T:C	0	0	0	0	0	0	0	0
chr10:79946525:A:G	0	0	0	0	0	0	0	0
chr10:79946568:A:G	0	0	0	0	0	0	0	0
chr10:80081936:G:T	34	17	53	17	36	1.5	0.5	1.0
chr10:80166782:C:T	9	3	12	6	6	1	1	0
chr10:80166946:G:A	1166	628	2113	693	1420	2.0	1.0	2.0
chr10:80247462:C:T	0	0	0	0	0	0	0	0
chr10:80273838:G:A	0	0	0	0	0	0	0	0
chr10:80366844:G:A	0	0	0	0	0	0	0	0
chr10:80509482:C:T	2	1	3	1	2	1.5	0.5	1.0
chr10:80516305:C:T	5	2	9	3	6	1	1	0
chr10:80609463:T:A	0	0	0	0	0	0	0	0
chr10:84196512:C:A	0	0	0	0	0	0	0	0
chr10:84212287:A:G	0	0	0	0	0	0	0	0
chr10:84234154:G:A	0	0	0	0	0	0	0	0
chr10:84237349:G:T	0	0	0	0	0	0	0	0
chr10:84244980:A:G	0	0	0	0	0	0	0	0
chr10:84245117:T:C	0	0	0	0	0	0	0	0
chr10:86443451:T:C	1	0	1	1	0	1	1	0
chr10:86662271:C:G	0	0	0	0	0	0	0	0
chr10:87170492:A:T	17	9	27	9	18	2	0	2
chr10:87961150:T:G	30	16	46	14	32	2.0	0.0	2.0
chr10:88583080:C:G	52	20	72	32	40	1.0	1.0	0.0
chr10:88678450:A:G	0	0	0	0	0	0	0	0
chr10:88731164:G:A	0	0	0	0	0	0	0	0
chr10:88743318:T:C	0	0	0	0	0	0	0	0
chr10:88752549:G:C	0	0	0	0	0	0	0	0
chr10:88764480:T:C	7	4	13	3	10	2	0	2
chr10:89010682:C:G	2	1	3	1	2	1.5	0.5	1.0
chr10:89206636:G:A	0	0	0	0	0	0	0	0
chr10:89306192:A:C	6	4	12	4	8	2.0	0.0	2.0
chr10:89306318:A:G	6	4	12	4	8	2.0	0.0	2.0
chr10:89340186:C:G	1	0	1	1	0	1	1	0
chr10:89378069:T:C	0	0	0	0	0	0	0	0
chr10:89383772:T:A	0	0	0	0	0	0	0	0
chr10:89402920:C:T	5	3	9	3	6	2	1	2
chr10:89418243:C:T	40	16	58	26	32	1.0	1.0	0.0
chr10:89462530:A:C	0	0	0	0	0	0	0	0
chr10:89593209:G:A	4	2	6	2	4	1.5	0.5	1.0
chr10:90912807:T:C	0	0	0	0	0	0	0	0
chr10:91630392:C:T	0	0	0	0	0	0	0	0
chr10:91908353:T:A	38	12	50	26	24	1.0	1.0	0.0
chr10:91908383:T:C	38	27	65	11	54	2.0	0.0	2.0
chr10:92834808:G:A	3	0	3	3	0	1	1	0
chr10:93062929:C:T	0	0	0	0	0	0	0	0
chr10:93374950:G:A	0	0	0	0	0	0	0	0
chr10:93482229:C:A	0	0	0	0	0	0	0	0
chr10:93587279:G:C	0	0	0	0	0	0	0	0
chr10:94031688:A:T	0	0	0	0	0	0	0	0
chr10:94031856:T:C	0	0	0	0	0	0	0	0
chr10:94032006:G:A	0	0	0	0	0	0	0	0
chr10:94171330:G:T	0	0	0	0	0	0	0	0
chr10:94298541:C:T	0	0	0	0	0	0	0	0
chr10:94306584:A:G	1	1	2	0	2	2	0	2
chr10:94316738:C:G	5	3	8	2	6	2	0	2
chr10:94338616:C:T	118	62	181	58	123	2.0	0.0	2.0
chr10:94733301:C:T	0	0	0	0	0	0	0	0
chr10:94735475:C:T	0	0	0	0	0	0	0	0
chr10:94735527:G:A	0	0	0	0	0	0	0	0
chr10:94781859:G:A	0	0	0	0	0	0	0	0
chr10:95037104:G:A	4	4	8	0	8	2.0	0.0	2.0
chr10:95067421:T:C	1	1	2	0	2	2	0	2
chr10:95211881:G:A	0	0	0	0	0	0	0	0
chr10:95237852:G:A	1050	514	1778	670	1108	2.0	1.0	0.0
chr10:95263873:T:C	1001	582	1794	528	1266	2	0	2
chr10:95381766:G:A	1	0	1	1	0	1	1	0
chr10:95687616:A:T	41	18	59	23	36	1	1	0
chr10:95847408:G:A	0	0	0	0	0	0	0	0
chr10:96204505:C:G	5	4	9	1	8	2	0	2
chr10:96216609:C:T	390	219	642	180	462	2.0	0.0	2.0
chr10:96318449:C:T	0	0	0	0	0	0	0	0
chr10:96338241:T:A	0	0	0	0	0	0	0	0
chr10:96373525:G:C	0	0	0	0	0	0	0	0
chr10:96373726:G:A	0	0	0	0	0	0	0	0
chr10:96609779:A:G	16	8	24	8	16	1.5	0.5	1.0
chr10:96620380:T:C	28	12	40	16	24	1.0	1.0	0.0
chr10:96620520:C:T	28	16	44	12	32	2.0	0.0	2.0
chr10:96709750:C:A	131	71	205	61	144	2	0	2
chr10:96982993:A:C	4	2	6	2	4	1.5	0.5	1.0
chr10:97059560:A:G	0	0	0	0	0	0	0	0
chr10:97246326:G:A	51	20	71	31	40	1	1	0
chr10:97265854:T:A	1	0	1	1	0	1	1	0
chr10:97366192:C:T	15	7	22	8	14	1	1	0
chr10:97367166:G:A	4	3	7	1	6	2.0	0.0	2.0
chr10:97369473:T:C	10	5	15	5	10	1.5	0.5	1.0
chr10:97379383:G:A	7	5	12	2	10	2	0	2
chr10:97445974:A:G	533	284	859	276	583	2	0	2
chr10:97460128:G:A	26	16	42	10	32	2.0	0.0	2.0
chr10:97460950:C:T	15	5	20	10	10	1	1	0
chr10:97572731:A:C	0	0	0	0	0	0	0	0
chr10:97577815:G:A	0	0	0	0	0	0	0	0
chr10:97590260:G:C	0	0	0	0	0	0	0	0
chr10:97590371:A:G	0	0	0	0	0	0	0	0
chr10:97599144:G:A	0	0	0	0	0	0	0	0
chr10:97600230:G:A	0	0	0	0	0	0	0	0
chr10:97611587:C:A	0	0	0	0	0	0	0	0
chr10:97679784:G:C	30	17	47	13	34	2.0	0.0	2.0
chr10:97744838:G:A	35	17	52	18	34	1	1	0
chr10:97744873:G:T	35	18	53	17	36	2	0	2
chr10:97750311:G:T	2	0	2	2	0	1.0	1.0	0.0
chr10:97759340:A:G	29	13	42	16	26	1	1	0
chr10:98255806:G:C	0	0	0	0	0	0	0	0
chr10:98259087:G:A	0	0	0	0	0	0	0	0
chr10:98385025:C:T	2	1	3	1	2	1.5	0.5	1.0
chr10:98387303:A:G	2	1	3	1	2	1.5	0.5	1.0
chr10:98388419:A:G	2	1	3	1	2	1.5	0.5	1.0
chr10:98407639:G:A	2	1	3	1	2	1.5	0.5	1.0
chr10:98429381:A:G	84	53	140	32	108	2.0	0.0	2.0
chr10:98431163:G:A	99	62	161	37	124	2	0	2
chr10:99368605:C:A	0	0	0	0	0	0	0	0
chr10:99387963:C:T	0	0	0	0	0	0	0	0
chr10:99533278:C:A	0	0	0	0	0	0	0	0
chr10:99685834:A:C	1	1	2	0	2	2	0	2
chr10:99691502:T:C	4	2	6	2	4	1.5	0.5	1.0
chr10:99732484:G:A	37	21	60	16	44	2	0	2
chr10:99743211:A:G	243	115	365	132	233	1	1	0
chr10:99804058:G:A	0	0	0	0	0	0	0	0
chr10:99930293:C:T	2	1	3	1	2	1.5	0.5	1.0
chr10:100347494:C:G	1	0	1	1	0	1	1	0
chr10:100356554:A:C	1	0	1	1	0	1	1	0
chr10:100497591:C:T	0	0	0	0	0	0	0	0
chr10:101008397:G:T	0	0	0	0	0	0	0	0
chr10:101030305:T:C	6	3	9	3	6	1.5	0.5	1.0
chr10:101038589:T:C	11	4	15	7	8	1	1	0
chr10:101064592:G:C	0	0	0	0	0	0	0	0
chr10:101131633:G:A	0	0	0	0	0	0	0	0
chr10:101228588:G:A	0	0	0	0	0	0	0	0
chr10:101694572:G:C	85	38	123	47	76	1	1	0
chr10:101798944:G:A	160	83	246	78	168	2.0	0.0	2.0
chr10:101817969:G:A	287	152	463	147	316	2	0	2
chr10:102065990:G:A	23	11	34	12	22	1	1	0
chr10:102140972:G:A	2	0	2	2	0	1.0	1.0	0.0
chr10:102160718:T:C	85	37	125	49	76	1	1	0
chr10:102162306:G:C	30	15	48	16	32	1.5	1.0	1.0
chr10:102366431:C:T	0	0	0	0	0	0	0	0
chr10:102399939:G:A	4	1	5	3	2	1.0	1.0	0.0
chr10:102404731:G:A	0	0	0	0	0	0	0	0
chr10:102482226:T:C	1	1	2	0	2	2	0	2
chr10:102726547:G:C	1	0	1	1	0	1	1	0
chr10:102831636:G:T	0	0	0	0	0	0	0	0
chr10:102832492:A:C	0	0	0	0	0	0	0	0
chr10:102834750:A:G	0	0	0	0	0	0	0	0
chr10:102835491:G:A	0	0	0	0	0	0	0	0
chr10:102890548:G:A	0	0	0	0	0	0	0	0
chr10:103076162:C:T	1	0	1	1	0	1	1	0
chr10:103077183:C:T	1	0	1	1	0	1	1	0
chr10:103174952:T:C	78	44	125	35	90	2.0	0.0	2.0
chr10:103445599:C:T	14	6	20	8	12	1.0	1.0	0.0
chr10:103602059:T:G	13	3	16	10	6	1	1	0
chr10:103602530:C:G	11	2	13	9	4	1	1	0
chr10:104002833:G:A	20	8	28	12	16	1.0	1.0	0.0
chr10:104005987:A:G	7	4	11	3	8	2	0	2
chr10:104032171:C:G	0	0	0	0	0	0	0	0
chr10:104033992:T:C	0	0	0	0	0	0	0	0
chr10:104039114:T:C	0	0	0	0	0	0	0	0
chr10:104039458:G:T	0	0	0	0	0	0	0	0
chr10:104060198:G:A	0	0	0	0	0	0	0	0
chr10:104064575:G:A	0	0	0	0	0	0	0	0
chr10:104123007:A:G	95	43	142	52	90	1	1	0
chr10:104167702:C:T	0	0	0	0	0	0	0	0
chr10:104315323:G:A	6	4	10	2	8	2.0	0.0	2.0
chr10:105147682:C:T	0	0	0	0	0	0	0	0
chr10:110228202:C:T	54	32	88	22	66	2.0	0.0	2.0
chr10:110298668:T:C	275	145	442	140	302	2	0	2
chr10:112395057:C:T	53	24	77	29	48	1	1	0
chr10:112409518:A:G	41	19	60	22	38	1	1	0
chr10:112426399:C:T	4	0	4	4	0	1.0	1.0	0.0
chr10:112440597:G:A	59	30	89	29	60	2	0	2
chr10:113574365:C:T	0	0	0	0	0	0	0	0
chr10:113850156:C:G	3	2	5	1	4	2	0	2
chr10:114547745:A:G	0	0	0	0	0	0	0	0
chr10:114631980:A:C	0	0	0	0	0	0	0	0
chr10:114833416:C:T	76	37	117	39	78	1.0	1.0	0.0
chr10:114843046:A:G	4	3	7	1	6	2.0	0.0	2.0
chr10:116469251:T:C	0	0	0	0	0	0	0	0
chr10:116553753:T:C	0	0	0	0	0	0	0	0
chr10:116605455:G:C	0	0	0	0	0	0	0	0
chr10:116609094:T:C	0	0	0	0	0	0	0	0
chr10:116627771:A:G	0	0	0	0	0	0	0	0
chr10:116645109:A:G	0	0	0	0	0	0	0	0
chr10:116856599:C:T	0	0	0	0	0	0	0	0
chr10:116860948:A:C	0	0	0	0	0	0	0	0
chr10:119670121:T:C	42	23	68	20	48	2.0	0.0	2.0
chr10:119792069:A:C	267	139	442	148	294	2	1	2
chr10:119827370:A:G	34	15	50	20	30	1.0	1.0	0.0
chr10:119919501:A:G	12	5	17	7	10	1.0	1.0	0.0
chr10:120905455:C:T	6	2	8	4	4	1.0	1.0	0.0
chr10:121479598:G:A	0	0	0	0	0	0	0	0
chr10:121743672:T:C	7	4	11	3	8	2	0	2
chr10:121790176:T:G	19	11	30	8	22	2	0	2
chr10:122083008:G:A	0	0	0	0	0	0	0	0
chr10:122084988:C:T	0	0	0	0	0	0	0	0
chr10:122085696:G:A	0	0	0	0	0	0	0	0
chr10:122086382:G:C	0	0	0	0	0	0	0	0
chr10:122086773:G:A	0	0	0	0	0	0	0	0
chr10:122086970:A:G	0	0	0	0	0	0	0	0
chr10:122087345:C:T	0	0	0	0	0	0	0	0
chr10:122087840:G:A	0	0	0	0	0	0	0	0
chr10:122237455:G:A	0	0	0	0	0	0	0	0
chr10:122254089:C:A	0	0	0	0	0	0	0	0
chr10:122429681:A:G	24	10	34	14	20	1.0	1.0	0.0
chr10:122698390:C:T	0	0	0	0	0	0	0	0
chr10:122699623:T:C	0	0	0	0	0	0	0	0
chr10:123666896:A:G	0	0	0	0	0	0	0	0
chr10:123688189:A:G	0	0	0	0	0	0	0	0
chr10:123762017:G:A	0	0	0	0	0	0	0	0
chr10:123762074:G:A	0	0	0	0	0	0	0	0
chr10:123762161:G:A	0	0	0	0	0	0	0	0
chr10:124829420:G:A	83	46	130	38	92	2	0	2
chr10:124998193:C:T	0	0	0	0	0	0	0	0
chr10:124998258:T:A	0	0	0	0	0	0	0	0
chr10:125026506:T:C	0	0	0	0	0	0	0	0
chr10:125026867:C:T	0	0	0	0	0	0	0	0
chr10:125896581:C:A	3	0	3	3	0	1	1	0
chr10:125896610:G:C	3	0	3	3	0	1	1	0
chr10:126004910:A:G	0	0	0	0	0	0	0	0
chr10:126049361:G:A	0	0	0	0	0	0	0	0
chr10:126064705:G:A	0	0	0	0	0	0	0	0
chr10:126064909:G:A	0	0	0	0	0	0	0	0
chr10:126330456:C:G	0	0	0	0	0	0	0	0
chr10:126425756:G:A	0	0	0	0	0	0	0	0
chr10:127444251:G:A	0	0	0	0	0	0	0	0
chr10:127447420:G:A	0	0	0	0	0	0	0	0
chr10:128047638:G:A	110	53	170	62	108	2.0	1.0	0.0
chr10:128047746:G:A	29	14	43	15	28	1	1	0
chr10:128068185:C:G	13	5	18	8	10	1	1	0
chr10:128073426:A:G	20	10	30	10	20	1.5	0.5	1.0
chr10:128101279:C:T	0	0	0	0	0	0	0	0
chr10:128102594:C:T	0	0	0	0	0	0	0	0
chr10:128103129:T:C	0	0	0	0	0	0	0	0
chr10:128103237:G:C	0	0	0	0	0	0	0	0
chr10:128103458:GGCAC:AGCAT	0	0	0	0	0	0	0	0
chr10:128103483:C:T	0	0	0	0	0	0	0	0
chr10:128103682:T:G	0	0	0	0	0	0	0	0
chr10:128103894:C:T	0	0	0	0	0	0	0	0
chr10:128105201:A:G	0	0	0	0	0	0	0	0
chr10:128106210:GGCC:AGCT	0	0	0	0	0	0	0	0
chr10:128106390:C:G	0	0	0	0	0	0	0	0
chr10:128107165:C:T	0	0	0	0	0	0	0	0
chr10:128107632:T:A	0	0	0	0	0	0	0	0
chr10:128108100:G:A	0	0	0	0	0	0	0	0
chr10:128108204:C:T	0	0	0	0	0	0	0	0
chr10:128108716:C:T	0	0	0	0	0	0	0	0
chr10:128109280:G:C	0	0	0	0	0	0	0	0
chr10:128112211:T:G	0	0	0	0	0	0	0	0
chr10:128113592:C:G	0	0	0	0	0	0	0	0
chr10:128115696:A:T	0	0	0	0	0	0	0	0
chr10:128122931:A:T	0	0	0	0	0	0	0	0
chr10:131955978:G:C	21	8	29	13	16	1	1	0
chr10:132104868:G:A	0	0	0	0	0	0	0	0
chr10:132104916:G:A	0	0	0	0	0	0	0	0
chr10:132135130:T:C	0	0	0	0	0	0	0	0
chr10:132140507:C:T	0	0	0	0	0	0	0	0
chr10:132141923:A:G	0	0	0	0	0	0	0	0
chr10:132147990:C:T	0	0	0	0	0	0	0	0
chr10:132168178:G:A	0	0	0	0	0	0	0	0
chr10:132200402:C:T	0	0	0	0	0	0	0	0
chr10:132208002:G:A	0	0	0	0	0	0	0	0
chr10:132808904:T:C	0	0	0	0	0	0	0	0
chr10:132810455:T:C	0	0	0	0	0	0	0	0
chr10:132860782:C:G	0	0	0	0	0	0	0	0
chr10:133128662:A:G	0	0	0	0	0	0	0	0
chr10:133128836:C:T	0	0	0	0	0	0	0	0
chr10:133129328:G:A	0	0	0	0	0	0	0	0
chr10:133129581:G:A	0	0	0	0	0	0	0	0
chr10:133167351:C:T	0	0	0	0	0	0	0	0
chr10:133238039:T:C	0	0	0	0	0	0	0	0
chr10:133238058:A:G	0	0	0	0	0	0	0	0
chr11:205889:T:C	3	1	4	2	2	1	1	0
chr11:212408:C:T	3	0	3	3	0	1	1	0
chr11:236094:A:G	276	129	415	153	262	1.0	1.0	0.0
chr11:237087:A:G	533	294	884	273	611	2	0	2
chr11:375804:G:A	0	0	0	0	0	0	0	0
chr11:400124:C:G	1	1	2	0	2	2	0	2
chr11:404468:G:A	0	0	0	0	0	0	0	0
chr11:406043:G:A	411	146	590	290	300	1	1	0
chr11:406473:A:C	409	145	588	288	300	1	1	0
chr11:406483:T:C	409	145	589	289	300	1	1	0
chr11:409815:G:A	0	0	0	0	0	0	0	0
chr11:558232:C:T	20	7	27	13	14	1.0	1.0	0.0
chr11:587425:C:A	21	12	33	9	24	2	0	2
chr11:607175:G:A	3	2	5	1	4	2	0	2
chr11:609068:G:A	9	7	16	2	14	2	0	2
chr11:609353:G:A	10	7	17	3	14	2.0	0.0	2.0
chr11:611802:C:G	28	17	45	11	34	2.0	0.0	2.0
chr11:611919:C:G	29	18	47	11	36	2	0	2
chr11:613165:G:C	23	13	36	10	26	2	0	2
chr11:613297:T:G	282	115	417	177	240	1.0	1.0	0.0
chr11:614318:T:C	220	97	331	127	204	1.0	1.0	0.0
chr11:615010:GA:TT	21	12	33	9	24	2	0	2
chr11:617378:C:T	1	1	2	0	2	2	0	2
chr11:617420:A:G	1	1	2	0	2	2	0	2
chr11:617519:A:G	1	1	2	0	2	2	0	2
chr11:617537:C:T	1	0	1	1	0	1	1	0
chr11:618013:C:T	1	1	2	0	2	2	0	2
chr11:618998:G:A	0	0	0	0	0	0	0	0
chr11:619789:T:G	0	0	0	0	0	0	0	0
chr11:674499:G:A	4	1	5	3	2	1.0	1.0	0.0
chr11:720197:C:T	3	2	5	1	4	2	0	2
chr11:721570:C:T	29	25	54	4	50	2	0	2
chr11:771034:A:G	34	18	53	17	36	2.0	0.5	2.0
chr11:772490:G:A	35	20	56	16	40	2	0	2
chr11:836043:C:T	25	15	40	10	30	2	0	2
chr11:1026048:G:A	0	0	0	0	0	0	0	0
chr11:1029320:C:T	0	0	0	0	0	0	0	0
chr11:1051715:T:C	0	0	0	0	0	0	0	0
chr11:1075850:G:A	0	0	0	0	0	0	0	0
chr11:1075920:G:A	0	0	0	0	0	0	0	0
chr11:1081750:C:T	0	0	0	0	0	0	0	0
chr11:1096322:C:A	0	0	0	0	0	0	0	0
chr11:1099802:G:C	0	0	0	0	0	0	0	0
chr11:1103841:A:C	0	0	0	0	0	0	0	0
chr11:1107741:T:C	0	0	0	0	0	0	0	0
chr11:1190037:C:T	0	0	0	0	0	0	0	0
chr11:1225711:A:G	0	0	0	0	0	0	0	0
chr11:1230071:C:T	0	0	0	0	0	0	0	0
chr11:1231478:G:C	0	0	0	0	0	0	0	0
chr11:1232712:T:C	0	0	0	0	0	0	0	0
chr11:1241269:C:T	0	0	0	0	0	0	0	0
chr11:1241677:T:C	0	0	0	0	0	0	0	0
chr11:1242457:C:T	0	0	0	0	0	0	0	0
chr11:1242527:A:G	0	0	0	0	0	0	0	0
chr11:1242702:C:G	0	0	0	0	0	0	0	0
chr11:1242928:TGC:CGT	0	0	0	0	0	0	0	0
chr11:1243660:A:G	0	0	0	0	0	0	0	0
chr11:1243735:G:A	0	0	0	0	0	0	0	0
chr11:1244154:T:C	0	0	0	0	0	0	0	0
chr11:1244192:G:A	0	0	0	0	0	0	0	0
chr11:1244220:A:C	0	0	0	0	0	0	0	0
chr11:1244624:A:G	0	0	0	0	0	0	0	0
chr11:1244709:C:G	0	0	0	0	0	0	0	0
chr11:1245780:A:G	0	0	0	0	0	0	0	0
chr11:1245890:G:A	0	0	0	0	0	0	0	0
chr11:1246059:AAT:CAC	0	0	0	0	0	0	0	0
chr11:1246245:T:C	0	0	0	0	0	0	0	0
chr11:1246381:C:G	0	0	0	0	0	0	0	0
chr11:1246458:T:C	0	0	0	0	0	0	0	0
chr11:1246473:G:C	0	0	0	0	0	0	0	0
chr11:1246483:C:G	0	0	0	0	0	0	0	0
chr11:1246497:T:C	0	0	0	0	0	0	0	0
chr11:1246506:G:A	0	0	0	0	0	0	0	0
chr11:1248626:CCCAC:GCCAG	0	0	0	0	0	0	0	0
chr11:1249847:G:T	0	0	0	0	0	0	0	0
chr11:1250269:C:T	0	0	0	0	0	0	0	0
chr11:1250554:T:C	0	0	0	0	0	0	0	0
chr11:1251598:T:C	0	0	0	0	0	0	0	0
chr11:1252416:T:C	0	0	0	0	0	0	0	0
chr11:1254324:C:T	0	0	0	0	0	0	0	0
chr11:1254758:T:C	0	0	0	0	0	0	0	0
chr11:1255464:T:C	0	0	0	0	0	0	0	0
chr11:1255545:C:T	0	0	0	0	0	0	0	0
chr11:1256664:C:T	0	0	0	0	0	0	0	0
chr11:1257566:G:A	0	0	0	0	0	0	0	0
chr11:1257682:G:C	0	0	0	0	0	0	0	0
chr11:1258124:G:A	0	0	0	0	0	0	0	0
chr11:1288726:C:T	195	104	305	97	208	2	0	2
chr11:1454476:A:G	0	0	0	0	0	0	0	0
chr11:1480440:G:C	191	106	299	87	212	2	0	2
chr11:1480867:A:G	188	104	292	86	206	2.0	0.0	2.0
chr11:1486501:A:G	0	0	0	0	0	0	0	0
chr11:1607718:G:A	0	0	0	0	0	0	0	0
chr11:1607735:G:A	0	0	0	0	0	0	0	0
chr11:1607762:G:A	0	0	0	0	0	0	0	0
chr11:1629890:G:T	0	0	0	0	0	0	0	0
chr11:1755102:G:A	0	0	0	0	0	0	0	0
chr11:1834624:G:C	0	0	0	0	0	0	0	0
chr11:1870675:C:G	1	1	2	0	2	2	0	2
chr11:1884423:G:C	1	1	2	0	2	2	0	2
chr11:1929072:A:G	0	0	0	0	0	0	0	0
chr11:1934982:T:C	0	0	0	0	0	0	0	0
chr11:2167008:C:T	0	0	0	0	0	0	0	0
chr11:2169721:C:T	0	0	0	0	0	0	0	0
chr11:2414716:A:G	0	0	0	0	0	0	0	0
chr11:2414726:C:T	0	0	0	0	0	0	0	0
chr11:2418312:A:G	0	0	0	0	0	0	0	0
chr11:2418537:T:C	0	0	0	0	0	0	0	0
chr11:2661922:T:G	0	0	0	0	0	0	0	0
chr11:2662127:A:G	0	0	0	0	0	0	0	0
chr11:2776007:G:A	6	3	9	3	6	1.5	0.5	1.0
chr11:2885574:C:T	0	0	0	0	0	0	0	0
chr11:2903380:G:A	24	11	35	13	22	1.0	1.0	0.0
chr11:2908322:A:G	17	8	24	9	15	1	1	0
chr11:3006910:G:A	67	39	105	28	77	2	0	2
chr11:3028980:A:G	5	2	7	3	4	1	1	0
chr11:3090636:C:T	19	15	34	4	30	2	0	2
chr11:3107797:G:A	13	9	22	4	18	2	0	2
chr11:3228322:C:T	0	0	0	0	0	0	0	0
chr11:3228754:C:T	0	0	0	0	0	0	0	0
chr11:3360139:G:C	37	17	54	20	34	1	1	0
chr11:3371121:T:C	0	0	0	0	0	0	0	0
chr11:3371127:T:G	0	0	0	0	0	0	0	0
chr11:3373664:G:A	4	4	8	0	8	2.0	0.0	2.0
chr11:3413899:A:G	0	0	0	0	0	0	0	0
chr11:3413910:G:A	0	0	0	0	0	0	0	0
chr11:3660289:T:C	0	0	0	0	0	0	0	0
chr11:4489055:A:G	0	0	0	0	0	0	0	0
chr11:4489357:C:T	0	0	0	0	0	0	0	0
chr11:4587032:A:C	0	0	0	0	0	0	0	0
chr11:4594004:A:G	0	0	0	0	0	0	0	0
chr11:4594278:C:G	0	0	0	0	0	0	0	0
chr11:4640055:A:G	0	0	0	0	0	0	0	0
chr11:4640857:T:C	0	0	0	0	0	0	0	0
chr11:4653113:G:A	0	0	0	0	0	0	0	0
chr11:4653345:G:A	0	0	0	0	0	0	0	0
chr11:4848419:G:A	0	0	0	0	0	0	0	0
chr11:4848909:G:A	0	0	0	0	0	0	0	0
chr11:4849031:G:C	0	0	0	0	0	0	0	0
chr11:4849039:A:T	0	0	0	0	0	0	0	0
chr11:4849068:T:G	0	0	0	0	0	0	0	0
chr11:4859662:T:C	0	0	0	0	0	0	0	0
chr11:4859762:C:G	0	0	0	0	0	0	0	0
chr11:4907391:G:A	0	0	0	0	0	0	0	0
chr11:4907611:T:C	0	0	0	0	0	0	0	0
chr11:4907831:C:G	0	0	0	0	0	0	0	0
chr11:4915378:C:G	0	0	0	0	0	0	0	0
chr11:4923966:T:G	0	0	0	0	0	0	0	0
chr11:4923999:G:A	0	0	0	0	0	0	0	0
chr11:4999825:C:G	0	0	0	0	0	0	0	0
chr11:5059129:G:A	0	0	0	0	0	0	0	0
chr11:5059614:T:C	0	0	0	0	0	0	0	0
chr11:5226503:A:C	0	0	0	0	0	0	0	0
chr11:5248353:GTGA:AGAG	0	0	0	0	0	0	0	0
chr11:5248576:C:T	0	0	0	0	0	0	0	0
chr11:5301507:A:G	0	0	0	0	0	0	0	0
chr11:5301841:C:T	0	0	0	0	0	0	0	0
chr11:5343220:A:G	0	0	0	0	0	0	0	0
chr11:5343512:C:T	0	0	0	0	0	0	0	0
chr11:5351521:A:C	1	1	2	0	2	2	0	2
chr11:5351626:A:G	1	1	2	0	2	2	0	2
chr11:5352332:C:A	0	0	0	0	0	0	0	0
chr11:5402820:G:A	0	0	0	0	0	0	0	0
chr11:5403200:A:G	0	0	0	0	0	0	0	0
chr11:5422212:G:C	0	0	0	0	0	0	0	0
chr11:5422470:C:T	0	0	0	0	0	0	0	0
chr11:5422509:T:C	0	0	0	0	0	0	0	0
chr11:5422831:G:A	1	1	2	0	2	2	0	2
chr11:5422906:C:T	1	1	2	0	2	2	0	2
chr11:5440761:C:A	0	0	0	0	0	0	0	0
chr11:5440855:G:A	0	0	0	0	0	0	0	0
chr11:5441025:C:G	0	0	0	0	0	0	0	0
chr11:5453608:G:T	1	1	2	0	2	2	0	2
chr11:5454367:C:T	0	0	0	0	0	0	0	0
chr11:5489458:T:C	0	0	0	0	0	0	0	0
chr11:5507688:C:T	0	0	0	0	0	0	0	0
chr11:5581045:A:G	1	0	1	1	0	1	1	0
chr11:5581208:T:A	1	0	1	1	0	1	1	0
chr11:5581560:A:G	0	0	0	0	0	0	0	0
chr11:5643601:C:A	25	9	35	17	18	1	1	0
chr11:5679110:T:C	26	15	41	11	30	2.0	0.0	2.0
chr11:5679771:C:T	27	16	42	11	31	2	0	2
chr11:5680051:G:A	26	10	36	16	20	1.0	1.0	0.0
chr11:5680179:G:C	27	10	37	17	20	1	1	0
chr11:5698520:G:C	92	42	132	53	79	1.0	1.0	0.0
chr11:5709113:G:A	101	58	163	45	118	2	0	2
chr11:5755254:A:T	0	0	0	0	0	0	0	0
chr11:5788247:A:G	0	0	0	0	0	0	0	0
chr11:5788318:G:A	0	0	0	0	0	0	0	0
chr11:5788443:C:T	0	0	0	0	0	0	0	0
chr11:5788516:C:T	0	0	0	0	0	0	0	0
chr11:5788850:T:C	0	0	0	0	0	0	0	0
chr11:5821080:T:G	0	0	0	0	0	0	0	0
chr11:5821126:A:G	0	0	0	0	0	0	0	0
chr11:5841302:A:C	0	0	0	0	0	0	0	0
chr11:5841423:T:C	0	0	0	0	0	0	0	0
chr11:5841550:T:C	0	0	0	0	0	0	0	0
chr11:5841883:G:A	0	0	0	0	0	0	0	0
chr11:5856749:T:A	0	0	0	0	0	0	0	0
chr11:5884913:T:C	0	0	0	0	0	0	0	0
chr11:5884973:T:G	0	0	0	0	0	0	0	0
chr11:5884975:G:A	0	0	0	0	0	0	0	0
chr11:5885061:T:C	0	0	0	0	0	0	0	0
chr11:5900992:T:C	0	0	0	0	0	0	0	0
chr11:5947498:T:C	0	0	0	0	0	0	0	0
chr11:5968063:G:A	0	0	0	0	0	0	0	0
chr11:5968185:C:T	0	0	0	0	0	0	0	0
chr11:6002351:A:G	0	0	0	0	0	0	0	0
chr11:6002410:T:C	0	0	0	0	0	0	0	0
chr11:6002588:G:A	0	0	0	0	0	0	0	0
chr11:6057771:G:A	0	0	0	0	0	0	0	0
chr11:6057798:C:T	0	0	0	0	0	0	0	0
chr11:6108607:C:T	0	0	0	0	0	0	0	0
chr11:6200197:T:C	0	0	0	0	0	0	0	0
chr11:6217909:A:G	13	6	19	7	12	1	1	0
chr11:6394460:G:A	71	32	103	39	64	1	1	0
chr11:6498133:C:G	14	8	22	6	16	2.0	0.0	2.0
chr11:6498412:G:A	15	9	24	6	18	2	0	2
chr11:6498785:G:T	5	3	8	2	6	2	0	2
chr11:6498934:T:A	6	4	10	2	8	2.0	0.0	2.0
chr11:6509048:C:T	2	1	3	1	2	1.5	0.5	1.0
chr11:6511289:C:T	3	2	5	1	4	2	0	2
chr11:6520350:T:G	3	1	4	2	2	1	1	0
chr11:6528549:A:C	1	0	2	2	0	2	2	0
chr11:6529079:G:A	2	0	3	3	0	1.5	1.5	0.0
chr11:6540040:A:G	1	0	1	1	0	1	1	0
chr11:6546361:C:T	2	2	4	0	4	2.0	0.0	2.0
chr11:6546983:T:C	2	2	4	0	4	2.0	0.0	2.0
chr11:6556774:G:A	2	1	3	1	2	1.5	0.5	1.0
chr11:6558309:A:G	0	0	0	0	0	0	0	0
chr11:6563802:G:A	3	1	4	2	2	1	1	0
chr11:6570359:A:C	1	1	2	0	2	2	0	2
chr11:6571574:C:T	3	1	4	2	2	1	1	0
chr11:6571721:T:C	9	4	13	5	8	1	1	0
chr11:6600286:G:A	4	3	7	1	6	2.0	0.0	2.0
chr11:6600686:A:G	60	28	90	32	58	1.0	1.0	0.0
chr11:6608300:G:A	4	1	5	3	2	1.0	1.0	0.0
chr11:6609179:T:C	9	2	11	7	4	1	1	0
chr11:6609785:C:T	260	143	426	128	298	2.0	0.0	2.0
chr11:6611219:C:T	344	170	529	181	348	2.0	1.0	0.0
chr11:6611626:A:T	25	16	41	9	32	2	0	2
chr11:6615669:G:C	2	1	3	1	2	1.5	0.5	1.0
chr11:6617275:A:T	68	34	102	35	67	1.0	1.0	0.5
chr11:6622203:C:T	0	0	0	0	0	0	0	0
chr11:6622745:C:T	0	0	0	0	0	0	0	0
chr11:6623369:C:T	0	0	0	0	0	0	0	0
chr11:6627193:G:A	0	0	0	0	0	0	0	0
chr11:6631387:C:T	0	0	0	0	0	0	0	0
chr11:6634202:G:A	0	0	0	0	0	0	0	0
chr11:6640369:G:T	0	0	0	0	0	0	0	0
chr11:6768698:C:A	0	0	0	0	0	0	0	0
chr11:6768797:C:G	0	0	0	0	0	0	0	0
chr11:6785265:T:C	0	0	0	0	0	0	0	0
chr11:6785596:G:T	0	0	0	0	0	0	0	0
chr11:6785932:C:G	0	0	0	0	0	0	0	0
chr11:6795547:A:G	0	0	0	0	0	0	0	0
chr11:6869708:C:T	0	0	0	0	0	0	0	0
chr11:6869882:A:G	0	0	0	0	0	0	0	0
chr11:6870154:G:A	0	0	0	0	0	0	0	0
chr11:6870297:C:G	0	0	0	0	0	0	0	0
chr11:6870374:A:G	0	0	0	0	0	0	0	0
chr11:6870527:A:C	0	0	0	0	0	0	0	0
chr11:6877264:T:C	0	0	0	0	0	0	0	0
chr11:6877527:A:C	0	0	0	0	0	0	0	0
chr11:6891896:A:G	0	0	0	0	0	0	0	0
chr11:6892059:A:G	0	0	0	0	0	0	0	0
chr11:6921245:C:A	0	0	0	0	0	0	0	0
chr11:6921397:A:C	0	0	0	0	0	0	0	0
chr11:6921721:T:C	0	0	0	0	0	0	0	0
chr11:6922023:C:T	0	0	0	0	0	0	0	0
chr11:6955757:A:T	0	0	0	0	0	0	0	0
chr11:7038750:G:A	0	0	0	0	0	0	0	0
chr11:7057807:G:A	0	0	0	0	0	0	0	0
chr11:7089132:G:A	0	0	0	0	0	0	0	0
chr11:7089317:C:T	0	0	0	0	0	0	0	0
chr11:7485943:C:T	0	0	0	0	0	0	0	0
chr11:7485951:A:G	0	0	0	0	0	0	0	0
chr11:7488343:G:A	0	0	0	0	0	0	0	0
chr11:7605866:A:T	3	0	3	3	0	1	1	0
chr11:7641501:C:T	3	1	4	2	2	1	1	0
chr11:7651784:G:A	3	1	4	2	2	1	1	0
chr11:7653272:G:A	6	4	10	2	8	2.0	0.0	2.0
chr11:7665353:A:T	3	0	3	3	0	1	1	0
chr11:7665579:C:G	0	0	0	0	0	0	0	0
chr11:7667798:A:C	4	3	7	1	6	2.0	0.0	2.0
chr11:7669747:C:G	2	0	2	2	0	1.0	1.0	0.0
chr11:7987694:C:T	1819	1079	3761	1219	2542	2	1	2
chr11:7994952:C:T	3	3	6	0	6	2	0	2
chr11:8039684:G:A	0	0	0	0	0	0	0	0
chr11:8230374:G:C	0	0	0	0	0	0	0	0
chr11:8474969:G:A	0	0	0	0	0	0	0	0
chr11:8624690:G:T	1	0	1	1	0	1	1	0
chr11:8625123:T:G	1	1	2	0	2	2	0	2
chr11:8625216:G:C	1	1	2	0	2	2	0	2
chr11:8640969:T:C	3	2	5	1	4	2	0	2
chr11:8685686:C:T	1160	636	2099	687	1412	2.0	1.0	2.0
chr11:8697715:G:A	5	4	9	1	8	2	0	2
chr11:8730093:G:C	0	0	0	0	0	0	0	0
chr11:8731051:G:C	0	0	0	0	0	0	0	0
chr11:9065986:A:G	0	0	0	0	0	0	0	0
chr11:9732674:C:T	242	115	367	131	236	1.0	1.0	0.0
chr11:9748015:C:G	244	117	373	131	242	1.0	1.0	0.0
chr11:9780378:T:G	2	1	3	1	2	1.5	0.5	1.0
chr11:10456300:C:T	6	3	10	4	6	2.0	0.5	1.0
chr11:10500217:T:C	5	2	7	3	4	1	1	0
chr11:10559137:C:T	0	0	0	0	0	0	0	0
chr11:10559890:G:T	0	0	0	0	0	0	0	0
chr11:10626155:G:A	0	0	0	0	0	0	0	0
chr11:10627746:G:A	0	0	0	0	0	0	0	0
chr11:10628782:C:T	0	0	0	0	0	0	0	0
chr11:10693577:T:C	0	0	0	0	0	0	0	0
chr11:10806814:C:A	84	43	130	42	88	2.0	0.0	2.0
chr11:10853508:T:C	68	37	105	31	74	2.0	0.0	2.0
chr11:11332799:T:C	0	0	0	0	0	0	0	0
chr11:11352176:G:T	0	0	0	0	0	0	0	0
chr11:11352722:A:G	0	0	0	0	0	0	0	0
chr11:11892038:G:T	183	100	289	90	199	2	0	2
chr11:12261361:A:G	0	0	0	0	0	0	0	0
chr11:12262381:C:T	0	0	0	0	0	0	0	0
chr11:12293639:G:A	0	0	0	0	0	0	0	0
chr11:12294301:C:T	0	0	0	0	0	0	0	0
chr11:12294368:A:G	0	0	0	0	0	0	0	0
chr11:12881896:C:T	0	0	0	0	0	0	0	0
chr11:13963036:C:T	0	0	0	0	0	0	0	0
chr11:14243370:A:G	0	0	0	0	0	0	0	0
chr11:14892029:G:A	33	12	45	21	24	1	1	0
chr11:15178411:T:C	0	0	0	0	0	0	0	0
chr11:15643910:C:G	0	0	0	0	0	0	0	0
chr11:15705346:G:A	0	0	0	0	0	0	0	0
chr11:16738697:T:G	1484	767	2594	942	1652	2.0	1.0	2.0
chr11:16778891:G:A	3	2	5	1	4	2	0	2
chr11:16789052:C:T	1	0	1	1	0	1	1	0
chr11:16790850:G:A	3	0	3	3	0	1	1	0
chr11:17089725:A:G	3	1	4	2	2	1	1	0
chr11:17169472:A:G	68	35	105	33	72	2.0	0.0	2.0
chr11:17386857:C:T	4	1	5	3	2	1.0	1.0	0.0
chr11:17387083:C:T	5	2	7	3	4	1	1	0
chr11:17387522:G:A	5	2	7	3	4	1	1	0
chr11:17388025:T:C	0	0	0	0	0	0	0	0
chr11:17393210:C:T	0	0	0	0	0	0	0	0
chr11:17396930:C:A	11	5	16	6	10	1	1	0
chr11:17474969:A:G	0	0	0	0	0	0	0	0
chr11:17498195:C:G	0	0	0	0	0	0	0	0
chr11:17558503:A:C	0	0	0	0	0	0	0	0
chr11:17558628:A:T	0	0	0	0	0	0	0	0
chr11:17570414:C:T	0	0	0	0	0	0	0	0
chr11:17572162:T:C	0	0	0	0	0	0	0	0
chr11:17574766:G:A	0	0	0	0	0	0	0	0
chr11:17578486:G:A	0	0	0	0	0	0	0	0
chr11:17606066:G:C	0	0	0	0	0	0	0	0
chr11:17610204:C:T	0	0	0	0	0	0	0	0
chr11:17610759:C:T	0	0	0	0	0	0	0	0
chr11:17611104:C:T	0	0	0	0	0	0	0	0
chr11:17642195:G:C	0	0	0	0	0	0	0	0
chr11:18137446:T:C	0	0	0	0	0	0	0	0
chr11:18138121:TG:CA	0	0	0	0	0	0	0	0
chr11:18173246:G:A	0	0	0	0	0	0	0	0
chr11:18173280:C:G	0	0	0	0	0	0	0	0
chr11:18173331:T:G	0	0	0	0	0	0	0	0
chr11:18173397:T:A	0	0	0	0	0	0	0	0
chr11:18173417:A:G	0	0	0	0	0	0	0	0
chr11:18173901:C:T	0	0	0	0	0	0	0	0
chr11:18210368:T:C	0	0	0	0	0	0	0	0
chr11:18245480:C:T	2	0	2	2	0	1.0	1.0	0.0
chr11:18245924:A:G	3	0	3	3	0	1	1	0
chr11:18306137:G:T	38	18	56	20	36	1.0	1.0	0.0
chr11:18358082:C:A	2	0	2	2	0	1.0	1.0	0.0
chr11:18481612:C:T	0	0	0	0	0	0	0	0
chr11:18729494:C:T	0	0	0	0	0	0	0	0
chr11:18742479:G:C	0	0	0	0	0	0	0	0
chr11:19055464:A:C	0	0	0	0	0	0	0	0
chr11:19186294:C:T	0	0	0	0	0	0	0	0
chr11:19832542:G:A	0	0	0	0	0	0	0	0
chr11:19880086:G:A	0	0	0	0	0	0	0	0
chr11:20083123:G:A	0	0	0	0	0	0	0	0
chr11:20090946:G:A	0	0	0	0	0	0	0	0
chr11:20095686:T:C	0	0	0	0	0	0	0	0
chr11:20601461:C:T	0	0	0	0	0	0	0	0
chr11:20601477:C:T	0	0	0	0	0	0	0	0
chr11:20626834:G:A	0	0	0	0	0	0	0	0
chr11:20654871:C:T	0	0	0	0	0	0	0	0
chr11:20937848:C:T	0	0	0	0	0	0	0	0
chr11:21560259:C:T	0	0	0	0	0	0	0	0
chr11:22624986:C:T	27	10	37	17	20	1	1	0
chr11:22625820:G:A	31	16	47	15	32	2	0	2
chr11:25078683:G:A	0	0	0	0	0	0	0	0
chr11:26599570:A:C	0	0	0	0	0	0	0	0
chr11:27340812:T:G	4	2	6	2	4	1.5	0.5	1.0
chr11:30233638:C:T	0	0	0	0	0	0	0	0
chr11:31305769:C:T	0	0	0	0	0	0	0	0
chr11:32103432:T:C	36	15	54	22	32	1.0	1.0	0.0
chr11:32396399:T:C	0	0	0	0	0	0	0	0
chr11:32434752:G:A	0	0	0	0	0	0	0	0
chr11:32934946:C:T	5	2	7	3	4	1	1	0
chr11:33543974:C:G	0	0	0	0	0	0	0	0
chr11:33583339:C:T	0	0	0	0	0	0	0	0
chr11:33583414:C:T	0	0	0	0	0	0	0	0
chr11:33618558:A:C	0	0	0	0	0	0	0	0
chr11:33645787:A:G	0	0	0	0	0	0	0	0
chr11:33668166:C:T	0	0	0	0	0	0	0	0
chr11:34438994:T:C	438	237	708	220	488	2.0	0.0	2.0
chr11:34461361:C:T	477	221	735	285	450	1	1	0
chr11:34480798:T:C	0	0	0	0	0	0	0	0
chr11:34895110:C:T	128	48	181	83	98	1.0	1.0	0.0
chr11:34916150:T:C	28	22	50	6	44	2.0	0.0	2.0
chr11:34916354:A:G	159	84	249	75	174	2	0	2
chr11:34916718:C:T	100	52	155	49	106	2.0	0.0	2.0
chr11:35180295:C:T	384	191	607	213	394	2.0	1.0	0.0
chr11:35204608:A:G	12	8	20	4	16	2.0	0.0	2.0
chr11:35208126:T:C	6	4	10	2	8	2.0	0.0	2.0
chr11:36081678:A:G	0	0	0	0	0	0	0	0
chr11:36277005:C:T	12	6	18	6	12	1.5	0.5	1.0
chr11:36278426:A:T	12	8	20	4	16	2.0	0.0	2.0
chr11:36401151:C:T	0	0	0	0	0	0	0	0
chr11:36574050:A:G	0	0	0	0	0	0	0	0
chr11:36648228:C:T	0	0	0	0	0	0	0	0
chr11:36659215:T:C	1	0	1	1	0	1	1	0
chr11:43451196:C:T	30	14	46	16	30	1.0	1.0	0.0
chr11:43830941:T:C	3	1	4	2	2	1	1	0
chr11:43855148:C:T	61	17	77	44	33	1	1	0
chr11:44058660:T:C	0	0	0	0	0	0	0	0
chr11:44077435:G:A	1	0	1	1	0	1	1	0
chr11:44083431:C:T	26	15	41	11	30	2.0	0.0	2.0
chr11:44615289:C:T	378	216	628	176	452	2.0	0.0	2.0
chr11:44919277:G:A	0	0	0	0	0	0	0	0
chr11:44929233:G:A	1	0	1	1	0	1	1	0
chr11:44938373:G:A	0	0	0	0	0	0	0	0
chr11:45805799:A:G	23	18	43	5	38	2	0	2
chr11:45856137:C:G	30	13	43	17	26	1.0	1.0	0.0
chr11:45913833:A:G	348	198	571	167	404	2.0	0.0	2.0
chr11:46397603:C:A	4	2	6	2	4	1.5	0.5	1.0
chr11:46397709:C:T	4	2	6	2	4	1.5	0.5	1.0
chr11:46719945:C:T	0	0	0	0	0	0	0	0
chr11:46723375:G:C	0	0	0	0	0	0	0	0
chr11:46723453:C:T	0	0	0	0	0	0	0	0
chr11:46783211:C:T	2	1	3	1	2	1.5	0.5	1.0
chr11:46858929:C:T	0	0	0	0	0	0	0	0
chr11:46868614:C:T	0	0	0	0	0	0	0	0
chr11:46868646:G:A	0	0	0	0	0	0	0	0
chr11:46871557:T:C	0	0	0	0	0	0	0	0
chr11:46875895:G:A	0	0	0	0	0	0	0	0
chr11:46877220:T:C	0	0	0	0	0	0	0	0
chr11:47137502:G:A	9	6	15	3	12	2	0	2
chr11:47171816:T:G	3	2	5	1	4	2	0	2
chr11:47244920:G:C	2	1	3	1	2	1.5	0.5	1.0
chr11:47244989:G:T	0	0	0	0	0	0	0	0
chr11:47245257:T:G	0	0	0	0	0	0	0	0
chr11:47247608:T:C	11	3	14	8	6	1	1	0
chr11:47248704:C:T	32	13	45	19	26	1.0	1.0	0.0
chr11:47259211:G:A	0	0	0	0	0	0	0	0
chr11:47260473:C:T	3	0	3	3	0	1	1	0
chr11:47285034:G:A	7	5	14	2	12	2	0	2
chr11:47324594:G:A	1	0	1	1	0	1	1	0
chr11:47333236:C:T	0	0	0	0	0	0	0	0
chr11:47690661:C:T	4	2	6	2	4	1.5	0.5	1.0
chr11:47732442:C:T	39	14	53	25	28	1	1	0
chr11:48123695:T:C	14	11	25	3	22	2.0	0.0	2.0
chr11:48123823:A:C	15	4	19	11	8	1	1	0
chr11:48125070:G:A	16	5	21	11	10	1.0	1.0	0.0
chr11:48144715:G:C	4	3	7	1	6	2.0	0.0	2.0
chr11:48216997:G:A	0	0	0	0	0	0	0	0
chr11:48217011:G:A	0	0	0	0	0	0	0	0
chr11:48217221:C:T	0	0	0	0	0	0	0	0
chr11:48217630:C:A	0	0	0	0	0	0	0	0
chr11:48264304:C:T	0	0	0	0	0	0	0	0
chr11:48307092:C:T	0	0	0	0	0	0	0	0
chr11:48325588:T:C	0	0	0	0	0	0	0	0
chr11:48365634:A:G	0	0	0	0	0	0	0	0
chr11:48489102:A:C	0	0	0	0	0	0	0	0
chr11:48489225:G:A	0	0	0	0	0	0	0	0
chr11:48975782:T:G	0	0	0	0	0	0	0	0
chr11:48978970:C:T	0	0	0	0	0	0	0	0
chr11:48979006:G:A	0	0	0	0	0	0	0	0
chr11:49037810:C:A	0	0	0	0	0	0	0	0
chr11:49054053:G:A	0	0	0	0	0	0	0	0
chr11:49059064:T:C	0	0	0	0	0	0	0	0
chr11:54603280:G:A	0	0	0	0	0	0	0	0
chr11:54603368:G:A	0	0	0	0	0	0	0	0
chr11:54603640:T:C	0	0	0	0	0	0	0	0
chr11:54660223:C:T	0	0	0	0	0	0	0	0
chr11:54706901:A:G	0	0	0	0	0	0	0	0
chr11:55344108:A:T	0	0	0	0	0	0	0	0
chr11:55491609:T:C	0	0	0	0	0	0	0	0
chr11:55554735:A:G	0	0	0	0	0	0	0	0
chr11:55554822:C:T	0	0	0	0	0	0	0	0
chr11:55555162:C:T	0	0	0	0	0	0	0	0
chr11:55572842:G:A	0	0	0	0	0	0	0	0
chr11:55572903:T:C	0	0	0	0	0	0	0	0
chr11:55665564:T:C	0	0	0	0	0	0	0	0
chr11:55795860:A:T	0	0	0	0	0	0	0	0
chr11:55811464:G:A	0	0	0	0	0	0	0	0
chr11:55820111:C:T	0	0	0	0	0	0	0	0
chr11:55820438:A:G	0	0	0	0	0	0	0	0
chr11:56232590:G:A	0	0	0	0	0	0	0	0
chr11:56360495:T:G	0	0	0	0	0	0	0	0
chr11:56641534:A:T	0	0	0	0	0	0	0	0
chr11:56740404:T:C	0	0	0	0	0	0	0	0
chr11:56742767:A:G	0	0	0	0	0	0	0	0
chr11:56743878:G:A	0	0	0	0	0	0	0	0
chr11:56989546:G:A	0	0	0	0	0	0	0	0
chr11:57182217:G:A	0	0	0	0	0	0	0	0
chr11:57237103:C:T	0	0	0	0	0	0	0	0
chr11:57309990:T:C	0	0	0	0	0	0	0	0
chr11:57313672:G:C	0	0	0	0	0	0	0	0
chr11:57326754:A:G	107	51	160	58	102	1	1	0
chr11:57330450:G:A	2	1	3	1	2	1.5	0.5	1.0
chr11:57332877:G:A	6	1	7	5	2	1.0	1.0	0.0
chr11:57334622:A:G	119	67	187	53	134	2	0	2
chr11:57388965:A:G	0	0	0	0	0	0	0	0
chr11:57426180:A:G	23	11	34	12	22	1	1	0
chr11:57542834:A:G	1	0	1	1	0	1	1	0
chr11:57545996:C:G	1	0	1	1	0	1	1	0
chr11:57550167:C:T	10	4	14	6	8	1.0	1.0	0.0
chr11:57611697:A:G	0	0	0	0	0	0	0	0
chr11:57646470:C:G	0	0	0	0	0	0	0	0
chr11:57646914:A:G	0	0	0	0	0	0	0	0
chr11:57696028:T:C	14	7	21	7	14	1.5	0.5	1.0
chr11:57741941:C:T	1718	978	3552	1224	2328	2.0	1.0	2.0
chr11:57796519:C:T	3	0	3	3	0	1	1	0
chr11:58031251:A:G	0	0	0	0	0	0	0	0
chr11:58031470:A:G	0	0	0	0	0	0	0	0
chr11:58031899:G:C	0	0	0	0	0	0	0	0
chr11:58190488:T:C	0	0	0	0	0	0	0	0
chr11:58191025:T:C	0	0	0	0	0	0	0	0
chr11:58214757:A:G	0	0	0	0	0	0	0	0
chr11:58358832:A:T	0	0	0	0	0	0	0	0
chr11:58402901:T:C	0	0	0	0	0	0	0	0
chr11:58402996:C:A	0	0	0	0	0	0	0	0
chr11:58403265:A:G	0	0	0	0	0	0	0	0
chr11:59504164:T:C	0	0	0	0	0	0	0	0
chr11:60062630:A:G	0	0	0	0	0	0	0	0
chr11:60173126:T:A	476	218	866	348	518	2.0	1.0	0.0
chr11:60179779:C:T	95	54	155	45	110	2	0	2
chr11:60302703:A:G	0	0	0	0	0	0	0	0
chr11:60335034:G:T	0	0	0	0	0	0	0	0
chr11:60337893:T:C	0	0	0	0	0	0	0	0
chr11:60416718:G:A	0	0	0	0	0	0	0	0
chr11:60497529:C:T	0	0	0	0	0	0	0	0
chr11:60507167:T:C	0	0	0	0	0	0	0	0
chr11:60798451:T:C	0	0	0	0	0	0	0	0
chr11:60906396:T:C	53	23	76	30	46	1	1	0
chr11:60921973:T:C	377	178	586	216	370	1	1	0
chr11:60927829:C:A	0	0	0	0	0	0	0	0
chr11:60930582:G:A	0	0	0	0	0	0	0	0
chr11:60933478:C:G	2	0	2	2	0	1.0	1.0	0.0
chr11:60933519:A:G	1	0	1	1	0	1	1	0
chr11:60933664:C:G	1	0	1	1	0	1	1	0
chr11:60935788:A:G	0	0	0	0	0	0	0	0
chr11:60936741:C:T	0	0	0	0	0	0	0	0
chr11:61008714:C:T	50	21	71	29	42	1.0	1.0	0.0
chr11:61008737:C:T	50	29	79	21	58	2.0	0.0	2.0
chr11:61009601:G:A	47	29	76	18	58	2	0	2
chr11:61015636:C:T	8	4	12	4	8	1.5	0.5	1.0
chr11:61017991:C:T	48	28	76	20	56	2.0	0.0	2.0
chr11:61017992:G:A	48	20	96	56	40	2.0	2.0	0.0
chr11:61291395:T:C	0	0	0	0	0	0	0	0
chr11:61343874:C:G	43	21	68	26	42	2	1	0
chr11:61481911:C:A	1	0	1	1	0	1	1	0
chr11:61720218:G:A	0	0	0	0	0	0	0	0
chr11:61906646:C:T	0	0	0	0	0	0	0	0
chr11:61920202:G:A	0	0	0	0	0	0	0	0
chr11:61951915:T:C	0	0	0	0	0	0	0	0
chr11:61959399:G:T	0	0	0	0	0	0	0	0
chr11:61959966:C:T	0	0	0	0	0	0	0	0
chr11:61962564:G:A	0	0	0	0	0	0	0	0
chr11:62128269:A:G	12	10	22	2	20	2.0	0.0	2.0
chr11:62129887:C:T	10	8	18	2	16	2.0	0.0	2.0
chr11:62140968:T:C	10	6	16	4	12	2.0	0.0	2.0
chr11:62145724:G:T	3	3	6	0	6	2	0	2
chr11:62146897:C:T	1	0	1	1	0	1	1	0
chr11:62419070:G:A	0	0	0	0	0	0	0	0
chr11:62567436:G:C	152	57	203	97	106	1.0	1.0	0.0
chr11:62578659:C:T	55	28	84	28	56	2	0	2
chr11:62598147:A:G	7	5	12	2	10	2	0	2
chr11:62598193:G:A	7	2	9	5	4	1	1	0
chr11:62602408:TGGGCCA:TAGGGCA	111	0	113	113	0	1	1	0
chr11:62602683:G:A	7	1	8	6	2	1	1	0
chr11:62611188:G:A	38	18	56	20	36	1.0	1.0	0.0
chr11:62611329:T:C	38	18	54	20	34	1.0	1.0	0.0
chr11:62614336:G:C	7	7	14	0	14	2	0	2
chr11:62663187:T:A	111	51	164	62	102	1	1	0
chr11:62666701:G:A	4	3	7	1	6	2.0	0.0	2.0
chr11:62672097:G:A	274	128	429	159	270	1.0	1.0	0.0
chr11:62690803:T:C	104	63	169	41	128	2.0	0.0	2.0
chr11:62729047:T:C	75	39	114	36	78	2	0	2
chr11:62738292:C:T	60	34	94	26	68	2.0	0.0	2.0
chr11:62754003:T:C	3	2	5	1	4	2	0	2
chr11:63466238:A:G	0	0	0	0	0	0	0	0
chr11:63818332:C:A	0	0	0	0	0	0	0	0
chr11:63945845:G:A	42	19	61	23	38	1.0	1.0	0.0
chr11:63952149:C:A	0	0	0	0	0	0	0	0
chr11:63999714:A:G	18	11	29	7	22	2.0	0.0	2.0
chr11:64117833:C:T	0	0	0	0	0	0	0	0
chr11:64220630:C:T	198	105	309	97	212	2.0	0.0	2.0
chr11:64224329:T:C	230	114	347	122	225	1.0	1.0	0.0
chr11:64231768:G:C	16	11	27	5	22	2.0	0.0	2.0
chr11:64232057:C:T	26	12	38	14	24	1.0	1.0	0.0
chr11:64232938:C:G	26	14	42	14	28	2.0	0.0	2.0
chr11:64245312:G:A	6	1	7	5	2	1.0	1.0	0.0
chr11:64256499:G:A	2	2	4	0	4	2.0	0.0	2.0
chr11:64258672:G:A	2	1	3	1	2	1.5	0.5	1.0
chr11:64259213:C:T	1	1	2	0	2	2	0	2
chr11:64267394:G:A	7	3	10	4	6	1	1	0
chr11:64300838:C:T	0	0	0	0	0	0	0	0
chr11:64313973:G:A	9	6	15	3	12	2	0	2
chr11:64321744:C:G	1430	803	2644	882	1762	2.0	1.0	2.0
chr11:64344456:T:C	51	28	79	23	56	2	0	2
chr11:64591814:C:T	0	0	0	0	0	0	0	0
chr11:64592802:T:C	0	0	0	0	0	0	0	0
chr11:64600390:T:C	0	0	0	0	0	0	0	0
chr11:64648295:G:A	0	0	0	0	0	0	0	0
chr11:64651428:G:A	0	0	0	0	0	0	0	0
chr11:64990024:C:T	0	0	0	0	0	0	0	0
chr11:64990246:C:T	0	0	0	0	0	0	0	0
chr11:65021722:T:C	995	503	1733	646	1087	2	1	2
chr11:65109268:C:T	1	0	1	1	0	1	1	0
chr11:65130754:C:T	42	19	61	23	38	1.0	1.0	0.0
chr11:65170212:C:T	0	0	0	0	0	0	0	0
chr11:65214116:G:A	0	0	0	0	0	0	0	0
chr11:65214382:G:T	0	0	0	0	0	0	0	0
chr11:65214400:G:C	0	0	0	0	0	0	0	0
chr11:65222570:G:C	0	0	0	0	0	0	0	0
chr11:65223626:A:G	2	2	4	0	4	2.0	0.0	2.0
chr11:65297219:G:A	29	14	44	16	28	1	1	0
chr11:65356937:A:G	8	5	13	3	10	2.0	0.0	2.0
chr11:65552280:G:A	0	0	0	0	0	0	0	0
chr11:65570563:A:G	96	48	152	50	102	2.0	0.5	1.0
chr11:65571473:T:G	435	217	711	246	465	2	1	0
chr11:65581592:G:A	22	15	37	7	30	2.0	0.0	2.0
chr11:65582285:T:G	7	4	11	3	8	2	0	2
chr11:65583603:G:A	2	2	4	0	4	2.0	0.0	2.0
chr11:65617256:C:T	0	0	0	0	0	0	0	0
chr11:65618735:C:G	0	0	0	0	0	0	0	0
chr11:65625224:C:T	2	2	4	0	4	2.0	0.0	2.0
chr11:65644996:G:A	20	9	29	11	18	1.0	1.0	0.0
chr11:65660097:G:A	20	8	28	13	15	1.0	1.0	0.0
chr11:65779862:G:A	7	3	10	4	6	1	1	0
chr11:65793997:C:T	0	0	0	0	0	0	0	0
chr11:65885438:G:A	1	1	2	0	2	2	0	2
chr11:66264189:C:T	27	13	40	14	26	1	1	0
chr11:66315658:T:C	0	0	0	0	0	0	0	0
chr11:66316311:G:A	0	0	0	0	0	0	0	0
chr11:66332648:G:A	1	1	2	0	2	2	0	2
chr11:66337723:G:A	338	158	515	193	322	1.0	1.0	0.0
chr11:66338346:C:T	11	7	18	4	14	2	0	2
chr11:66341562:T:C	326	177	520	162	358	2.0	0.0	2.0
chr11:66421290:G:T	0	0	0	0	0	0	0	0
chr11:66473411:T:C	44	20	65	25	40	1.0	1.0	0.0
chr11:66486614:G:T	60	31	92	30	62	2.0	0.0	2.0
chr11:66504671:A:G	59	28	87	31	56	1	1	0
chr11:66504766:G:A	59	28	87	31	56	1	1	0
chr11:66514624:G:A	22	11	33	11	22	1.5	0.5	1.0
chr11:66515786:C:T	12	5	17	7	10	1.0	1.0	0.0
chr11:66521262:G:C	52	41	97	11	86	2.0	0.0	2.0
chr11:66529892:C:T	2	1	3	1	2	1.5	0.5	1.0
chr11:66532044:A:G	3	1	4	2	2	1	1	0
chr11:66545732:T:C	145	87	238	61	177	2	0	2
chr11:66560202:G:A	0	0	0	0	0	0	0	0
chr11:66560584:A:G	0	0	0	0	0	0	0	0
chr11:66560624:C:T	0	0	0	0	0	0	0	0
chr11:66561248:T:C	0	0	0	0	0	0	0	0
chr11:66561270:A:C	0	0	0	0	0	0	0	0
chr11:66562168:G:A	0	0	0	0	0	0	0	0
chr11:66562261:A:G	0	0	0	0	0	0	0	0
chr11:66563987:A:G	79	45	124	34	90	2	0	2
chr11:66566127:C:T	76	42	118	34	84	2.0	0.0	2.0
chr11:66568077:A:G	76	42	118	34	84	2.0	0.0	2.0
chr11:66590655:C:T	0	0	0	0	0	0	0	0
chr11:66605834:G:A	764	386	1245	435	810	2.0	1.0	2.0
chr11:66625409:C:T	29	15	44	14	30	2	0	2
chr11:66844993:C:T	225	124	355	105	250	2	0	2
chr11:67429073:C:G	9	4	13	5	8	1	1	0
chr11:67433348:C:T	237	107	360	138	222	1	1	0
chr11:67434573:G:A	6	2	8	4	4	1.0	1.0	0.0
chr11:67434685:C:T	253	115	389	153	236	1	1	0
chr11:67497208:C:T	3	1	4	2	2	1	1	0
chr11:67521123:C:T	0	0	0	0	0	0	0	0
chr11:67585218:A:G	3692	2581	14469	4986	9483	3.0	1.0	2.0
chr11:67586373:C:T	55	13	73	48	25	1	1	0
chr11:67586499:T:C	3696	2586	14509	5002	9507	3.0	1.0	2.0
chr11:67607110:T:C	747	443	1285	358	927	2	0	2
chr11:67628243:C:T	73	36	114	38	76	2	1	0
chr11:67631702:C:T	0	0	0	0	0	0	0	0
chr11:67634891:T:G	0	0	0	0	0	0	0	0
chr11:67715957:C:T	7	7	14	0	14	2	0	2
chr11:68262705:C:A	64	26	91	39	52	1.0	1.0	0.0
chr11:68433827:C:T	0	0	0	0	0	0	0	0
chr11:68691002:T:C	0	0	0	0	0	0	0	0
chr11:68737439:C:T	1	1	2	0	2	2	0	2
chr11:68898012:T:C	429	173	640	281	359	1	1	0
chr11:68903951:C:T	61	25	88	38	50	1	1	0
chr11:68914934:A:G	41	19	61	23	38	1	1	0
chr11:68934480:C:T	19	7	26	12	14	1	1	0
chr11:68936491:A:G	21	13	34	8	26	2	0	2
chr11:68936560:C:T	23	9	32	14	18	1	1	0
chr11:68936796:C:T	23	14	37	9	28	2	0	2
chr11:68980534:T:C	0	0	0	0	0	0	0	0
chr11:69005935:G:A	0	0	0	0	0	0	0	0
chr11:69078931:A:T	7	3	10	4	6	1	1	0
chr11:69083998:G:T	7	2	9	5	4	1	1	0
chr11:69086544:A:G	10	7	17	3	14	2.0	0.0	2.0
chr11:69295669:C:T	0	0	0	0	0	0	0	0
chr11:69295926:T:C	0	0	0	0	0	0	0	0
chr11:69296043:G:A	0	0	0	0	0	0	0	0
chr11:69296261:G:C	0	0	0	0	0	0	0	0
chr11:69773252:C:T	0	0	0	0	0	0	0	0
chr11:70087979:G:A	0	0	0	0	0	0	0	0
chr11:70820660:C:T	0	0	0	0	0	0	0	0
chr11:71435531:G:A	13	3	17	11	6	1	1	0
chr11:71444125:C:T	10	2	12	8	4	1.0	1.0	0.0
chr11:71538137:T:C	0	0	0	0	0	0	0	0
chr11:71548951:G:T	1	1	2	0	2	2	0	2
chr11:71566098:A:C	0	0	0	0	0	0	0	0
chr11:72016073:T:C	21	10	32	12	20	1	1	0
chr11:72578247:T:C	0	0	0	0	0	0	0	0
chr11:72584995:G:T	82	27	114	57	57	1.0	1.0	0.0
chr11:73234296:C:T	0	0	0	0	0	0	0	0
chr11:73235095:G:C	0	0	0	0	0	0	0	0
chr11:73392577:G:A	3	3	6	0	6	2	0	2
chr11:74004497:G:A	1	0	1	1	0	1	1	0
chr11:74098233:G:A	2	0	2	2	0	1.0	1.0	0.0
chr11:74346757:G:A	13	6	19	7	12	1	1	0
chr11:74618570:T:C	75	37	112	38	74	1	1	0
chr11:74708312:C:T	0	0	0	0	0	0	0	0
chr11:74708333:C:T	0	0	0	0	0	0	0	0
chr11:74718942:G:A	0	0	0	0	0	0	0	0
chr11:74844011:C:T	2	1	3	1	2	1.5	0.5	1.0
chr11:74848401:G:C	1	1	2	0	2	2	0	2
chr11:74852032:G:A	3	3	6	0	6	2	0	2
chr11:74949247:A:G	5	0	5	5	0	1	1	0
chr11:74965035:G:A	198	71	278	132	146	1.0	1.0	0.0
chr11:74994557:G:A	12	6	18	6	12	1.5	0.5	1.0
chr11:75089594:G:A	0	0	0	0	0	0	0	0
chr11:75089784:A:G	0	0	0	0	0	0	0	0
chr11:75196606:G:A	0	0	0	0	0	0	0	0
chr11:75566583:A:G	8	4	12	4	8	1.5	0.5	1.0
chr11:75566712:C:G	8	4	12	4	8	1.5	0.5	1.0
chr11:75568801:C:T	8	5	13	3	10	2.0	0.0	2.0
chr11:75571837:G:A	10	5	15	5	10	1.5	0.5	1.0
chr11:75717913:A:G	0	0	0	0	0	0	0	0
chr11:75719905:A:G	0	0	0	0	0	0	0	0
chr11:76194885:G:A	0	0	0	0	0	0	0	0
chr11:76403841:T:C	6	3	8	3	5	1.0	0.5	0.5
chr11:76546171:T:C	10	7	17	3	14	2.0	0.0	2.0
chr11:76661008:A:G	0	0	0	0	0	0	0	0
chr11:77040541:A:G	0	0	0	0	0	0	0	0
chr11:77142737:T:C	0	0	0	0	0	0	0	0
chr11:77157326:T:C	0	0	0	0	0	0	0	0
chr11:77157346:A:G	0	0	0	0	0	0	0	0
chr11:77206175:A:G	0	0	0	0	0	0	0	0
chr11:77207277:T:C	0	0	0	0	0	0	0	0
chr11:77208820:T:A	0	0	0	0	0	0	0	0
chr11:77701806:A:G	54	25	82	29	53	1.0	1.0	0.0
chr11:77872330:G:A	57	24	81	33	48	1	1	0
chr11:78173736:C:T	0	0	0	0	0	0	0	0
chr11:78732541:G:A	0	0	0	0	0	0	0	0
chr11:82689671:C:T	193	2	207	203	4	1	1	0
chr11:82732979:T:G	0	0	0	0	0	0	0	0
chr11:82824921:C:T	228	105	343	129	214	1.0	1.0	0.0
chr11:82933862:G:A	3	0	3	3	0	1	1	0
chr11:83164317:G:A	126	65	191	61	130	2.0	0.0	2.0
chr11:83169299:G:A	11	5	16	6	10	1	1	0
chr11:83184592:T:C	19	9	28	10	18	1	1	0
chr11:83184615:A:G	20	9	29	11	18	1.0	1.0	0.0
chr11:83184784:A:G	67	35	106	34	72	2	0	2
chr11:83194637:C:T	40	16	56	24	32	1.0	1.0	0.0
chr11:83255981:A:G	10	8	18	2	16	2.0	0.0	2.0
chr11:86264295:A:T	9	4	13	5	8	1	1	0
chr11:86302338:G:A	729	362	1177	417	760	2	1	0
chr11:86412425:G:A	0	0	0	0	0	0	0	0
chr11:86450346:C:G	0	0	0	0	0	0	0	0
chr11:86556636:G:A	0	0	0	0	0	0	0	0
chr11:89284793:G:A	0	0	0	0	0	0	0	0
chr11:89645101:C:T	0	0	0	0	0	0	0	0
chr11:89659631:G:A	0	0	0	0	0	0	0	0
chr11:89710640:A:C	0	0	0	0	0	0	0	0
chr11:89714207:C:T	0	0	0	0	0	0	0	0
chr11:90202418:G:T	45	23	68	22	46	2	0	2
chr11:90223038:G:A	154	69	229	91	138	1.0	1.0	0.0
chr11:90283610:G:A	0	0	0	0	0	0	0	0
chr11:92353662:T:C	0	0	0	0	0	0	0	0
chr11:92857282:A:G	0	0	0	0	0	0	0	0
chr11:92890711:G:A	0	0	0	0	0	0	0	0
chr11:92969796:G:A	0	0	0	0	0	0	0	0
chr11:93724366:C:G	2	1	3	1	2	1.5	0.5	1.0
chr11:93784708:C:G	329	167	520	173	347	2	1	1
chr11:93784720:G:C	329	167	523	173	350	2	1	2
chr11:93801824:G:A	3	1	4	2	2	1	1	0
chr11:94129327:A:C	45	27	72	18	54	2	0	2
chr11:94380122:C:G	0	0	0	0	0	0	0	0
chr11:94800207:C:T	0	0	0	0	0	0	0	0
chr11:94869249:C:T	0	0	0	0	0	0	0	0
chr11:95025895:A:G	0	0	0	0	0	0	0	0
chr11:95026330:T:C	0	0	0	0	0	0	0	0
chr11:95129413:G:T	33	6	39	27	12	1	1	0
chr11:95923947:T:G	66	28	95	39	56	1.0	1.0	0.0
chr11:96092633:A:G	6	0	6	6	0	1.0	1.0	0.0
chr11:101997684:C:T	7	2	9	5	4	1	1	0
chr11:102223693:C:T	0	0	0	0	0	0	0	0
chr11:102402153:C:T	240	129	387	119	268	2.0	0.0	2.0
chr11:102722517:T:C	0	0	0	0	0	0	0	0
chr11:102724761:G:A	0	0	0	0	0	0	0	0
chr11:102770721:G:C	0	0	0	0	0	0	0	0
chr11:102838694:A:G	0	0	0	0	0	0	0	0
chr11:102840251:T:C	0	0	0	0	0	0	0	0
chr11:102842734:A:G	0	0	0	0	0	0	0	0
chr11:102842889:T:C	0	0	0	0	0	0	0	0
chr11:103117775:A:T	4	2	6	2	4	1.5	0.5	1.0
chr11:103156505:A:G	0	0	0	0	0	0	0	0
chr11:103287549:C:T	1	1	2	0	2	2	0	2
chr11:103455180:C:T	0	0	0	0	0	0	0	0
chr11:103909727:A:G	8	2	10	6	4	1.0	1.0	0.0
chr11:107326880:G:C	13	5	19	9	10	1	1	0
chr11:107428905:G:A	35	13	48	22	26	1	1	0
chr11:108512949:A:G	2	2	4	0	4	2.0	0.0	2.0
chr11:108513480:C:T	3	3	6	0	6	2	0	2
chr11:108513934:C:A	1	1	2	0	2	2	0	2
chr11:108514524:C:T	1	1	2	0	2	2	0	2
chr11:108593482:T:C	28	7	35	21	14	1.0	1.0	0.0
chr11:108675741:A:G	0	0	0	0	0	0	0	0
chr11:111286111:T:C	0	0	0	0	0	0	0	0
chr11:111308329:A:G	6	3	9	3	6	1.5	0.5	1.0
chr11:111541559:C:T	0	0	0	0	0	0	0	0
chr11:111875406:T:C	42	18	61	25	36	1.0	1.0	0.0
chr11:112169304:A:G	2	1	3	1	2	1.5	0.5	1.0
chr11:112200571:G:A	0	0	0	0	0	0	0	0
chr11:113233274:T:G	0	0	0	0	0	0	0	0
chr11:113323446:A:C	39	19	59	21	38	2	1	0
chr11:113341831:T:C	0	0	0	0	0	0	0	0
chr11:113397337:G:A	1	0	1	1	0	1	1	0
chr11:113399293:G:C	1	0	1	1	0	1	1	0
chr11:113399438:A:G	1	0	1	1	0	1	1	0
chr11:113410675:C:T	0	0	0	0	0	0	0	0
chr11:113412737:G:A	0	0	0	0	0	0	0	0
chr11:113412755:A:G	0	0	0	0	0	0	0	0
chr11:113698853:T:G	0	0	0	0	0	0	0	0
chr11:113699663:C:T	0	0	0	0	0	0	0	0
chr11:113801582:T:G	24	14	38	10	28	2.0	0.0	2.0
chr11:115190813:T:C	0	0	0	0	0	0	0	0
chr11:116820918:C:A	0	0	0	0	0	0	0	0
chr11:116830819:T:C	0	0	0	0	0	0	0	0
chr11:116832955:G:T	0	0	0	0	0	0	0	0
chr11:116863829:G:A	0	0	0	0	0	0	0	0
chr11:117182083:A:G	41	17	58	24	34	1	1	0
chr11:117521251:G:A	0	0	0	0	0	0	0	0
chr11:117532520:G:T	1	1	2	0	2	2	0	2
chr11:117824625:C:T	0	0	0	0	0	0	0	0
chr11:117841961:C:T	0	0	0	0	0	0	0	0
chr11:117903576:A:C	0	0	0	0	0	0	0	0
chr11:117903679:A:G	3	1	4	2	2	1	1	0
chr11:117918527:C:G	1	1	2	0	2	2	0	2
chr11:117986623:G:C	349	199	594	166	428	2	0	2
chr11:117988494:G:A	207	106	317	105	212	2	1	2
chr11:117993332:A:G	144	71	217	73	144	1.0	1.0	0.0
chr11:118094880:C:T	0	0	0	0	0	0	0	0
chr11:118094931:G:A	0	0	0	0	0	0	0	0
chr11:118118069:A:G	0	0	0	0	0	0	0	0
chr11:118141449:G:A	0	0	0	0	0	0	0	0
chr11:118145353:C:T	0	0	0	0	0	0	0	0
chr11:118307292:C:T	0	0	0	0	0	0	0	0
chr11:118472663:G:A	13	11	24	2	22	2	0	2
chr11:118534089:G:A	20	9	29	11	18	1.0	1.0	0.0
chr11:118534353:A:G	21	11	32	10	22	2	0	2
chr11:118534590:G:A	5	3	8	2	6	2	0	2
chr11:118535274:A:G	7	4	11	3	8	2	0	2
chr11:118555347:C:A	0	0	0	0	0	0	0	0
chr11:118638950:A:G	0	0	0	0	0	0	0	0
chr11:118883940:C:G	561	269	898	324	574	2	1	0
chr11:118898733:A:G	1	0	1	1	0	1	1	0
chr11:118958232:A:G	0	0	0	0	0	0	0	0
chr11:118998215:C:G	222	112	345	113	232	2.0	1.0	2.0
chr11:119018121:T:C	99	50	152	51	101	2	0	1
chr11:119026547:C:T	0	0	0	0	0	0	0	0
chr11:119026552:C:T	0	0	0	0	0	0	0	0
chr11:119026762:A:G	0	0	0	0	0	0	0	0
chr11:119028440:T:C	0	0	0	0	0	0	0	0
chr11:119028508:C:T	0	0	0	0	0	0	0	0
chr11:119345569:G:A	0	0	0	0	0	0	0	0
chr11:119346544:C:T	0	0	0	0	0	0	0	0
chr11:119359254:G:A	0	0	0	0	0	0	0	0
chr11:119372960:C:T	0	0	0	0	0	0	0	0
chr11:120228949:A:G	1	0	1	1	0	1	1	0
chr11:120228970:G:A	1	0	1	1	0	1	1	0
chr11:120236702:G:A	0	0	0	0	0	0	0	0
chr11:120305040:A:G	0	0	0	0	0	0	0	0
chr11:120317262:G:A	0	0	0	0	0	0	0	0
chr11:120327384:G:A	18	9	27	9	18	1.5	0.5	1.0
chr11:120469351:A:T	12	5	17	7	10	1.0	1.0	0.0
chr11:120952899:G:A	1	0	1	1	0	1	1	0
chr11:121118626:A:G	0	0	0	0	0	0	0	0
chr11:121125583:A:G	0	0	0	0	0	0	0	0
chr11:121130075:T:C	0	0	0	0	0	0	0	0
chr11:121146109:G:A	0	0	0	0	0	0	0	0
chr11:121146129:C:T	0	0	0	0	0	0	0	0
chr11:121496917:T:C	0	0	0	0	0	0	0	0
chr11:121586261:G:C	0	0	0	0	0	0	0	0
chr11:122924980:T:C	3	3	6	0	6	2	0	2
chr11:123057914:A:G	1932	1139	4509	1556	2953	2.0	1.0	2.0
chr11:123058493:G:T	4	3	7	1	6	2.0	0.0	2.0
chr11:123058699:T:G	1989	1169	4678	1620	3058	2	1	2
chr11:123073420:A:G	2	0	2	2	0	1.0	1.0	0.0
chr11:123606644:G:A	4	4	8	0	8	2.0	0.0	2.0
chr11:123610273:T:C	7	7	14	0	14	2	0	2
chr11:124038943:CCTGGGG:GCTTGGA	0	0	0	0	0	0	0	0
chr11:124310581:G:A	0	0	0	0	0	0	0	0
chr11:124424807:T:C	0	0	0	0	0	0	0	0
chr11:124440726:A:G	0	0	0	0	0	0	0	0
chr11:124542942:C:T	0	0	0	0	0	0	0	0
chr11:124611598:T:C	0	0	0	0	0	0	0	0
chr11:124619671:T:C	0	0	0	0	0	0	0	0
chr11:124630865:A:G	5	1	6	4	2	1	1	0
chr11:124632025:A:G	4	4	8	0	8	2.0	0.0	2.0
chr11:124753596:T:C	3	3	6	0	6	2	0	2
chr11:124871084:C:T	0	0	0	0	0	0	0	0
chr11:124878300:G:A	18	3	21	15	6	1.0	1.0	0.0
chr11:124886510:G:A	1	0	1	1	0	1	1	0
chr11:124887133:G:A	1	0	1	1	0	1	1	0
chr11:124887664:G:A	1	0	1	1	0	1	1	0
chr11:124896232:A:G	0	0	0	0	0	0	0	0
chr11:124897171:T:C	0	0	0	0	0	0	0	0
chr11:124919932:A:T	0	0	0	0	0	0	0	0
chr11:124923820:G:A	0	0	0	0	0	0	0	0
chr11:125077253:G:A	0	0	0	0	0	0	0	0
chr11:125085136:T:C	0	0	0	0	0	0	0	0
chr11:125086081:C:T	0	0	0	0	0	0	0	0
chr11:125088226:A:G	1	0	1	1	0	1	1	0
chr11:125097591:T:A	237	117	362	123	239	1	1	0
chr11:125102218:G:A	101	51	155	51	104	2	1	2
chr11:125102312:A:G	101	51	156	52	104	2	1	2
chr11:125456130:C:T	0	0	0	0	0	0	0	0
chr11:125609601:C:T	5	5	10	0	10	2	0	2
chr11:125747711:G:A	0	0	0	0	0	0	0	0
chr11:125747874:C:T	0	0	0	0	0	0	0	0
chr11:125899459:T:C	11	7	18	4	14	2	0	2
chr11:125961075:A:T	0	0	0	0	0	0	0	0
chr11:125961806:G:A	0	0	0	0	0	0	0	0
chr11:125981160:A:G	0	0	0	0	0	0	0	0
chr11:125981286:G:A	0	0	0	0	0	0	0	0
chr11:126005939:C:T	0	0	0	0	0	0	0	0
chr11:126021374:C:T	0	0	0	0	0	0	0	0
chr11:126211508:T:C	77	45	123	32	91	2	0	2
chr11:126292712:G:A	20	9	30	12	18	1.5	1.0	0.0
chr11:126292948:C:T	19	8	28	12	16	1	1	0
chr11:126292967:C:T	19	11	32	8	24	2	0	2
chr11:126331508:T:C	157	22	183	139	44	1	1	0
chr11:126406065:T:C	0	0	0	0	0	0	0	0
chr11:126407321:C:T	1	0	1	1	0	1	1	0
chr11:126408180:C:T	1	0	1	1	0	1	1	0
chr11:126424922:G:A	0	0	0	0	0	0	0	0
chr11:127941507:G:A	0	0	0	0	0	0	0	0
chr11:128463608:T:C	89	44	133	45	88	1	1	0
chr11:128902448:A:C	0	0	0	0	0	0	0	0
chr11:128902557:C:T	0	0	0	0	0	0	0	0
chr11:128934894:C:A	0	0	0	0	0	0	0	0
chr11:128935484:C:T	0	0	0	0	0	0	0	0
chr11:128998344:T:C	0	0	0	0	0	0	0	0
chr11:129852658:C:T	0	0	0	0	0	0	0	0
chr11:129876812:G:T	2	0	2	2	0	1.0	1.0	0.0
chr11:129884773:T:C	48	23	71	25	46	1.0	1.0	0.0
chr11:129902277:T:C	0	0	0	0	0	0	0	0
chr11:129915699:G:A	0	0	0	0	0	0	0	0
chr11:129925055:T:C	1	1	2	0	2	2	0	2
chr11:129931148:C:T	0	0	0	0	0	0	0	0
chr11:130109386:T:A	0	0	0	0	0	0	0	0
chr11:130196440:C:T	26	13	39	13	26	1.5	0.5	1.0
chr11:130198596:G:C	34	14	48	20	28	1.0	1.0	0.0
chr11:130233473:C:T	26	0	26	26	0	1.0	1.0	0.0
chr11:130469417:T:C	0	0	0	0	0	0	0	0
chr11:130880747:A:C	8	7	15	1	14	2.0	0.0	2.0
chr11:130903181:G:A	1	0	1	1	0	1	1	0
chr11:130905793:C:T	6	2	8	4	4	1.0	1.0	0.0
chr11:130910120:C:T	28	16	44	12	32	2.0	0.0	2.0
chr11:130914859:C:G	13	6	19	7	12	1	1	0
chr11:130915076:C:G	14	6	20	8	12	1.0	1.0	0.0
chr11:131911020:A:C	0	0	0	0	0	0	0	0
chr11:133935690:C:T	0	0	0	0	0	0	0	0
chr11:133944296:A:G	0	0	0	0	0	0	0	0
chr11:133946086:C:G	0	0	0	0	0	0	0	0
chr11:134177348:T:C	1	0	1	1	0	1	1	0
chr11:134223994:G:C	8	7	15	1	14	2.0	0.0	2.0
chr11:134235136:A:G	1	0	1	1	0	1	1	0
chr11:134258419:G:T	4	2	6	2	4	1.5	0.5	1.0
chr11:134311207:T:C	0	0	0	0	0	0	0	0
chr12:165995:C:T	0	0	0	0	0	0	0	0
chr12:201735:T:C	0	0	0	0	0	0	0	0
chr12:202783:A:G	0	0	0	0	0	0	0	0
chr12:411778:G:A	49	29	78	20	58	2	0	2
chr12:552606:G:A	0	0	0	0	0	0	0	0
chr12:553110:C:T	0	0	0	0	0	0	0	0
chr12:663507:C:A	5	2	7	3	4	1	1	0
chr12:1793600:T:G	1	0	1	1	0	1	1	0
chr12:2651542:G:A	0	0	0	0	0	0	0	0
chr12:2677892:C:T	3	1	4	2	2	1	1	0
chr12:2679713:G:A	0	0	0	0	0	0	0	0
chr12:2681964:CGA:TGG	2	2	4	0	4	2.0	0.0	2.0
chr12:2858934:T:C	3	1	4	2	2	1	1	0
chr12:3201169:C:T	0	0	0	0	0	0	0	0
chr12:3278531:T:C	0	0	0	0	0	0	0	0
chr12:3278591:A:G	0	0	0	0	0	0	0	0
chr12:3280435:C:T	0	0	0	0	0	0	0	0
chr12:3281866:T:G	0	0	0	0	0	0	0	0
chr12:3283185:A:G	0	0	0	0	0	0	0	0
chr12:3381380:T:C	0	0	0	0	0	0	0	0
chr12:3673481:A:T	10	3	13	7	6	1.0	1.0	0.0
chr12:3673535:C:T	10	3	13	7	6	1.0	1.0	0.0
chr12:4278918:C:G	154	68	240	98	142	1.0	1.0	0.0
chr12:4370383:G:A	0	0	0	0	0	0	0	0
chr12:4912062:T:C	0	0	0	0	0	0	0	0
chr12:4912182:G:C	0	0	0	0	0	0	0	0
chr12:4912818:T:A	0	0	0	0	0	0	0	0
chr12:5494466:G:A	0	0	0	0	0	0	0	0
chr12:5494484:C:T	0	0	0	0	0	0	0	0
chr12:5565588:G:A	0	0	0	0	0	0	0	0
chr12:6018777:A:G	0	0	0	0	0	0	0	0
chr12:6019004:C:G	0	0	0	0	0	0	0	0
chr12:6019277:T:C	0	0	0	0	0	0	0	0
chr12:6034818:T:C	0	0	0	0	0	0	0	0
chr12:6063036:T:C	0	0	0	0	0	0	0	0
chr12:6236033:C:T	1	0	1	1	0	1	1	0
chr12:6453119:C:T	86	53	140	35	105	2.0	0.0	2.0
chr12:6453127:C:T	86	53	141	35	106	2.0	0.0	2.0
chr12:6453657:C:T	90	55	148	38	110	2.0	0.0	2.0
chr12:6458741:C:T	79	30	111	51	60	1	1	0
chr12:6463025:T:C	40	18	58	22	36	1.0	1.0	0.0
chr12:6464690:G:T	32	12	44	20	24	1.0	1.0	0.0
chr12:6465878:G:T	50	22	72	28	44	1.0	1.0	0.0
chr12:6470646:T:C	51	28	79	23	56	2	0	2
chr12:6493201:C:T	670	347	1145	399	746	2.0	1.0	2.0
chr12:6526108:G:A	5	3	8	2	6	2	0	2
chr12:6528679:T:C	6	3	6	3	3	1.0	0.5	0.5
chr12:6528775:C:T	6	3	9	3	6	1.5	0.5	1.0
chr12:6529922:A:G	6	3	8	3	5	1.0	0.5	0.5
chr12:6548372:T:G	4	0	4	4	0	1.0	1.0	0.0
chr12:6581743:C:T	48	21	70	28	42	1.0	1.0	0.0
chr12:6601981:C:A	55	29	84	26	58	2	0	2
chr12:6620790:G:A	46	22	69	25	44	1.5	1.0	0.0
chr12:6730747:C:T	116	63	183	55	128	2.0	0.0	2.0
chr12:6748732:C:A	299	164	471	137	334	2	0	2
chr12:6748960:G:A	700	390	1159	353	806	2.0	0.0	2.0
chr12:6749805:C:T	13	6	20	8	12	2	1	0
chr12:6777854:T:C	112	58	190	62	128	2.0	1.0	2.0
chr12:6815983:C:T	0	0	0	0	0	0	0	0
chr12:6817197:T:C	0	0	0	0	0	0	0	0
chr12:6818909:T:C	0	0	0	0	0	0	0	0
chr12:6824621:A:G	0	0	0	0	0	0	0	0
chr12:6826812:A:G	0	0	0	0	0	0	0	0
chr12:6839304:T:C	0	0	0	0	0	0	0	0
chr12:6839528:A:G	0	0	0	0	0	0	0	0
chr12:6841239:G:A	0	0	0	0	0	0	0	0
chr12:6845711:C:T	1	0	1	1	0	1	1	0
chr12:6856030:A:G	55	30	85	25	60	2	0	2
chr12:6906751:A:G	5	4	9	1	8	2	0	2
chr12:6912921:T:A	20	9	29	11	18	1.0	1.0	0.0
chr12:6913959:A:G	65	40	107	25	82	2	0	2
chr12:6914113:G:A	65	25	91	41	50	1	1	0
chr12:6914136:A:C	65	40	107	25	82	2	0	2
chr12:7086501:T:C	0	0	0	0	0	0	0	0
chr12:7089703:G:A	1	1	2	0	2	2	0	2
chr12:7128721:C:T	1	0	1	1	0	1	1	0
chr12:7157589:C:T	14	8	22	6	16	2.0	0.0	2.0
chr12:7202673:T:C	6	5	11	1	10	2.0	0.0	2.0
chr12:7310645:A:T	0	0	0	0	0	0	0	0
chr12:7432651:T:C	0	0	0	0	0	0	0	0
chr12:7439085:G:A	0	0	0	0	0	0	0	0
chr12:7487740:G:A	0	0	0	0	0	0	0	0
chr12:7497057:T:C	0	0	0	0	0	0	0	0
chr12:7502541:A:G	0	0	0	0	0	0	0	0
chr12:7891092:G:C	0	0	0	0	0	0	0	0
chr12:8134166:G:C	0	0	0	0	0	0	0	0
chr12:8134452:C:T	0	0	0	0	0	0	0	0
chr12:8177596:T:C	0	0	0	0	0	0	0	0
chr12:8229550:G:A	1	1	2	0	2	2	0	2
chr12:8234282:C:T	14	2	16	12	4	1.0	1.0	0.0
chr12:8861159:C:T	0	0	0	0	0	0	0	0
chr12:9294888:CGAGC:TGAGT	0	0	0	0	0	0	0	0
chr12:9294896:T:C	0	0	0	0	0	0	0	0
chr12:9998362:G:A	0	0	0	0	0	0	0	0
chr12:9998375:A:G	0	0	0	0	0	0	0	0
chr12:10629516:T:C	0	0	0	0	0	0	0	0
chr12:10631130:A:G	0	0	0	0	0	0	0	0
chr12:10801984:A:T	0	0	0	0	0	0	0	0
chr12:10938833:C:T	10	6	16	4	12	2.0	0.0	2.0
chr12:10939094:T:A	11	6	17	5	12	2	0	2
chr12:10986336:T:C	0	0	0	0	0	0	0	0
chr12:10997641:T:C	1	0	1	1	0	1	1	0
chr12:11022488:G:A	1	0	1	1	0	1	1	0
chr12:11030592:T:C	9	6	15	3	12	2	0	2
chr12:11030618:C:T	9	3	12	6	6	1	1	0
chr12:11030656:G:A	9	3	12	6	6	1	1	0
chr12:11030852:A:T	9	4	13	5	8	1	1	0
chr12:11030913:A:G	10	3	13	7	6	1.0	1.0	0.0
chr12:11031233:G:A	8	3	11	5	6	1.0	1.0	0.0
chr12:11061546:C:T	2	2	6	0	6	3.0	0.0	3.0
chr12:11061613:A:T	2	2	6	0	6	3.0	0.0	3.0
chr12:11133489:A:C	3	0	4	4	0	1	1	0
chr12:11186377:C:T	0	0	0	0	0	0	0	0
chr12:11308358:C:G	0	0	0	0	0	0	0	0
chr12:12087265:C:T	1	0	1	1	0	1	1	0
chr12:12131981:G:A	0	0	0	0	0	0	0	0
chr12:12330341:G:A	0	0	0	0	0	0	0	0
chr12:12477412:G:A	1	0	1	1	0	1	1	0
chr12:12718165:T:G	315	170	511	163	348	2	0	2
chr12:12814193:C:T	260	126	396	138	258	1.0	1.0	0.0
chr12:12823799:A:G	14	9	23	5	18	2.0	0.0	2.0
chr12:12908360:C:T	0	0	0	0	0	0	0	0
chr12:13055618:C:T	2	1	3	1	2	1.5	0.5	1.0
chr12:13058537:G:A	2	1	3	1	2	1.5	0.5	1.0
chr12:13061603:A:G	1	0	1	1	0	1	1	0
chr12:13090713:A:G	0	0	0	0	0	0	0	0
chr12:13563704:G:A	0	0	0	0	0	0	0	0
chr12:13564574:G:A	0	0	0	0	0	0	0	0
chr12:13611840:G:A	0	0	0	0	0	0	0	0
chr12:13865981:G:A	0	0	0	0	0	0	0	0
chr12:13866194:C:T	0	0	0	0	0	0	0	0
chr12:14511661:A:G	400	264	707	147	560	2.0	0.0	2.0
chr12:14823563:T:C	3	2	7	1	6	2	0	2
chr12:14942624:C:G	3130	1979	8344	2868	5476	2.0	1.0	2.0
chr12:16244800:C:A	0	0	0	0	0	0	0	0
chr12:16272629:G:C	0	0	0	0	0	0	0	0
chr12:16272722:A:T	0	0	0	0	0	0	0	0
chr12:18503291:G:A	0	0	0	0	0	0	0	0
chr12:20552358:C:T	0	0	0	0	0	0	0	0
chr12:20552606:C:T	0	0	0	0	0	0	0	0
chr12:20552813:G:C	0	0	0	0	0	0	0	0
chr12:21294132:C:T	0	0	0	0	0	0	0	0
chr12:21437687:T:C	215	97	325	125	200	1	1	0
chr12:21455109:A:G	1	0	1	1	0	1	1	0
chr12:21501897:G:T	318	142	480	188	292	1.0	1.0	0.0
chr12:21536948:T:A	0	0	0	0	0	0	0	0
chr12:21558177:G:C	0	0	0	0	0	0	0	0
chr12:21560468:T:C	0	0	0	0	0	0	0	0
chr12:25035597:G:A	2	1	3	1	2	1.5	0.5	1.0
chr12:25090181:G:C	600	296	976	352	624	2.0	1.0	0.0
chr12:25518825:T:A	0	0	0	0	0	0	0	0
chr12:25553200:G:A	0	0	0	0	0	0	0	0
chr12:26596898:G:A	7	3	10	4	6	1	1	0
chr12:26631917:G:A	11	4	15	7	8	1	1	0
chr12:26657844:T:C	6	4	10	2	8	2.0	0.0	2.0
chr12:26715389:T:C	25	15	40	10	30	2	0	2
chr12:26916050:A:T	30	15	45	15	30	1.5	0.5	1.0
chr12:26990575:G:A	67	37	104	30	74	2	0	2
chr12:27022736:T:C	35	12	47	23	24	1	1	0
chr12:27082346:G:A	0	0	0	0	0	0	0	0
chr12:27400633:A:G	0	0	0	0	0	0	0	0
chr12:27472890:A:T	0	0	0	0	0	0	0	0
chr12:27472946:G:A	0	0	0	0	0	0	0	0
chr12:27474872:G:A	0	0	0	0	0	0	0	0
chr12:27635088:G:A	0	0	0	0	0	0	0	0
chr12:27697180:A:T	0	0	0	0	0	0	0	0
chr12:27710760:C:T	0	0	0	0	0	0	0	0
chr12:27763011:A:G	1	1	2	0	2	2	0	2
chr12:27763273:G:A	0	0	0	0	0	0	0	0
chr12:27763291:A:G	0	0	0	0	0	0	0	0
chr12:27791925:G:A	12	5	17	7	10	1.0	1.0	0.0
chr12:30715068:C:T	6	3	9	3	6	1.5	0.5	1.0
chr12:30728875:T:C	7	1	8	6	2	1	1	0
chr12:30982644:T:C	0	0	0	0	0	0	0	0
chr12:30991949:A:G	0	0	0	0	0	0	0	0
chr12:31104061:G:A	18	6	24	12	12	1.0	1.0	0.0
chr12:31452110:G:T	50	27	77	23	54	2.0	0.0	2.0
chr12:31981130:A:G	194	90	293	107	186	1.0	1.0	0.0
chr12:31981306:C:T	183	86	277	99	178	1	1	0
chr12:31981992:G:A	141	75	219	69	150	2	0	2
chr12:31982009:A:G	141	67	213	76	137	1	1	0
chr12:31983004:A:G	55	27	83	29	54	2	1	0
chr12:31984578:C:G	166	90	265	81	184	2.0	0.0	2.0
chr12:31985476:A:G	59	26	87	35	52	1	1	0
chr12:32328159:G:C	26	17	43	9	34	2.0	0.0	2.0
chr12:32337830:G:A	26	13	39	13	26	1.5	0.5	1.0
chr12:32339035:C:T	3	1	4	2	2	1	1	0
chr12:32755303:C:A	94	38	132	57	75	1.0	1.0	0.0
chr12:32755584:G:A	79	31	109	48	61	1	1	0
chr12:32869000:A:G	0	0	0	0	0	0	0	0
chr12:34022573:T:C	33	11	46	22	24	1	1	0
chr12:38316781:C:T	18	10	28	8	20	2.0	0.0	2.0
chr12:38321198:A:G	6	4	10	2	8	2.0	0.0	2.0
chr12:39720979:A:G	0	0	0	0	0	0	0	0
chr12:40105545:G:A	33	18	51	15	36	2	0	2
chr12:40314059:C:T	3	2	5	1	4	2	0	2
chr12:40320071:A:G	5	4	9	1	8	2	0	2
chr12:40322458:T:C	5	3	8	2	6	2	0	2
chr12:40406167:C:T	0	0	0	0	0	0	0	0
chr12:40406173:G:C	0	0	0	0	0	0	0	0
chr12:40408348:G:A	0	0	0	0	0	0	0	0
chr12:40490434:A:G	0	0	0	0	0	0	0	0
chr12:40490439:A:C	0	0	0	0	0	0	0	0
chr12:40544949:A:G	0	0	0	0	0	0	0	0
chr12:40943633:C:T	0	0	0	0	0	0	0	0
chr12:41573875:G:A	0	0	0	0	0	0	0	0
chr12:42324009:A:T	9	7	16	2	14	2	0	2
chr12:42459718:A:G	3	1	4	2	2	1	1	0
chr12:43754970:A:C	233	116	359	123	236	2	1	0
chr12:44532551:T:A	0	0	0	0	0	0	0	0
chr12:47740431:G:C	1	1	2	0	2	2	0	2
chr12:47740577:G:T	0	0	0	0	0	0	0	0
chr12:47740851:C:T	0	0	0	0	0	0	0	0
chr12:47746800:C:T	4	0	4	4	0	1.0	1.0	0.0
chr12:47748560:T:C	1	1	2	0	2	2	0	2
chr12:47748853:C:T	25	17	44	8	36	2	0	2
chr12:47758039:C:G	30	18	50	12	38	2.0	0.0	2.0
chr12:47784123:C:T	97	54	154	44	110	2	0	2
chr12:47785261:C:G	5	3	8	2	6	2	0	2
chr12:47785564:C:T	3	3	6	0	6	2	0	2
chr12:47785695:T:G	4	4	8	0	8	2.0	0.0	2.0
chr12:47787995:T:C	0	0	0	0	0	0	0	0
chr12:47796261:C:T	119	66	186	54	132	2	0	2
chr12:47844974:A:G	0	0	0	0	0	0	0	0
chr12:47964496:C:A	2	1	3	1	2	1.5	0.5	1.0
chr12:47981785:A:G	0	0	0	0	0	0	0	0
chr12:47982508:G:A	0	0	0	0	0	0	0	0
chr12:48145699:T:G	71	40	113	33	80	2	0	2
chr12:48184659:C:T	0	0	0	0	0	0	0	0
chr12:48329541:C:G	1	0	1	1	0	1	1	0
chr12:48330001:C:T	0	0	0	0	0	0	0	0
chr12:48343202:T:G	9	5	14	4	10	2	0	2
chr12:49101538:C:A	149	74	226	78	148	1	1	0
chr12:49103860:T:A	8	6	14	2	12	2.0	0.0	2.0
chr12:49104968:G:A	7	7	14	0	14	2	0	2
chr12:49106615:G:A	34	17	51	17	34	1.5	0.5	1.0
chr12:49106726:C:T	33	17	50	16	34	2	0	2
chr12:49127889:G:A	2021	1267	4688	1429	3259	2	1	2
chr12:49128795:T:C	1904	1188	4328	1331	2997	2.0	1.0	2.0
chr12:49128822:C:T	1906	1194	4369	1329	3040	2.0	1.0	2.0
chr12:49129003:C:A	32	15	47	17	30	1.0	1.0	0.0
chr12:49131225:G:C	533	281	889	297	592	2	1	2
chr12:49185913:C:G	1551	868	3069	1037	2032	2	1	2
chr12:49186397:T:C	1745	1003	3596	1178	2418	2	1	2
chr12:49188874:G:A	1180	594	2213	852	1361	2.0	1.0	1.0
chr12:49188909:T:G	1176	671	2377	693	1684	2.0	1.0	2.0
chr12:49954295:T:C	0	0	0	0	0	0	0	0
chr12:49955628:C:A	0	0	0	0	0	0	0	0
chr12:50073861:G:T	0	0	0	0	0	0	0	0
chr12:50073986:G:A	0	0	0	0	0	0	0	0
chr12:50109486:C:T	0	0	0	0	0	0	0	0
chr12:50144032:A:G	125	74	200	52	148	2	0	2
chr12:50222563:A:G	4	0	4	4	0	1.0	1.0	0.0
chr12:50330661:G:C	0	0	0	0	0	0	0	0
chr12:50333923:G:C	0	0	0	0	0	0	0	0
chr12:50334028:C:T	0	0	0	0	0	0	0	0
chr12:50350970:T:C	0	0	0	0	0	0	0	0
chr12:50360780:T:G	0	0	0	0	0	0	0	0
chr12:50695951:T:A	6	3	9	3	6	1.5	0.5	1.0
chr12:50744904:A:C	3	2	5	1	4	2	0	2
chr12:50809588:C:T	131	52	184	80	104	1	1	0
chr12:50844033:G:A	0	0	0	0	0	0	0	0
chr12:50992283:A:G	14	8	23	7	16	2.0	0.5	2.0
chr12:51049161:G:A	260	139	414	132	282	2.0	0.0	2.0
chr12:51242475:C:T	870	391	1375	554	821	1.0	1.0	0.0
chr12:51328527:C:T	0	0	0	0	0	0	0	0
chr12:51343778:T:C	0	0	0	0	0	0	0	0
chr12:51770005:G:A	0	0	0	0	0	0	0	0
chr12:51790487:T:C	0	0	0	0	0	0	0	0
chr12:51806958:C:A	0	0	0	0	0	0	0	0
chr12:52038687:G:A	2	0	2	2	0	1.0	1.0	0.0
chr12:52058973:C:T	17	9	28	8	20	2	0	2
chr12:52171538:G:T	0	0	0	0	0	0	0	0
chr12:52185510:G:A	0	0	0	0	0	0	0	0
chr12:52191911:C:G	0	0	0	0	0	0	0	0
chr12:52237625:C:T	0	0	0	0	0	0	0	0
chr12:52241576:G:A	0	0	0	0	0	0	0	0
chr12:52258212:C:A	0	0	0	0	0	0	0	0
chr12:52286224:T:C	0	0	0	0	0	0	0	0
chr12:52287272:C:T	0	0	0	0	0	0	0	0
chr12:52287296:G:A	0	0	0	0	0	0	0	0
chr12:52287632:T:C	0	0	0	0	0	0	0	0
chr12:52287653:A:G	0	0	0	0	0	0	0	0
chr12:52305764:T:C	0	0	0	0	0	0	0	0
chr12:52314636:G:A	0	0	0	0	0	0	0	0
chr12:52314781:A:G	0	0	0	0	0	0	0	0
chr12:52317765:G:T	0	0	0	0	0	0	0	0
chr12:52319191:G:A	0	0	0	0	0	0	0	0
chr12:52344327:T:C	0	0	0	0	0	0	0	0
chr12:52364444:C:T	0	0	0	0	0	0	0	0
chr12:52367173:C:T	0	0	0	0	0	0	0	0
chr12:52395161:C:G	0	0	0	0	0	0	0	0
chr12:52428208:A:G	0	0	0	0	0	0	0	0
chr12:52428474:A:G	0	0	0	0	0	0	0	0
chr12:52431579:G:A	0	0	0	0	0	0	0	0
chr12:52433956:G:C	0	0	0	0	0	0	0	0
chr12:52434034:T:C	0	0	0	0	0	0	0	0
chr12:52447395:T:C	0	0	0	0	0	0	0	0
chr12:52447981:G:A	0	0	0	0	0	0	0	0
chr12:52452017:T:C	0	0	0	0	0	0	0	0
chr12:52468986:T:C	0	0	0	0	0	0	0	0
chr12:52469780:C:T	0	0	0	0	0	0	0	0
chr12:52469837:T:G	0	0	0	0	0	0	0	0
chr12:52472116:C:T	0	0	0	0	0	0	0	0
chr12:52487644:A:C	0	0	0	0	0	0	0	0
chr12:52490499:A:G	0	0	0	0	0	0	0	0
chr12:52490773:T:C	0	0	0	0	0	0	0	0
chr12:52490951:A:G	0	0	0	0	0	0	0	0
chr12:52492706:A:G	0	0	0	0	0	0	0	0
chr12:52493127:T:C	0	0	0	0	0	0	0	0
chr12:52520427:T:C	0	0	0	0	0	0	0	0
chr12:52571389:T:G	0	0	0	0	0	0	0	0
chr12:52587658:C:A	0	0	0	0	0	0	0	0
chr12:52590836:C:T	0	0	0	0	0	0	0	0
chr12:52591509:A:G	0	0	0	0	0	0	0	0
chr12:52592403:T:C	0	0	0	0	0	0	0	0
chr12:52599028:T:C	0	0	0	0	0	0	0	0
chr12:52651842:T:C	0	0	0	0	0	0	0	0
chr12:52651993:G:A	0	0	0	0	0	0	0	0
chr12:52676337:T:G	0	0	0	0	0	0	0	0
chr12:52676361:G:A	0	0	0	0	0	0	0	0
chr12:52676390:C:A	0	0	0	0	0	0	0	0
chr12:52691144:T:G	0	0	0	0	0	0	0	0
chr12:52691305:T:C	0	0	0	0	0	0	0	0
chr12:52692861:G:A	0	0	0	0	0	0	0	0
chr12:52694700:C:T	0	0	0	0	0	0	0	0
chr12:52696406:C:T	0	0	0	0	0	0	0	0
chr12:52697782:C:A	0	0	0	0	0	0	0	0
chr12:52768854:G:A	0	0	0	0	0	0	0	0
chr12:52768965:G:A	0	0	0	0	0	0	0	0
chr12:52771064:G:A	0	0	0	0	0	0	0	0
chr12:52772156:C:T	0	0	0	0	0	0	0	0
chr12:52772819:T:C	0	0	0	0	0	0	0	0
chr12:52792304:G:C	0	0	0	0	0	0	0	0
chr12:52792338:G:A	0	0	0	0	0	0	0	0
chr12:52848656:A:G	0	0	0	0	0	0	0	0
chr12:52900597:T:C	0	0	0	0	0	0	0	0
chr12:52904985:A:G	0	0	0	0	0	0	0	0
chr12:52904991:A:T	0	0	0	0	0	0	0	0
chr12:52905051:T:G	0	0	0	0	0	0	0	0
chr12:53037514:T:A	294	160	482	155	327	2.0	0.0	2.0
chr12:53115555:GC:TT	0	0	0	0	0	0	0	0
chr12:53116149:C:T	0	0	0	0	0	0	0	0
chr12:53154056:A:C	0	0	0	0	0	0	0	0
chr12:53154203:A:G	0	0	0	0	0	0	0	0
chr12:53160142:C:T	9	6	15	3	12	2	0	2
chr12:53170081:G:A	8	6	14	2	12	2.0	0.0	2.0
chr12:53192041:C:T	3	0	3	3	0	1	1	0
chr12:53192075:C:T	3	0	3	3	0	1	1	0
chr12:53193038:G:A	9	4	13	5	8	1	1	0
chr12:53193684:T:G	2	1	3	1	2	1.5	0.5	1.0
chr12:53211712:C:T	23	11	34	12	22	1	1	0
chr12:53289202:C:T	0	0	0	0	0	0	0	0
chr12:53715875:C:T	51	26	78	26	52	2	1	2
chr12:53715949:A:G	51	25	77	27	50	1	1	0
chr12:53945268:C:A	0	0	0	0	0	0	0	0
chr12:54000713:C:T	0	0	0	0	0	0	0	0
chr12:54257687:A:G	76	47	124	30	94	2.0	0.0	2.0
chr12:54561540:T:C	3	1	4	2	2	1	1	0
chr12:54572541:G:A	0	0	0	0	0	0	0	0
chr12:54576452:G:A	0	0	0	0	0	0	0	0
chr12:54855218:A:G	0	0	0	0	0	0	0	0
chr12:54856828:A:G	0	0	0	0	0	0	0	0
chr12:55637154:C:T	0	0	0	0	0	0	0	0
chr12:55637489:G:A	0	0	0	0	0	0	0	0
chr12:55700033:T:G	0	0	0	0	0	0	0	0
chr12:55703032:T:C	0	0	0	0	0	0	0	0
chr12:55839529:G:A	0	0	0	0	0	0	0	0
chr12:55941323:A:G	97	55	152	42	110	2	0	2
chr12:55954244:G:A	6	1	8	6	2	1.0	1.0	0.0
chr12:55957562:G:A	0	0	0	0	0	0	0	0
chr12:55980911:G:A	9	7	16	2	14	2	0	2
chr12:56236980:G:A	0	0	0	0	0	0	0	0
chr12:56243191:C:G	0	0	0	0	0	0	0	0
chr12:56254127:G:C	19	5	26	14	12	1	1	0
chr12:56254993:C:T	6	5	11	1	10	2.0	0.0	2.0
chr12:56255817:A:G	88	45	135	44	91	1.5	0.5	1.5
chr12:56273514:T:C	20	11	31	9	22	2.0	0.0	2.0
chr12:56285967:A:G	82	28	111	55	56	1.0	1.0	0.0
chr12:56314792:G:A	317	143	481	185	296	1	1	0
chr12:56324021:G:A	1	0	1	1	0	1	1	0
chr12:56324638:T:C	4	3	7	1	6	2.0	0.0	2.0
chr12:56339747:G:A	91	46	143	45	98	2	0	2
chr12:56346898:C:G	13	7	20	6	14	2	0	2
chr12:56420779:G:A	0	0	0	0	0	0	0	0
chr12:56471554:A:G	8	1	9	7	2	1.0	1.0	0.0
chr12:56473178:C:T	13	8	21	5	16	2	0	2
chr12:56562429:T:C	21	9	30	12	18	1	1	0
chr12:56606385:A:C	55	28	86	28	58	2	1	2
chr12:56609941:C:T	117	60	183	57	126	2	0	2
chr12:56636242:T:C	69	37	106	34	72	2	0	2
chr12:56712876:A:T	4753	4071	30585	10190	20395	5	2	4
chr12:56714419:A:G	4757	4087	30911	10320	20591	6	2	4
chr12:56716008:A:G	1	0	1	1	0	1	1	0
chr12:56716147:A:T	1	0	1	1	0	1	1	0
chr12:56720316:A:G	4	2	6	2	4	1.5	0.5	1.0
chr12:56720523:A:T	3	1	4	2	2	1	1	0
chr12:56739356:T:G	126	53	180	74	106	1.0	1.0	0.0
chr12:56744044:T:A	1	1	2	0	2	2	0	2
chr12:56996254:T:C	0	0	0	0	0	0	0	0
chr12:57012660:T:C	0	0	0	0	0	0	0	0
chr12:57029150:G:A	2	1	3	1	2	1.5	0.5	1.0
chr12:57029413:T:C	1	0	1	1	0	1	1	0
chr12:57030064:T:C	1	0	1	1	0	1	1	0
chr12:57030148:C:A	1	0	1	1	0	1	1	0
chr12:57200373:C:T	0	0	0	0	0	0	0	0
chr12:57233934:G:A	5	3	8	2	6	2	0	2
chr12:57243810:G:A	48	48	98	0	98	2.0	0.0	2.0
chr12:57256057:C:T	10	2	13	9	4	1.0	1.0	0.0
chr12:57455985:C:G	0	0	0	0	0	0	0	0
chr12:57465648:G:A	0	0	0	0	0	0	0	0
chr12:57471538:G:A	1	0	1	1	0	1	1	0
chr12:57472038:G:C	1	0	1	1	0	1	1	0
chr12:57474124:G:A	183	104	303	83	220	2	0	2
chr12:57475799:T:C	28	10	39	19	20	1.0	1.0	0.0
chr12:57476372:A:C	155	81	252	78	174	2	0	2
chr12:57591421:C:T	61	27	91	35	56	1	1	0
chr12:57608816:C:T	7	4	11	3	8	2	0	2
chr12:57732451:C:A	7	4	11	3	8	2	0	2
chr12:57750882:C:T	5	3	8	2	6	2	0	2
chr12:57751373:C:T	5	2	7	3	4	1	1	0
chr12:57768956:A:G	36	14	50	22	28	1.0	1.0	0.0
chr12:57780523:T:C	4	4	8	0	8	2.0	0.0	2.0
chr12:57780735:G:A	4	4	8	0	8	2.0	0.0	2.0
chr12:57782831:T:C	125	63	190	64	126	2	1	2
chr12:57802664:G:A	0	0	0	0	0	0	0	0
chr12:57808636:C:A	1	1	2	0	2	2	0	2
chr12:62234621:C:T	0	0	0	0	0	0	0	0
chr12:62234777:G:T	0	0	0	0	0	0	0	0
chr12:62532618:G:A	9	2	11	7	4	1	1	0
chr12:62534853:G:A	4	2	6	2	4	1.5	0.5	1.0
chr12:62585436:G:A	17	5	22	12	10	1	1	0
chr12:63560524:T:C	0	0	0	0	0	0	0	0
chr12:64091372:C:T	0	0	0	0	0	0	0	0
chr12:64127886:C:G	0	0	0	0	0	0	0	0
chr12:64221964:C:A	45	23	70	24	46	2	0	2
chr12:64482007:T:A	52	25	77	27	50	1.0	1.0	0.0
chr12:64875267:G:A	0	0	0	0	0	0	0	0
chr12:67305756:G:A	13	6	19	7	12	1	1	0
chr12:67312686:G:A	39	17	56	22	34	1	1	0
chr12:67657791:A:G	29	17	46	12	34	2	0	2
chr12:68314981:C:T	8	5	13	3	10	2.0	0.0	2.0
chr12:68316112:C:T	14	10	24	4	20	2.0	0.0	2.0
chr12:68325436:G:A	5	1	6	4	2	1	1	0
chr12:68326847:G:A	26	19	45	7	38	2.0	0.0	2.0
chr12:68553629:G:A	0	0	0	0	0	0	0	0
chr12:68746559:G:C	106	47	154	61	93	1.0	1.0	0.0
chr12:69697672:A:G	0	0	0	0	0	0	0	0
chr12:69880205:T:G	0	0	0	0	0	0	0	0
chr12:69936307:A:G	0	0	0	0	0	0	0	0
chr12:70569839:G:A	0	0	0	0	0	0	0	0
chr12:70570970:G:A	0	0	0	0	0	0	0	0
chr12:70596274:T:C	0	0	0	0	0	0	0	0
chr12:70635953:C:T	0	0	0	0	0	0	0	0
chr12:70761600:A:G	0	0	0	0	0	0	0	0
chr12:71620052:A:G	11	5	16	6	10	1	1	0
chr12:71630882:C:G	10	4	14	6	8	1.0	1.0	0.0
chr12:71979082:A:G	0	0	0	0	0	0	0	0
chr12:74538379:G:C	118	74	195	45	150	2.0	0.0	2.0
chr12:75391320:C:T	6	1	7	5	2	1.0	1.0	0.0
chr12:75501839:T:C	16	7	23	9	14	1.0	1.0	0.0
chr12:76822501:G:A	52	25	77	27	50	1.0	1.0	0.0
chr12:77025561:A:T	1	1	2	0	2	2	0	2
chr12:77025813:A:G	1	1	2	0	2	2	0	2
chr12:78007104:G:A	0	0	0	0	0	0	0	0
chr12:78119804:A:T	0	0	0	0	0	0	0	0
chr12:78205111:G:A	0	0	0	0	0	0	0	0
chr12:79448929:G:T	0	0	0	0	0	0	0	0
chr12:80460849:C:T	0	0	0	0	0	0	0	0
chr12:80541566:T:C	0	0	0	0	0	0	0	0
chr12:80541713:A:G	0	0	0	0	0	0	0	0
chr12:80542303:C:T	0	0	0	0	0	0	0	0
chr12:81439966:G:T	0	0	0	0	0	0	0	0
chr12:85055687:T:A	0	0	0	0	0	0	0	0
chr12:85072945:G:A	0	0	0	0	0	0	0	0
chr12:88046899:G:C	50	25	75	25	50	1.5	0.5	1.0
chr12:88111856:A:G	17	7	24	10	14	1	1	0
chr12:91056207:C:T	0	0	0	0	0	0	0	0
chr12:91056213:C:T	0	0	0	0	0	0	0	0
chr12:92737427:A:C	1	1	2	0	2	2	0	2
chr12:92754131:A:T	2	1	3	1	2	1.5	0.5	1.0
chr12:92756326:T:C	2	1	3	1	2	1.5	0.5	1.0
chr12:92802646:T:G	18	10	28	8	20	2.0	0.0	2.0
chr12:92809025:C:T	29	12	40	17	23	1	1	0
chr12:92864889:A:G	105	50	163	57	106	1	1	0
chr12:94149730:C:T	0	0	0	0	0	0	0	0
chr12:94186510:T:C	0	0	0	0	0	0	0	0
chr12:94248247:C:T	1	1	2	0	2	2	0	2
chr12:94424181:G:A	1	0	1	1	0	1	1	0
chr12:94582383:T:C	15	10	25	5	20	2	0	2
chr12:95049258:G:C	9	4	13	5	8	1	1	0
chr12:95533261:A:G	6	3	9	3	6	1.5	0.5	1.0
chr12:95683536:C:T	0	0	0	0	0	0	0	0
chr12:95738117:A:G	0	0	0	0	0	0	0	0
chr12:95867169:A:G	4	4	8	0	8	2.0	0.0	2.0
chr12:95898392:C:G	0	0	0	0	0	0	0	0
chr12:95990344:T:C	1	1	2	0	2	2	0	2
chr12:95990361:T:C	1	1	2	0	2	2	0	2
chr12:95990471:T:C	1	1	2	0	2	2	0	2
chr12:98613845:C:T	87	36	128	54	74	1	1	0
chr12:98773027:G:T	0	0	0	0	0	0	0	0
chr12:99648074:G:A	0	0	0	0	0	0	0	0
chr12:99648319:G:A	0	0	0	0	0	0	0	0
chr12:100624383:C:T	0	0	0	0	0	0	0	0
chr12:101168162:A:T	0	0	0	0	0	0	0	0
chr12:101193740:C:T	0	0	0	0	0	0	0	0
chr12:101209705:G:T	0	0	0	0	0	0	0	0
chr12:101401231:A:C	8	4	12	4	8	1.5	0.5	1.0
chr12:101486350:A:G	0	0	0	0	0	0	0	0
chr12:101659897:C:T	0	0	0	0	0	0	0	0
chr12:101675299:A:G	0	0	0	0	0	0	0	0
chr12:101685640:G:A	0	0	0	0	0	0	0	0
chr12:101714523:T:C	42	17	59	25	34	1.0	1.0	0.0
chr12:101764985:T:C	90	33	123	57	66	1.0	1.0	0.0
chr12:101901440:T:C	93	48	143	46	97	2	0	2
chr12:102061951:G:A	416	183	640	256	384	1.0	1.0	0.0
chr12:102076854:G:T	24	19	45	5	40	2.0	0.0	2.0
chr12:102124026:G:A	47	25	73	23	50	2	0	2
chr12:102151785:A:G	6	4	10	2	8	2.0	0.0	2.0
chr12:103302404:T:G	14	9	23	5	18	2.0	0.0	2.0
chr12:103674034:C:T	0	0	0	0	0	0	0	0
chr12:103706957:G:A	0	0	0	0	0	0	0	0
chr12:103755244:G:A	0	0	0	0	0	0	0	0
chr12:103763392:G:C	0	0	0	0	0	0	0	0
chr12:103763480:C:G	0	0	0	0	0	0	0	0
chr12:103766269:A:G	0	0	0	0	0	0	0	0
chr12:103793168:G:T	9	7	16	2	14	2	0	2
chr12:103947325:C:T	399	196	645	229	416	2	1	0
chr12:104251606:C:G	0	0	0	0	0	0	0	0
chr12:104265317:C:T	79	1	85	83	2	1	1	0
chr12:104265543:A:G	83	77	169	6	163	2	0	2
chr12:104265708:G:A	93	0	98	98	0	1	1	0
chr12:104265759:A:G	100	0	106	106	0	1.0	1.0	0.0
chr12:107001328:A:G	15	11	28	4	24	2	0	2
chr12:107319103:C:T	0	0	0	0	0	0	0	0
chr12:107702992:G:C	117	68	188	52	136	2	0	2
chr12:107734188:A:G	20	10	30	10	20	1.5	0.5	1.0
chr12:107742395:A:G	3	2	5	1	4	2	0	2
chr12:108292231:C:G	0	0	0	0	0	0	0	0
chr12:108788273:T:C	3	0	3	3	0	1	1	0
chr12:109073451:T:C	11	6	17	5	12	2	0	2
chr12:109259033:G:A	0	0	0	0	0	0	0	0
chr12:109266372:G:A	3	1	4	2	2	1	1	0
chr12:109279892:A:G	0	0	0	0	0	0	0	0
chr12:109469503:G:C	8	3	11	5	6	1.0	1.0	0.0
chr12:109490022:C:A	11	5	16	6	10	1	1	0
chr12:109568707:A:G	12	5	18	8	10	1.5	1.0	0.0
chr12:109573424:GC:TT	133	66	206	68	138	2	1	0
chr12:109783756:G:A	0	0	0	0	0	0	0	0
chr12:109803033:T:G	0	0	0	0	0	0	0	0
chr12:110065965:T:C	0	0	0	0	0	0	0	0
chr12:110403632:C:T	130	62	194	70	124	1.0	1.0	0.0
chr12:111748470:C:T	7	5	12	2	10	2	0	2
chr12:112152836:A:G	35	20	55	15	40	2	0	2
chr12:112229871:T:G	3	1	4	2	2	1	1	0
chr12:112865416:G:A	0	0	0	0	0	0	0	0
chr12:112911065:G:A	385	174	615	235	380	1	1	0
chr12:112938515:C:T	25	20	47	5	42	2	0	2
chr12:112938526:C:A	25	20	47	5	42	2	0	2
chr12:112938583:G:A	25	18	43	7	36	2	0	2
chr12:112938647:C:T	25	19	44	6	38	2	0	2
chr12:112948974:C:G	2	2	4	0	4	2.0	0.0	2.0
chr12:112949145:T:C	3	3	6	0	6	2	0	2
chr12:112965879:C:T	0	0	0	0	0	0	0	0
chr12:112987088:C:G	15	5	20	10	10	1	1	0
chr12:112987349:C:G	5	0	5	5	0	1	1	0
chr12:112997645:A:T	10	5	15	5	10	1.5	0.5	1.0
chr12:113010483:A:G	7	5	12	2	10	2	0	2
chr12:113287140:A:G	0	0	0	0	0	0	0	0
chr12:113398910:C:T	0	0	0	0	0	0	0	0
chr12:113398916:C:T	0	0	0	0	0	0	0	0
chr12:113937082:T:C	10	3	13	7	6	1.0	1.0	0.0
chr12:113940030:A:G	6	1	7	5	2	1.0	1.0	0.0
chr12:113940072:T:C	6	1	7	5	2	1.0	1.0	0.0
chr12:113945846:C:T	9	4	13	5	8	1	1	0
chr12:113948834:A:G	6	2	8	4	4	1.0	1.0	0.0
chr12:113957846:T:C	14	5	19	9	10	1.0	1.0	0.0
chr12:117028176:T:C	8	3	11	5	6	1.0	1.0	0.0
chr12:117232109:G:A	0	0	0	0	0	0	0	0
chr12:117247465:G:A	0	0	0	0	0	0	0	0
chr12:117256012:G:A	0	0	0	0	0	0	0	0
chr12:117263909:A:G	0	0	0	0	0	0	0	0
chr12:117555259:C:T	4	1	5	3	2	1.0	1.0	0.0
chr12:117761481:C:G	12	6	18	6	12	1.5	0.5	1.0
chr12:118035249:T:C	105	38	144	68	76	1	1	0
chr12:118068381:A:T	8	3	11	5	6	1.0	1.0	0.0
chr12:118070991:A:G	2	1	3	1	2	1.5	0.5	1.0
chr12:118071281:A:T	2	1	3	1	2	1.5	0.5	1.0
chr12:118071333:A:G	2	1	3	1	2	1.5	0.5	1.0
chr12:118071343:C:T	2	1	3	1	2	1.5	0.5	1.0
chr12:118071352:T:C	2	1	3	1	2	1.5	0.5	1.0
chr12:118246438:A:G	1	1	2	0	2	2	0	2
chr12:119151157:G:A	0	0	0	0	0	0	0	0
chr12:119523782:G:A	0	0	0	0	0	0	0	0
chr12:119680081:G:A	2	1	3	1	2	1.5	0.5	1.0
chr12:119708182:G:C	0	0	0	0	0	0	0	0
chr12:119713688:T:C	0	0	0	0	0	0	0	0
chr12:119734190:T:C	0	0	0	0	0	0	0	0
chr12:119752074:A:G	0	0	0	0	0	0	0	0
chr12:119752083:T:C	0	0	0	0	0	0	0	0
chr12:119782478:A:G	0	0	0	0	0	0	0	0
chr12:119783832:C:T	0	0	0	0	0	0	0	0
chr12:120097365:G:A	19	8	27	11	16	1	1	0
chr12:120098979:C:T	3	3	6	0	6	2	0	2
chr12:120151356:A:G	1	0	1	1	0	1	1	0
chr12:120168359:T:C	9	6	15	3	12	2	0	2
chr12:120224174:T:C	7	4	11	3	8	2	0	2
chr12:120659819:G:A	0	0	0	0	0	0	0	0
chr12:120694088:C:T	0	0	0	0	0	0	0	0
chr12:120737096:T:C	50	30	83	23	60	2.0	0.0	2.0
chr12:120738181:T:C	2	0	2	2	0	1.0	1.0	0.0
chr12:120738876:C:T	59	36	98	26	72	2	0	2
chr12:120999418:T:C	0	0	0	0	0	0	0	0
chr12:121004396:T:A	65	27	93	39	54	1	1	0
chr12:121004411:G:A	65	27	93	39	54	1	1	0
chr12:121016454:T:A	68	26	94	42	52	1.0	1.0	0.0
chr12:121020597:C:T	9	4	13	5	8	1	1	0
chr12:121641283:C:T	81	40	122	42	80	1	1	0
chr12:121641535:T:C	83	42	126	42	84	2	1	2
chr12:121748362:C:T	34	10	44	24	20	1.0	1.0	0.0
chr12:121748411:G:A	34	10	44	24	20	1.0	1.0	0.0
chr12:121823550:G:A	4	2	6	2	4	1.5	0.5	1.0
chr12:121857429:T:C	0	0	0	0	0	0	0	0
chr12:121888906:T:C	564	317	940	282	658	2.0	0.0	2.0
chr12:121958489:C:T	0	0	0	0	0	0	0	0
chr12:121968006:G:T	0	0	0	0	0	0	0	0
chr12:122043973:A:C	59	25	89	35	54	1	1	0
chr12:122266474:G:A	106	48	154	58	96	1.0	1.0	0.0
chr12:122620596:C:T	22	15	37	7	30	2.0	0.0	2.0
chr12:122715522:AG:GC	0	0	0	0	0	0	0	0
chr12:122715552:T:C	0	0	0	0	0	0	0	0
chr12:122716146:A:G	0	0	0	0	0	0	0	0
chr12:122716221:T:G	0	0	0	0	0	0	0	0
chr12:122716390:T:G	0	0	0	0	0	0	0	0
chr12:122716744:A:G	0	0	0	0	0	0	0	0
chr12:122729523:G:A	0	0	0	0	0	0	0	0
chr12:122976570:G:A	0	0	0	0	0	0	0	0
chr12:123320714:G:A	16	7	23	9	14	1.0	1.0	0.0
chr12:123619502:A:G	80	36	121	45	76	1.0	1.0	0.0
chr12:123620139:G:A	11	5	16	6	10	1	1	0
chr12:123696502:C:T	6	3	9	3	6	1.5	0.5	1.0
chr12:123724785:T:C	20	9	29	11	18	1.0	1.0	0.0
chr12:123744882:T:C	16	6	17	10	7	1.0	1.0	0.0
chr12:123783156:T:C	0	0	0	0	0	0	0	0
chr12:123789927:A:G	0	0	0	0	0	0	0	0
chr12:123813530:C:T	0	0	0	0	0	0	0	0
chr12:124800202:A:G	0	0	0	0	0	0	0	0
chr12:124911942:T:C	4713	3657	23558	8610	14948	4	1	2
chr12:124912818:A:G	4634	3499	22231	8463	13768	4.0	1.0	2.0
chr12:124913493:G:C	4601	3493	22018	8258	13760	4	1	2
chr12:124950034:C:T	7	5	12	2	10	2	0	2
chr12:124950170:G:A	7	5	12	2	10	2	0	2
chr12:124952473:T:C	6	4	10	2	8	2.0	0.0	2.0
chr12:124953970:T:C	6	4	10	2	8	2.0	0.0	2.0
chr12:124956813:T:C	19	8	27	11	16	1	1	0
chr12:124966941:C:T	3	2	5	1	4	2	0	2
chr12:125076605:A:G	5	3	8	2	6	2	0	2
chr12:125118606:C:T	0	0	0	0	0	0	0	0
chr12:125652514:C:T	0	0	0	0	0	0	0	0
chr12:128808801:C:T	12	6	18	6	12	1.5	0.5	1.0
chr12:128815130:C:G	15	7	22	8	14	1	1	0
chr12:130428212:C:T	0	0	0	0	0	0	0	0
chr12:130969154:A:G	0	0	0	0	0	0	0	0
chr12:130987154:G:A	0	0	0	0	0	0	0	0
chr12:131084552:G:A	0	0	0	0	0	0	0	0
chr12:131084560:C:T	0	0	0	0	0	0	0	0
chr12:131840694:G:A	4	3	7	1	6	2.0	0.0	2.0
chr12:132077581:G:A	445	218	716	250	466	2	1	0
chr12:132142123:T:C	4	4	8	0	8	2.0	0.0	2.0
chr12:132150976:T:C	7	4	11	3	8	2	0	2
chr12:132197936:TCCA:GCCG	0	0	0	0	0	0	0	0
chr12:132201021:C:T	0	0	0	0	0	0	0	0
chr12:132201281:T:C	0	0	0	0	0	0	0	0
chr12:132203592:A:G	0	0	0	0	0	0	0	0
chr12:132247897:G:T	0	0	0	0	0	0	0	0
chr12:132606232:G:A	0	0	0	0	0	0	0	0
chr12:132625629:G:A	1	1	2	0	2	2	0	2
chr12:132632393:T:C	9	5	14	4	10	2	0	2
chr12:132638182:A:G	0	0	0	0	0	0	0	0
chr12:132643245:T:C	1	0	1	1	0	1	1	0
chr12:132648860:G:T	0	0	0	0	0	0	0	0
chr12:132659414:C:T	1	0	1	1	0	1	1	0
chr12:132672553:T:A	0	0	0	0	0	0	0	0
chr12:132675970:T:C	0	0	0	0	0	0	0	0
chr12:132676210:C:G	0	0	0	0	0	0	0	0
chr12:132730003:C:T	25	12	37	13	24	1	1	0
chr12:132730341:AT:GC	0	0	0	0	0	0	0	0
chr12:132735358:T:C	5	1	6	4	2	1	1	0
chr12:132750884:A:T	0	0	0	0	0	0	0	0
chr12:132754951:G:A	125	44	172	82	90	1	1	0
chr12:133121812:G:A	23	16	39	7	32	2	0	2
chr12:133219299:G:A	0	0	0	0	0	0	0	0
chr13:18176081:G:A	0	0	0	0	0	0	0	0
chr13:18279410:T:C	0	0	0	0	0	0	0	0
chr13:18294474:C:A	0	0	0	0	0	0	0	0
chr13:18297943:C:T	0	0	0	0	0	0	0	0
chr13:18298334:T:C	0	0	0	0	0	0	0	0
chr13:18298669:C:T	0	0	0	0	0	0	0	0
chr13:18301452:C:T	0	0	0	0	0	0	0	0
chr13:19177404:C:T	0	0	0	0	0	0	0	0
chr13:20034325:T:C	11	2	13	9	4	1	1	0
chr13:20188817:A:G	0	0	0	0	0	0	0	0
chr13:20189475:A:C	0	0	0	0	0	0	0	0
chr13:21604119:C:T	422	213	668	226	442	2.0	1.0	2.0
chr13:23250644:T:G	0	0	0	0	0	0	0	0
chr13:23324370:T:C	0	0	0	0	0	0	0	0
chr13:24123202:C:A	0	0	0	0	0	0	0	0
chr13:24223775:C:T	0	0	0	0	0	0	0	0
chr13:24793144:A:C	0	0	0	0	0	0	0	0
chr13:25365934:T:C	0	0	0	0	0	0	0	0
chr13:26215391:A:G	29	17	45	12	33	2	0	2
chr13:26680166:G:C	0	0	0	0	0	0	0	0
chr13:27569092:A:G	24	12	36	12	24	1.5	0.5	1.0
chr13:27623299:C:T	491	229	770	288	482	1	1	0
chr13:27665803:G:C	318	138	467	191	276	1.0	1.0	0.0
chr13:27665833:G:A	305	132	447	183	264	1	1	0
chr13:27988468:T:G	4	1	5	3	2	1.0	1.0	0.0
chr13:28034322:T:C	104	53	162	56	106	2.0	1.0	2.0
chr13:28260477:A:G	82	38	123	45	78	1.0	1.0	0.0
chr13:28319505:A:G	0	0	0	0	0	0	0	0
chr13:28713415:C:T	22	9	31	13	18	1.0	1.0	0.0
chr13:29514470:G:A	1	1	2	0	2	2	0	2
chr13:30428236:G:A	0	0	0	0	0	0	0	0
chr13:30657669:T:C	26	11	37	15	22	1.0	1.0	0.0
chr13:30658926:G:A	29	16	48	14	34	2	0	2
chr13:30744171:C:A	0	0	0	0	0	0	0	0
chr13:31161622:G:A	68	35	105	33	72	2.0	0.0	2.0
chr13:31274581:G:A	21	9	30	12	18	1	1	0
chr13:31329697:G:T	10	6	16	4	12	2.0	0.0	2.0
chr13:31329704:A:G	10	6	16	4	12	2.0	0.0	2.0
chr13:32202479:T:A	9	4	13	5	8	1	1	0
chr13:32316435:G:A	52	23	75	29	46	1.0	1.0	0.0
chr13:32333270:A:G	6	2	8	4	4	1.0	1.0	0.0
chr13:32337751:A:G	5	1	6	4	2	1	1	0
chr13:32425814:G:C	284	146	455	147	308	2.0	0.0	2.0
chr13:35070815:A:C	3	1	4	2	2	1	1	0
chr13:35161839:A:G	3	1	4	2	2	1	1	0
chr13:35593292:G:A	0	0	0	0	0	0	0	0
chr13:35810894:G:T	0	0	0	0	0	0	0	0
chr13:36112001:T:C	0	0	0	0	0	0	0	0
chr13:36312332:T:C	49	23	72	26	46	1	1	0
chr13:37006002:G:A	530	277	863	284	579	2.0	1.0	2.0
chr13:37105131:G:T	0	0	0	0	0	0	0	0
chr13:37783334:G:A	0	0	0	0	0	0	0	0
chr13:38689594:C:T	0	0	0	0	0	0	0	0
chr13:39047938:T:C	11	5	16	6	10	1	1	0
chr13:39655754:G:A	61	32	102	30	72	2	0	2
chr13:39655820:T:A	61	32	102	30	72	2	0	2
chr13:40808575:A:T	9	3	12	6	6	1	1	0
chr13:41193202:AGGA:GGGG	2	1	3	1	2	1.5	0.5	1.0
chr13:41260608:C:T	44	19	66	26	40	1.0	1.0	0.0
chr13:42198581:G:T	5	3	8	2	6	2	0	2
chr13:43023729:A:G	936	416	1561	670	891	1.0	1.0	0.0
chr13:43356124:G:A	0	0	0	0	0	0	0	0
chr13:43969235:C:T	1	0	1	1	0	1	1	0
chr13:44989329:G:C	82	45	129	37	92	2.0	0.0	2.0
chr13:45194624:G:A	1	0	1	1	0	1	1	0
chr13:45561404:C:T	0	0	0	0	0	0	0	0
chr13:45967538:T:A	7	4	11	3	8	2	0	2
chr13:45988800:A:G	21	13	34	8	26	2	0	2
chr13:46053542:T:C	4	3	7	1	6	2.0	0.0	2.0
chr13:46082534:A:G	0	0	0	0	0	0	0	0
chr13:46895805:G:A	0	0	0	0	0	0	0	0
chr13:46896689:C:T	0	0	0	0	0	0	0	0
chr13:51739059:C:T	139	45	186	96	90	1	1	0
chr13:51768070:G:A	126	76	206	52	154	2.0	0.0	2.0
chr13:51946371:C:T	0	0	0	0	0	0	0	0
chr13:52011412:G:T	0	0	0	0	0	0	0	0
chr13:52029058:G:T	22	10	32	12	20	1.0	1.0	0.0
chr13:52029105:A:G	22	10	32	12	20	1.0	1.0	0.0
chr13:52029639:C:T	12	3	15	9	6	1.0	1.0	0.0
chr13:52102139:T:G	0	0	0	0	0	0	0	0
chr13:52397382:C:T	0	0	0	0	0	0	0	0
chr13:52712815:C:T	0	0	0	0	0	0	0	0
chr13:52739242:G:A	0	0	0	0	0	0	0	0
chr13:53034497:C:T	0	0	0	0	0	0	0	0
chr13:57173506:C:G	0	0	0	0	0	0	0	0
chr13:59666695:C:T	0	0	0	0	0	0	0	0
chr13:60535241:A:C	8	3	11	5	6	1.0	1.0	0.0
chr13:67227589:A:G	30	8	38	22	16	1.0	1.0	0.0
chr13:67228207:A:T	27	9	36	18	18	1	1	0
chr13:70107741:A:G	0	0	0	0	0	0	0	0
chr13:72728188:G:A	5	1	6	4	2	1	1	0
chr13:72795504:A:G	98	53	153	45	108	2.0	0.0	2.0
chr13:75481684:G:C	0	0	0	0	0	0	0	0
chr13:75636606:A:C	122	80	202	42	160	2.0	0.0	2.0
chr13:75821328:C:T	14	10	24	4	20	2.0	0.0	2.0
chr13:75823595:G:A	14	5	19	9	10	1.0	1.0	0.0
chr13:75835300:A:G	19	11	30	8	22	2	0	2
chr13:75853211:C:A	18	7	25	11	14	1.0	1.0	0.0
chr13:75853267:G:A	18	7	25	11	14	1.0	1.0	0.0
chr13:75853274:C:G	18	7	25	11	14	1.0	1.0	0.0
chr13:76885086:G:A	0	0	0	0	0	0	0	0
chr13:85794985:C:T	0	0	0	0	0	0	0	0
chr13:94382495:G:A	0	0	0	0	0	0	0	0
chr13:94382509:G:A	0	0	0	0	0	0	0	0
chr13:95021537:A:C	4	0	4	4	0	1.0	1.0	0.0
chr13:95170507:C:T	1	1	2	0	2	2	0	2
chr13:98446064:C:T	0	0	0	0	0	0	0	0
chr13:98446216:C:T	0	0	0	0	0	0	0	0
chr13:98446628:A:C	0	0	0	0	0	0	0	0
chr13:98448293:T:C	0	0	0	0	0	0	0	0
chr13:98704358:A:G	0	0	0	0	0	0	0	0
chr13:99255087:G:A	198	86	305	127	178	1.0	1.0	0.0
chr13:99295843:A:G	600	349	1120	323	797	2.0	0.0	2.0
chr13:99983123:C:T	0	0	0	0	0	0	0	0
chr13:99984848:T:C	0	0	0	0	0	0	0	0
chr13:100540184:C:T	6	4	10	2	8	2.0	0.0	2.0
chr13:100606369:T:C	3	1	4	2	2	1	1	0
chr13:100614392:C:T	3	1	4	2	2	1	1	0
chr13:101143022:C:A	0	0	0	0	0	0	0	0
chr13:101143071:A:G	0	0	0	0	0	0	0	0
chr13:102852167:T:C	80	38	117	42	75	1.0	1.0	0.0
chr13:102875652:G:C	65	39	104	26	78	2	0	2
chr13:110161176:C:T	0	0	0	0	0	0	0	0
chr13:110161185:G:A	0	0	0	0	0	0	0	0
chr13:110161362:G:A	0	0	0	0	0	0	0	0
chr13:110166251:T:G	0	0	0	0	0	0	0	0
chr13:110211878:A:T	0	0	0	0	0	0	0	0
chr13:110445879:C:T	0	0	0	0	0	0	0	0
chr13:110449779:C:T	0	0	0	0	0	0	0	0
chr13:110456942:C:G	0	0	0	0	0	0	0	0
chr13:110457535:A:G	0	0	0	0	0	0	0	0
chr13:110462404:G:A	0	0	0	0	0	0	0	0
chr13:110467049:G:C	0	0	0	0	0	0	0	0
chr13:110469273:C:T	0	0	0	0	0	0	0	0
chr13:110511851:T:C	0	0	0	0	0	0	0	0
chr13:110638281:GAT:CAC	1	0	1	1	0	1	1	0
chr13:110638533:G:A	16	6	22	10	12	1.0	1.0	0.0
chr13:110641500:G:A	345	162	532	200	332	1	1	0
chr13:110641568:T:G	346	163	537	203	334	1.0	1.0	0.0
chr13:110646045:A:G	324	161	511	183	328	2.0	1.0	0.0
chr13:110715969:C:T	26	17	43	9	34	2.0	0.0	2.0
chr13:111153898:A:G	63	48	112	16	96	2	0	2
chr13:111217690:T:C	39	16	55	23	32	1	1	0
chr13:111328190:C:T	2	0	2	2	0	1.0	1.0	0.0
chr13:112810648:A:G	1	0	1	1	0	1	1	0
chr13:112854525:G:C	6	2	8	4	4	1.0	1.0	0.0
chr13:112858017:C:T	2	2	4	0	4	2.0	0.0	2.0
chr13:112859353:T:C	2	1	3	1	2	1.5	0.5	1.0
chr13:112859368:C:G	2	1	3	1	2	1.5	0.5	1.0
chr13:112873467:C:T	39	18	57	21	36	1	1	0
chr13:112876008:G:A	53	26	77	27	50	1	1	0
chr13:112882153:G:A	7	4	11	3	8	2	0	2
chr13:113001902:C:T	0	0	0	0	0	0	0	0
chr13:113457972:C:A	1	0	1	1	0	1	1	0
chr13:113520723:G:A	22	9	31	13	18	1.0	1.0	0.0
chr13:114015288:A:G	17	9	26	8	18	2	0	2
chr13:114301944:G:A	119	71	190	49	141	2	0	2
chr13:114325598:G:T	6	5	11	1	10	2.0	0.0	2.0
chr14:19747830:A:G	0	0	0	0	0	0	0	0
chr14:19827675:T:C	0	0	0	0	0	0	0	0
chr14:19827845:C:T	0	0	0	0	0	0	0	0
chr14:19828351:G:A	0	0	0	0	0	0	0	0
chr14:19935932:G:A	0	0	0	0	0	0	0	0
chr14:19936455:C:A	0	0	0	0	0	0	0	0
chr14:19936576:C:T	0	0	0	0	0	0	0	0
chr14:19936577:G:A	0	0	0	0	0	0	0	0
chr14:19936608:A:G	0	0	0	0	0	0	0	0
chr14:20014760:A:C	0	0	0	0	0	0	0	0
chr14:20033961:C:T	0	0	0	0	0	0	0	0
chr14:20060860:C:T	0	0	0	0	0	0	0	0
chr14:20060884:C:G	0	0	0	0	0	0	0	0
chr14:20117883:G:C	0	0	0	0	0	0	0	0
chr14:20197631:T:A	0	0	0	0	0	0	0	0
chr14:20224294:G:T	0	0	0	0	0	0	0	0
chr14:20224415:T:C	0	0	0	0	0	0	0	0
chr14:20229430:C:T	0	0	0	0	0	0	0	0
chr14:20229441:T:G	0	0	0	0	0	0	0	0
chr14:20242747:G:A	0	0	0	0	0	0	0	0
chr14:20289645:C:A	108	55	165	53	112	2.0	0.0	2.0
chr14:20301877:T:C	111	56	169	57	112	2	1	2
chr14:20316559:G:T	343	169	544	190	354	2	1	0
chr14:20356022:T:C	46	27	75	19	56	2.0	0.0	2.0
chr14:20357203:G:A	6	3	9	3	6	1.5	0.5	1.0
chr14:20383870:A:G	0	0	0	0	0	0	0	0
chr14:20384658:G:A	0	0	0	0	0	0	0	0
chr14:20391046:C:T	0	0	0	0	0	0	0	0
chr14:20395518:C:A	3	2	5	1	4	2	0	2
chr14:20403486:C:A	7	5	12	2	10	2	0	2
chr14:20404722:G:T	9	4	12	5	7	1	1	0
chr14:20408094:A:G	41	27	68	14	54	2	0	2
chr14:20448090:T:C	0	0	0	0	0	0	0	0
chr14:20448799:T:C	175	81	260	99	161	1	1	0
chr14:20448828:G:A	1	1	2	0	2	2	0	2
chr14:20449283:A:T	10	6	16	4	12	2.0	0.0	2.0
chr14:20452091:T:C	400	213	640	207	433	2.0	0.0	2.0
chr14:20452181:A:G	152	80	238	76	162	2.0	0.0	2.0
chr14:20558614:C:T	0	0	0	0	0	0	0	0
chr14:20584100:T:C	0	0	0	0	0	0	0	0
chr14:20590266:G:T	0	0	0	0	0	0	0	0
chr14:20640982:C:T	0	0	0	0	0	0	0	0
chr14:20641119:A:T	0	0	0	0	0	0	0	0
chr14:20641226:C:T	0	0	0	0	0	0	0	0
chr14:20641512:A:G	0	0	0	0	0	0	0	0
chr14:20641567:G:A	0	0	0	0	0	0	0	0
chr14:20699417:A:T	27	22	49	5	44	2	0	2
chr14:20770639:T:C	0	0	0	0	0	0	0	0
chr14:20781965:G:A	923	541	1818	562	1256	2	1	2
chr14:20990490:C:G	250	137	392	116	276	2.0	0.0	2.0
chr14:20992743:T:C	57	18	75	39	36	1	1	0
chr14:20999754:T:G	0	0	0	0	0	0	0	0
chr14:21023373:G:A	0	0	0	0	0	0	0	0
chr14:21032170:C:A	0	0	0	0	0	0	0	0
chr14:21033951:G:A	0	0	0	0	0	0	0	0
chr14:21034186:A:G	0	0	0	0	0	0	0	0
chr14:21034272:G:A	0	0	0	0	0	0	0	0
chr14:21057920:C:T	0	0	0	0	0	0	0	0
chr14:21328625:G:C	1	1	2	0	2	2	0	2
chr14:21360970:C:G	20	10	31	11	20	2.0	0.5	1.0
chr14:21362893:T:C	29	17	47	13	34	2	0	2
chr14:21403494:C:T	5	2	7	3	4	1	1	0
chr14:21431472:C:T	6	3	9	3	6	1.5	0.5	1.0
chr14:21523492:G:C	0	0	0	0	0	0	0	0
chr14:21570079:G:T	0	0	0	0	0	0	0	0
chr14:21570319:G:A	0	0	0	0	0	0	0	0
chr14:21570394:G:T	0	0	0	0	0	0	0	0
chr14:21570431:T:C	0	0	0	0	0	0	0	0
chr14:21634137:T:C	0	0	0	0	0	0	0	0
chr14:21634283:G:C	0	0	0	0	0	0	0	0
chr14:21634589:A:C	0	0	0	0	0	0	0	0
chr14:21665804:C:T	0	0	0	0	0	0	0	0
chr14:21670334:A:C	0	0	0	0	0	0	0	0
chr14:22603856:C:A	6	2	8	4	4	1.0	1.0	0.0
chr14:22633721:G:A	0	0	0	0	0	0	0	0
chr14:22633879:A:G	0	0	0	0	0	0	0	0
chr14:22633991:A:G	0	0	0	0	0	0	0	0
chr14:22634064:A:G	0	0	0	0	0	0	0	0
chr14:22634135:C:T	0	0	0	0	0	0	0	0
chr14:22634377:T:C	0	0	0	0	0	0	0	0
chr14:22634838:C:T	0	0	0	0	0	0	0	0
chr14:22812901:A:G	109	46	156	64	92	1	1	0
chr14:22813240:C:T	105	44	150	62	88	1	1	0
chr14:22829926:G:T	931	507	1674	549	1125	2	1	2
chr14:22843714:T:C	9	5	16	4	12	2	0	2
chr14:22884857:G:C	0	0	0	0	0	0	0	0
chr14:22901846:G:C	34	10	46	26	20	1.0	1.0	0.0
chr14:22905226:G:A	45	30	75	15	60	2	0	2
chr14:22974753:T:C	1	0	1	1	0	1	1	0
chr14:22989947:G:A	0	0	0	0	0	0	0	0
chr14:22998455:G:A	15	6	22	10	12	1	1	0
chr14:23049709:T:C	0	0	0	0	0	0	0	0
chr14:23061413:T:C	101	44	151	59	92	1	1	0
chr14:23062549:G:A	3	0	3	3	0	1	1	0
chr14:23063368:C:T	0	0	0	0	0	0	0	0
chr14:23064549:G:A	2	2	4	0	4	2.0	0.0	2.0
chr14:23080110:A:G	23	12	35	11	24	2	0	2
chr14:23080576:T:C	83	40	124	44	80	1	1	0
chr14:23100865:T:C	0	0	0	0	0	0	0	0
chr14:23101213:G:A	0	0	0	0	0	0	0	0
chr14:23182795:G:A	0	0	0	0	0	0	0	0
chr14:23276324:C:T	7	4	11	3	8	2	0	2
chr14:23323207:A:C	17	6	23	11	12	1	1	0
chr14:23359684:G:A	0	0	0	0	0	0	0	0
chr14:23359955:G:A	0	0	0	0	0	0	0	0
chr14:23379102:C:T	0	0	0	0	0	0	0	0
chr14:23386360:A:G	0	0	0	0	0	0	0	0
chr14:23400784:G:A	0	0	0	0	0	0	0	0
chr14:23953881:A:G	336	162	517	183	334	1.0	1.0	0.0
chr14:23988953:G:C	18	17	35	1	34	2.0	0.0	2.0
chr14:24001009:C:T	0	0	0	0	0	0	0	0
chr14:24065707:G:T	0	0	0	0	0	0	0	0
chr14:24076157:T:C	1	0	1	1	0	1	1	0
chr14:24076166:C:T	1	1	2	0	2	2	0	2
chr14:24163272:G:T	33	15	48	18	30	1	1	0
chr14:24178608:T:C	58	13	73	47	26	1.0	1.0	0.0
chr14:24178696:C:T	7	1	8	6	2	1	1	0
chr14:24178751:C:T	7	1	8	6	2	1	1	0
chr14:24180463:C:T	14	8	22	6	16	2.0	0.0	2.0
chr14:24188201:T:G	1	0	1	1	0	1	1	0
chr14:24210671:C:T	413	200	651	245	406	2	1	0
chr14:24249309:G:A	1	0	1	1	0	1	1	0
chr14:24290803:G:A	102	48	151	55	96	1.0	1.0	0.0
chr14:24291049:C:T	1	0	1	1	0	1	1	0
chr14:24292484:C:T	69	38	111	31	80	2	0	2
chr14:24303759:C:A	3	3	6	0	6	2	0	2
chr14:24322592:G:A	0	0	0	0	0	0	0	0
chr14:24330081:A:T	0	0	0	0	0	0	0	0
chr14:24330372:C:G	0	0	0	0	0	0	0	0
chr14:24332750:G:C	6	3	9	3	6	1.5	0.5	1.0
chr14:24369959:C:T	0	0	0	0	0	0	0	0
chr14:24375979:C:T	0	0	0	0	0	0	0	0
chr14:24377755:G:T	0	0	0	0	0	0	0	0
chr14:24407955:A:G	0	0	0	0	0	0	0	0
chr14:24416400:A:G	0	0	0	0	0	0	0	0
chr14:24432070:G:T	10	3	13	7	6	1.0	1.0	0.0
chr14:24432227:C:T	8	3	11	5	6	1.0	1.0	0.0
chr14:24440849:C:T	280	154	455	137	318	2.0	0.0	2.0
chr14:24442802:T:C	0	0	0	0	0	0	0	0
chr14:24505415:G:A	0	0	0	0	0	0	0	0
chr14:26448076:A:G	0	0	0	0	0	0	0	0
chr14:28265097:A:C	0	0	0	0	0	0	0	0
chr14:30885890:C:G	91	38	163	69	94	1	1	0
chr14:32545663:C:T	15	6	22	10	12	1	1	0
chr14:32545808:G:A	17	8	26	10	16	2	1	0
chr14:32545876:A:G	17	8	26	10	16	2	1	0
chr14:32823816:A:G	9	5	15	5	10	2	1	2
chr14:32824325:T:A	19	11	31	9	22	2	0	2
chr14:34758674:G:T	1	0	1	1	0	1	1	0
chr14:34999687:T:A	108	48	157	61	96	1.0	1.0	0.0
chr14:35046714:C:G	213	108	338	110	228	2	1	2
chr14:35266761:A:G	140	78	223	65	158	2.0	0.0	2.0
chr14:35278611:T:C	2	2	4	0	4	2.0	0.0	2.0
chr14:35402754:G:A	129	65	202	68	134	2	1	2
chr14:35403101:C:T	86	48	141	41	100	2.0	0.0	2.0
chr14:35403720:G:A	1281	745	2822	924	1898	2	1	2
chr14:35683971:T:C	7	3	10	4	6	1	1	0
chr14:35721824:A:G	8	4	12	4	8	1.5	0.5	1.0
chr14:36371490:A:G	0	0	0	0	0	0	0	0
chr14:36662856:A:G	1	1	2	0	2	2	0	2
chr14:36666547:C:T	4	4	8	0	8	2.0	0.0	2.0
chr14:36666548:G:C	4	0	8	8	0	2.0	2.0	0.0
chr14:37592342:G:C	0	0	0	0	0	0	0	0
chr14:37592537:C:T	0	0	0	0	0	0	0	0
chr14:37749138:A:G	0	0	0	0	0	0	0	0
chr14:39114277:A:G	0	0	0	0	0	0	0	0
chr14:39181620:C:T	374	187	593	207	386	2.0	1.0	0.5
chr14:39181720:A:G	372	184	589	208	381	2.0	1.0	0.0
chr14:39215409:T:C	0	0	0	0	0	0	0	0
chr14:39216335:A:G	0	0	0	0	0	0	0	0
chr14:39234120:A:G	0	0	0	0	0	0	0	0
chr14:39246997:A:G	0	0	0	0	0	0	0	0
chr14:39348824:A:G	56	27	83	29	54	1.0	1.0	0.0
chr14:41891430:T:C	0	0	0	0	0	0	0	0
chr14:44506307:C:T	0	0	0	0	0	0	0	0
chr14:44506308:G:A	0	0	0	0	0	0	0	0
chr14:44960986:A:T	45	20	65	25	40	1	1	0
chr14:44963667:G:C	109	55	165	55	110	2	1	2
chr14:44963952:C:G	109	54	164	56	108	1	1	0
chr14:45046635:A:G	5	3	8	2	6	2	0	2
chr14:45137084:C:T	28	11	39	17	22	1.0	1.0	0.0
chr14:45196265:C:G	1	1	2	0	2	2	0	2
chr14:45242391:T:C	82	33	115	49	66	1.0	1.0	0.0
chr14:50283859:A:G	0	0	0	0	0	0	0	0
chr14:50302999:G:A	11	8	19	3	16	2	0	2
chr14:50312098:A:C	52	28	80	24	56	2.0	0.0	2.0
chr14:50321495:C:T	281	129	433	163	270	1	1	0
chr14:50332408:G:C	11	8	19	3	16	2	0	2
chr14:50587880:A:G	25	15	41	11	30	2	0	2
chr14:50738278:C:T	21	9	30	12	18	1	1	0
chr14:50757699:G:C	5	2	7	3	4	1	1	0
chr14:50757940:T:A	4	3	7	1	6	2.0	0.0	2.0
chr14:50758414:G:T	4	3	7	1	6	2.0	0.0	2.0
chr14:50770983:A:G	16	10	26	6	20	2.0	0.0	2.0
chr14:50904066:G:C	0	0	0	0	0	0	0	0
chr14:50904403:C:T	0	0	0	0	0	0	0	0
chr14:50916714:G:A	0	0	0	0	0	0	0	0
chr14:51715363:T:A	0	0	0	0	0	0	0	0
chr14:51720254:A:G	0	0	0	0	0	0	0	0
chr14:52068040:C:G	0	0	0	0	0	0	0	0
chr14:53950804:A:G	0	0	0	0	0	0	0	0
chr14:55138318:A:C	133	80	246	66	180	2	0	2
chr14:55151806:C:G	0	0	0	0	0	0	0	0
chr14:55351557:A:G	17	11	28	6	22	2	0	2
chr14:55351799:T:A	16	9	25	7	18	2.0	0.0	2.0
chr14:55351988:T:C	17	10	27	7	20	2	0	2
chr14:55440454:C:G	0	0	0	0	0	0	0	0
chr14:58096976:G:C	0	0	0	0	0	0	0	0
chr14:58139072:G:A	0	0	0	0	0	0	0	0
chr14:58301615:C:T	175	86	270	94	176	1	1	0
chr14:58364424:A:G	38	19	57	19	38	1.5	0.5	1.0
chr14:58488812:T:C	8	4	12	4	8	1.5	0.5	1.0
chr14:58645757:C:T	2	1	3	1	2	1.5	0.5	1.0
chr14:58646014:C:T	2	1	3	1	2	1.5	0.5	1.0
chr14:58646712:G:A	2	1	3	1	2	1.5	0.5	1.0
chr14:59323009:G:A	50	29	81	23	58	2.0	0.0	2.0
chr14:59323174:G:T	50	23	75	29	46	1.0	1.0	0.0
chr14:60149324:C:T	14	10	24	4	20	2.0	0.0	2.0
chr14:60397865:G:T	0	0	0	0	0	0	0	0
chr14:60437039:G:A	0	0	0	0	0	0	0	0
chr14:60509819:C:A	0	0	0	0	0	0	0	0
chr14:61996496:C:T	0	0	0	0	0	0	0	0
chr14:64098864:T:C	0	0	0	0	0	0	0	0
chr14:64190137:T:C	5	4	9	1	8	2	0	2
chr14:64209380:A:G	6	3	9	3	6	1.5	0.5	1.0
chr14:64214475:C:T	9	4	13	5	8	1	1	0
chr14:64219407:G:T	54	25	80	30	50	1.0	1.0	0.0
chr14:64233098:C:T	2	1	3	1	2	1.5	0.5	1.0
chr14:64415662:A:G	38	20	58	18	40	2.0	0.0	2.0
chr14:64442127:G:A	27	13	40	14	26	1	1	0
chr14:64522206:T:C	130	68	199	63	136	2.0	0.0	2.0
chr14:64552767:T:C	0	0	0	0	0	0	0	0
chr14:64749402:C:T	0	0	0	0	0	0	0	0
chr14:64774510:A:G	0	0	0	0	0	0	0	0
chr14:64775326:C:T	0	0	0	0	0	0	0	0
chr14:64793509:T:G	0	0	0	0	0	0	0	0
chr14:64796582:C:T	0	0	0	0	0	0	0	0
chr14:64796629:C:T	0	0	0	0	0	0	0	0
chr14:64805062:G:A	0	0	0	0	0	0	0	0
chr14:65084098:T:A	52	28	84	26	58	2.0	0.0	2.0
chr14:67569162:A:G	0	0	0	0	0	0	0	0
chr14:67572062:T:G	0	0	0	0	0	0	0	0
chr14:67575857:A:G	0	0	0	0	0	0	0	0
chr14:67579885:C:T	0	0	0	0	0	0	0	0
chr14:67587085:T:C	0	0	0	0	0	0	0	0
chr14:67600232:G:A	296	146	452	154	298	1.0	1.0	0.0
chr14:67646576:G:A	2	1	3	1	2	1.5	0.5	1.0
chr14:67690125:A:G	1	0	1	1	0	1	1	0
chr14:67692909:G:A	19	7	26	12	14	1	1	0
chr14:67727014:G:A	1	1	2	0	2	2	0	2
chr14:67769805:G:A	13	7	20	6	14	2	0	2
chr14:68610971:G:A	4	1	5	3	2	1.0	1.0	0.0
chr14:68610982:T:A	4	1	5	3	2	1.0	1.0	0.0
chr14:68792945:C:A	566	251	911	373	538	2.0	1.0	0.0
chr14:68880915:C:T	0	0	0	0	0	0	0	0
chr14:69952164:G:A	2	2	4	0	4	2.0	0.0	2.0
chr14:70167829:C:T	0	0	0	0	0	0	0	0
chr14:70457790:A:C	1	1	2	0	2	2	0	2
chr14:70458135:A:C	1	0	1	1	0	1	1	0
chr14:70642436:C:G	16	12	29	5	24	2.0	0.0	2.0
chr14:70734489:G:A	1	1	2	0	2	2	0	2
chr14:72836266:A:G	0	0	0	0	0	0	0	0
chr14:72892472:A:G	0	0	0	0	0	0	0	0
chr14:72937972:A:C	75	35	110	40	70	1	1	0
chr14:72942975:C:G	20	13	33	7	26	2.0	0.0	2.0
chr14:72958754:G:A	26	15	41	11	30	2.0	0.0	2.0
chr14:72974156:C:T	4	4	8	0	8	2.0	0.0	2.0
chr14:72993209:C:T	12	7	20	6	14	2.0	0.0	2.0
chr14:73244686:A:G	3	2	5	1	4	2	0	2
chr14:73244805:G:A	3	2	5	1	4	2	0	2
chr14:73245595:T:G	4	3	7	1	6	2.0	0.0	2.0
chr14:73249925:T:C	0	0	0	0	0	0	0	0
chr14:73250066:G:A	0	0	0	0	0	0	0	0
chr14:73261218:G:C	0	0	0	0	0	0	0	0
chr14:73268658:C:T	0	0	0	0	0	0	0	0
chr14:73492108:T:C	27	12	39	15	24	1	1	0
chr14:73502906:G:A	2	2	4	0	4	2.0	0.0	2.0
chr14:73593804:CTCTAGCTTAT:ATCTTCAAAGT	17	4	21	13	8	1	1	0
chr14:73617142:C:T	0	0	0	0	0	0	0	0
chr14:73739778:T:C	14	8	23	7	16	2.0	0.5	2.0
chr14:73879216:G:T	32	19	51	13	38	2.0	0.0	2.0
chr14:74064782:T:G	1	1	2	0	2	2	0	2
chr14:74071182:T:G	1	1	2	0	2	2	0	2
chr14:74071605:T:C	2	1	3	1	2	1.5	0.5	1.0
chr14:74084823:C:A	2	1	3	1	2	1.5	0.5	1.0
chr14:74245180:C:T	0	0	0	0	0	0	0	0
chr14:74289836:A:G	1	1	2	0	2	2	0	2
chr14:74292303:C:T	38	18	56	20	36	1.0	1.0	0.0
chr14:74292598:G:T	39	19	58	20	38	1	1	0
chr14:74292774:C:T	41	20	61	21	40	1	1	0
chr14:74299649:A:G	80	50	130	30	100	2.0	0.0	2.0
chr14:74889399:TT:TC	33	0	33	33	0	1	1	0
chr14:74892967:G:A	40	16	56	24	32	1.0	1.0	0.0
chr14:74911482:G:A	1	1	2	0	2	2	0	2
chr14:74919873:G:A	1	1	2	0	2	2	0	2
chr14:74921480:C:T	1	1	2	0	2	2	0	2
chr14:75070678:C:T	3	3	6	0	6	2	0	2
chr14:75134960:G:A	537	279	873	294	579	2	1	2
chr14:75437957:A:G	19	7	26	12	14	1	1	0
chr14:75579348:C:T	1	1	2	0	2	2	0	2
chr14:75690266:C:T	14	7	22	8	14	2.0	0.5	1.0
chr14:75963212:C:T	0	0	0	0	0	0	0	0
chr14:76059210:A:G	11	6	17	5	12	2	0	2
chr14:76076661:G:A	4	0	4	4	0	1.0	1.0	0.0
chr14:76439633:A:C	0	0	0	0	0	0	0	0
chr14:76499808:G:A	0	0	0	0	0	0	0	0
chr14:76806649:C:G	8	3	11	5	6	1.0	1.0	0.0
chr14:77139415:G:A	0	0	0	0	0	0	0	0
chr14:77236714:A:G	0	0	0	0	0	0	0	0
chr14:77242461:C:T	0	0	0	0	0	0	0	0
chr14:77256842:C:T	0	0	0	0	0	0	0	0
chr14:77277301:G:A	7	2	9	5	4	1	1	0
chr14:77278850:A:C	5	1	6	4	2	1	1	0
chr14:77285582:C:T	4	3	7	1	6	2.0	0.0	2.0
chr14:77299682:GGA:AGG	0	0	0	0	0	0	0	0
chr14:77301039:A:G	0	0	0	0	0	0	0	0
chr14:77326864:G:A	195	103	312	98	214	2	0	2
chr14:77327940:T:C	164	88	266	82	184	2.0	0.0	2.0
chr14:77329295:G:A	0	0	0	0	0	0	0	0
chr14:77377471:T:C	0	0	0	0	0	0	0	0
chr14:77377628:C:T	0	0	0	0	0	0	0	0
chr14:77377922:G:A	0	0	0	0	0	0	0	0
chr14:77378249:T:A	0	0	0	0	0	0	0	0
chr14:77378526:A:G	0	0	0	0	0	0	0	0
chr14:77378778:A:G	0	0	0	0	0	0	0	0
chr14:77413962:C:T	0	0	0	0	0	0	0	0
chr14:77459668:C:T	285	150	443	143	300	2	0	2
chr14:77469177:G:A	287	152	450	144	306	2	0	2
chr14:77475973:G:A	0	0	0	0	0	0	0	0
chr14:77484242:A:G	0	0	0	0	0	0	0	0
chr14:77484781:C:T	0	0	0	0	0	0	0	0
chr14:77498751:G:A	0	0	0	0	0	0	0	0
chr14:77521615:C:A	8	5	13	3	10	2.0	0.0	2.0
chr14:77673986:G:A	7	5	12	2	10	2	0	2
chr14:77730940:T:C	11	3	14	8	6	1	1	0
chr14:80792910:A:T	1	0	1	1	0	1	1	0
chr14:80955913:G:C	0	0	0	0	0	0	0	0
chr14:81270732:A:C	3	0	3	3	0	1	1	0
chr14:81278392:A:G	0	0	0	0	0	0	0	0
chr14:85622971:G:A	0	0	0	0	0	0	0	0
chr14:88550511:G:T	0	0	0	0	0	0	0	0
chr14:90263727:C:T	184	100	286	86	200	2.0	0.0	2.0
chr14:90263921:G:A	84	42	129	43	86	2.0	0.5	1.0
chr14:90278328:G:A	3	2	5	1	4	2	0	2
chr14:90301263:C:T	0	0	0	0	0	0	0	0
chr14:90617994:C:T	1	0	1	1	0	1	1	0
chr14:91278005:G:T	7	4	10	3	7	1	0	1
chr14:91307224:T:C	11	3	14	8	6	1	1	0
chr14:91458683:G:T	82	42	130	40	90	2.0	0.0	2.0
chr14:91481699:T:C	85	38	124	48	76	1	1	0
chr14:91636415:A:G	0	0	0	0	0	0	0	0
chr14:91974722:C:T	15	6	21	9	12	1	1	0
chr14:92070879:G:T	40	16	58	24	34	1.0	1.0	0.0
chr14:92082441:C:T	101	49	155	52	103	1	1	0
chr14:92093664:G:A	35	18	54	18	36	2	0	2
chr14:92442729:T:C	0	0	0	0	0	0	0	0
chr14:92454027:C:T	0	0	0	0	0	0	0	0
chr14:92456556:G:A	0	0	0	0	0	0	0	0
chr14:92651693:A:G	59	29	90	30	60	1	1	0
chr14:92652323:C:T	76	34	112	44	68	1.0	1.0	0.0
chr14:92704648:C:T	13	13	26	0	26	2	0	2
chr14:92716121:G:A	3	3	6	0	6	2	0	2
chr14:92932504:G:A	0	0	0	0	0	0	0	0
chr14:92938329:T:C	0	0	0	0	0	0	0	0
chr14:92946398:G:A	16	9	25	7	18	2.0	0.0	2.0
chr14:93183156:A:G	127	63	195	69	126	2	1	0
chr14:93348147:A:G	3	1	4	2	2	1	1	0
chr14:93540729:C:T	0	0	0	0	0	0	0	0
chr14:93622241:G:A	0	0	0	0	0	0	0	0
chr14:93637256:G:A	0	0	0	0	0	0	0	0
chr14:93721486:C:T	0	0	0	0	0	0	0	0
chr14:93947473:C:T	0	0	0	0	0	0	0	0
chr14:94004867:G:A	0	0	0	0	0	0	0	0
chr14:94008836:A:G	0	0	0	0	0	0	0	0
chr14:94096919:C:T	31	18	49	13	36	2	0	2
chr14:94128431:T:G	8	1	9	7	2	1.0	1.0	0.0
chr14:94129457:G:A	15	9	24	6	18	2	0	2
chr14:94306092:G:A	0	0	0	0	0	0	0	0
chr14:94463204:G:A	0	0	0	0	0	0	0	0
chr14:94464643:A:G	0	0	0	0	0	0	0	0
chr14:94464679:T:G	0	0	0	0	0	0	0	0
chr14:94464768:A:G	0	0	0	0	0	0	0	0
chr14:94467372:C:T	0	0	0	0	0	0	0	0
chr14:94469770:G:A	0	0	0	0	0	0	0	0
chr14:94469773:G:A	0	0	0	0	0	0	0	0
chr14:94469848:C:T	0	0	0	0	0	0	0	0
chr14:94476326:C:A	0	0	0	0	0	0	0	0
chr14:94561683:C:T	0	0	0	0	0	0	0	0
chr14:94563515:G:T	0	0	0	0	0	0	0	0
chr14:94587512:T:C	0	0	0	0	0	0	0	0
chr14:94587526:C:T	0	0	0	0	0	0	0	0
chr14:94587675:A:G	0	0	0	0	0	0	0	0
chr14:94592125:A:C	0	0	0	0	0	0	0	0
chr14:94592294:A:T	0	0	0	0	0	0	0	0
chr14:94622510:G:A	0	0	0	0	0	0	0	0
chr14:94622557:G:T	0	0	0	0	0	0	0	0
chr14:95439984:G:A	9	5	14	4	10	2	0	2
chr14:95452229:C:T	1	1	2	0	2	2	0	2
chr14:95452288:T:C	51	27	79	25	54	2	0	2
chr14:95455404:C:T	52	27	80	26	54	2.0	0.0	2.0
chr14:95457333:A:C	50	27	77	23	54	2.0	0.0	2.0
chr14:95690850:G:A	6	4	10	2	8	2.0	0.0	2.0
chr14:96456415:C:G	0	0	0	0	0	0	0	0
chr14:96833516:A:G	177	92	274	87	187	2	0	2
chr14:98716222:G:A	0	0	0	0	0	0	0	0
chr14:99176023:C:G	0	0	0	0	0	0	0	0
chr14:99410168:A:G	10	4	14	6	8	1.0	1.0	0.0
chr14:99495493:T:C	30	18	50	12	38	2.0	0.0	2.0
chr14:99706562:A:G	0	0	0	0	0	0	0	0
chr14:99850935:C:T	0	0	0	0	0	0	0	0
chr14:99914611:T:C	0	0	0	0	0	0	0	0
chr14:100146756:C:T	166	68	240	102	138	1.0	1.0	0.0
chr14:100149328:T:C	121	57	183	67	116	1	1	0
chr14:100149624:C:T	118	55	178	66	112	1.0	1.0	0.0
chr14:100292709:C:A	63	18	81	45	36	1	1	0
chr14:100292940:C:T	60	17	77	43	34	1.0	1.0	0.0
chr14:100734523:G:A	0	0	0	0	0	0	0	0
chr14:100734936:G:T	0	0	0	0	0	0	0	0
chr14:100882247:C:G	0	0	0	0	0	0	0	0
chr14:100882680:A:G	0	0	0	0	0	0	0	0
chr14:100883961:T:C	0	0	0	0	0	0	0	0
chr14:101818942:A:C	37	16	53	21	32	1	1	0
chr14:101925240:G:C	3	0	3	3	0	1	1	0
chr14:102041719:C:A	17	8	27	9	18	1	1	0
chr14:102044091:A:G	4	1	5	3	2	1.0	1.0	0.0
chr14:102044537:G:A	6	3	9	3	6	1.5	0.5	1.0
chr14:102047890:T:C	37	19	60	18	42	2	0	2
chr14:102049376:G:A	1	0	1	1	0	1	1	0
chr14:102348705:C:T	256	132	409	138	271	2.0	1.0	2.0
chr14:102434864:A:G	2	1	3	1	2	1.5	0.5	1.0
chr14:103086061:G:A	0	0	0	0	0	0	0	0
chr14:103089765:T:G	0	0	0	0	0	0	0	0
chr14:103100567:G:A	0	0	0	0	0	0	0	0
chr14:103110058:G:A	0	0	0	0	0	0	0	0
chr14:103110106:TC:CG	0	0	0	0	0	0	0	0
chr14:103685063:C:T	15	6	21	9	12	1	1	0
chr14:103701208:G:A	119	50	179	75	104	1	1	0
chr14:103726762:C:G	0	0	0	0	0	0	0	0
chr14:103727941:C:T	1	1	2	0	2	2	0	2
chr14:103729273:T:C	5	3	8	2	6	2	0	2
chr14:103733019:C:T	60	32	94	28	66	2.0	0.0	2.0
chr14:103941451:A:G	0	0	0	0	0	0	0	0
chr14:104714228:T:C	6	5	11	1	10	2.0	0.0	2.0
chr14:104714448:C:T	6	1	7	5	2	1.0	1.0	0.0
chr14:104729893:A:C	0	0	0	0	0	0	0	0
chr14:104729898:G:A	0	0	0	0	0	0	0	0
chr14:104730028:T:C	0	0	0	0	0	0	0	0
chr14:104747006:A:G	1	0	1	1	0	1	1	0
chr14:104755700:C:T	773	415	1263	394	869	2	0	2
chr14:104772267:C:T	6	4	10	2	8	2.0	0.0	2.0
chr14:104773557:C:T	17	10	27	7	20	2	0	2
chr14:104775891:T:C	1	0	1	1	0	1	1	0
chr14:104776629:T:C	1	0	1	1	0	1	1	0
chr14:104801597:G:A	1	1	2	0	2	2	0	2
chr14:104801767:G:A	1	1	2	0	2	2	0	2
chr14:104877956:C:T	0	0	0	0	0	0	0	0
chr14:104883051:A:C	0	0	0	0	0	0	0	0
chr14:104927219:G:C	3	2	5	1	4	2	0	2
chr14:104930933:C:A	4	2	6	2	4	1.5	0.5	1.0
chr14:104938047:T:C	0	0	0	0	0	0	0	0
chr14:104939605:G:A	0	0	0	0	0	0	0	0
chr14:104939901:A:C	0	0	0	0	0	0	0	0
chr14:104940035:C:T	0	0	0	0	0	0	0	0
chr14:104940694:A:G	0	0	0	0	0	0	0	0
chr14:104941461:T:C	0	0	0	0	0	0	0	0
chr14:104941693:A:G	0	0	0	0	0	0	0	0
chr14:104941845:T:G	0	0	0	0	0	0	0	0
chr14:104941978:T:C	0	0	0	0	0	0	0	0
chr14:104942474:A:G	0	0	0	0	0	0	0	0
chr14:104942490:A:C	0	0	0	0	0	0	0	0
chr14:104942618:A:G	0	0	0	0	0	0	0	0
chr14:104943570:T:C	0	0	0	0	0	0	0	0
chr14:104943622:G:T	0	0	0	0	0	0	0	0
chr14:104943846:T:C	0	0	0	0	0	0	0	0
chr14:104944074:C:T	0	0	0	0	0	0	0	0
chr14:104944438:A:G	0	0	0	0	0	0	0	0
chr14:104944816:G:A	0	0	0	0	0	0	0	0
chr14:104945363:A:G	0	0	0	0	0	0	0	0
chr14:104945444:G:A	0	0	0	0	0	0	0	0
chr14:104946217:T:G	0	0	0	0	0	0	0	0
chr14:104946224:C:T	0	0	0	0	0	0	0	0
chr14:104946867:G:T	0	0	0	0	0	0	0	0
chr14:104946886:A:G	0	0	0	0	0	0	0	0
chr14:104947453:G:A	0	0	0	0	0	0	0	0
chr14:104947901:C:A	0	0	0	0	0	0	0	0
chr14:104947915:C:T	0	0	0	0	0	0	0	0
chr14:104948292:G:A	0	0	0	0	0	0	0	0
chr14:104948453:A:G	0	0	0	0	0	0	0	0
chr14:104948473:C:G	0	0	0	0	0	0	0	0
chr14:104948863:G:C	0	0	0	0	0	0	0	0
chr14:104954590:A:G	0	0	0	0	0	0	0	0
chr14:104954713:T:G	0	0	0	0	0	0	0	0
chr14:104994713:C:T	1	0	1	1	0	1	1	0
chr14:105142998:A:G	0	0	0	0	0	0	0	0
chr14:105144945:A:G	0	0	0	0	0	0	0	0
chr14:105149311:C:T	0	0	0	0	0	0	0	0
chr14:105286338:C:T	9	3	12	6	6	1	1	0
chr14:105464069:G:A	7	3	10	4	6	1	1	0
chr14:105498765:G:A	32	19	52	14	38	2.0	0.0	2.0
chr15:22258809:T:C	0	0	0	0	0	0	0	0
chr15:22573063:A:G	4	2	6	2	4	1.5	0.5	1.0
chr15:22851830:G:A	236	126	371	116	255	2.0	0.0	2.0
chr15:22903836:C:T	3	2	5	1	4	2	0	2
chr15:22912200:C:G	11	2	13	9	4	1	1	0
chr15:22912368:T:C	9	2	11	7	4	1	1	0
chr15:22914917:G:A	2	0	2	2	0	1.0	1.0	0.0
chr15:22914964:T:C	2	0	2	2	0	1.0	1.0	0.0
chr15:23686360:G:A	0	0	0	0	0	0	0	0
chr15:24675968:C:A	0	0	0	0	0	0	0	0
chr15:24676321:T:C	0	0	0	0	0	0	0	0
chr15:24676624:G:C	0	0	0	0	0	0	0	0
chr15:24677083:C:G	0	0	0	0	0	0	0	0
chr15:24678136:G:A	0	0	0	0	0	0	0	0
chr15:24678243:C:T	0	0	0	0	0	0	0	0
chr15:24678652:A:C	0	0	0	0	0	0	0	0
chr15:24679365:C:G	0	0	0	0	0	0	0	0
chr15:24909287:T:C	0	0	0	0	0	0	0	0
chr15:25679947:C:G	0	0	0	0	0	0	0	0
chr15:25708295:C:T	0	0	0	0	0	0	0	0
chr15:25716911:G:A	0	0	0	0	0	0	0	0
chr15:27845027:C:T	0	0	0	0	0	0	0	0
chr15:27851392:A:G	0	0	0	0	0	0	0	0
chr15:27966775:G:A	0	0	0	0	0	0	0	0
chr15:27990627:C:T	0	0	0	0	0	0	0	0
chr15:28014907:G:A	0	0	0	0	0	0	0	0
chr15:28111713:C:T	9	1	10	8	2	1	1	0
chr15:28141480:C:T	2	0	2	2	0	1.0	1.0	0.0
chr15:28167726:G:A	1	1	2	0	2	2	0	2
chr15:28257133:A:G	2	1	3	1	2	1.5	0.5	1.0
chr15:29252452:T:C	0	0	0	0	0	0	0	0
chr15:30045174:G:C	0	0	0	0	0	0	0	0
chr15:31002499:G:T	0	0	0	0	0	0	0	0
chr15:31038077:A:G	0	0	0	0	0	0	0	0
chr15:31050541:C:T	0	0	0	0	0	0	0	0
chr15:31070149:C:T	0	0	0	0	0	0	0	0
chr15:33065061:A:G	0	0	0	0	0	0	0	0
chr15:33067373:C:A	0	0	0	0	0	0	0	0
chr15:33154057:G:A	0	0	0	0	0	0	0	0
chr15:33154110:G:C	0	0	0	0	0	0	0	0
chr15:33154678:G:T	0	0	0	0	0	0	0	0
chr15:33154746:A:C	0	0	0	0	0	0	0	0
chr15:33579976:C:T	0	0	0	0	0	0	0	0
chr15:34236747:G:A	34	15	50	20	30	1.0	1.0	0.0
chr15:34250671:C:G	17	13	30	4	26	2	0	2
chr15:34252267:C:T	29	19	48	10	38	2	0	2
chr15:34343168:A:G	19	7	28	12	16	1	1	0
chr15:34495079:T:G	0	0	0	0	0	0	0	0
chr15:35084559:T:C	0	0	0	0	0	0	0	0
chr15:35084921:C:A	0	0	0	0	0	0	0	0
chr15:35093092:T:C	0	0	0	0	0	0	0	0
chr15:37943320:T:A	0	0	0	0	0	0	0	0
chr15:38498684:T:C	5	3	8	2	6	2	0	2
chr15:39252311:C:T	0	0	0	0	0	0	0	0
chr15:39587516:G:A	0	0	0	0	0	0	0	0
chr15:39588157:C:T	0	0	0	0	0	0	0	0
chr15:39588621:A:G	0	0	0	0	0	0	0	0
chr15:39617851:C:G	1	0	1	1	0	1	1	0
chr15:40161106:A:G	4	2	6	2	4	1.5	0.5	1.0
chr15:40185630:G:A	1	1	2	0	2	2	0	2
chr15:40196650:G:A	0	0	0	0	0	0	0	0
chr15:40252319:G:C	0	0	0	0	0	0	0	0
chr15:40252330:C:G	0	0	0	0	0	0	0	0
chr15:40252416:G:A	0	0	0	0	0	0	0	0
chr15:40296801:A:G	7	2	9	5	4	1	1	0
chr15:40297623:G:A	1	1	2	0	2	2	0	2
chr15:40297629:G:A	1	0	1	1	0	1	1	0
chr15:40335644:G:A	0	0	0	0	0	0	0	0
chr15:40363672:G:C	0	0	0	0	0	0	0	0
chr15:40368314:G:A	0	0	0	0	0	0	0	0
chr15:40368365:G:A	0	0	0	0	0	0	0	0
chr15:40466138:A:C	1	1	2	0	2	2	0	2
chr15:40472350:G:A	28	16	44	12	32	2.0	0.0	2.0
chr15:40557209:C:T	63	29	92	34	58	1	1	0
chr15:40564790:C:T	101	62	166	40	126	2	0	2
chr15:40621642:G:T	14	6	20	8	12	1.0	1.0	0.0
chr15:40621979:T:C	5	2	7	3	4	1	1	0
chr15:40622847:T:G	3	1	4	2	2	1	1	0
chr15:40744250:G:A	0	0	0	0	0	0	0	0
chr15:40771046:C:T	3	1	4	2	2	1	1	0
chr15:40807513:C:G	21	11	32	10	22	2	0	2
chr15:40807621:C:T	13	8	21	5	16	2	0	2
chr15:40809351:G:C	0	0	0	0	0	0	0	0
chr15:40814287:A:C	37	20	57	17	40	2	0	2
chr15:40854682:T:C	106	58	169	51	118	2.0	0.0	2.0
chr15:40856001:C:T	110	53	166	60	106	1.0	1.0	0.0
chr15:40856963:G:C	112	55	170	60	110	1.0	1.0	0.0
chr15:40953478:G:A	1	0	1	1	0	1	1	0
chr15:40983960:G:A	1	0	1	1	0	1	1	0
chr15:41184011:T:C	0	0	0	0	0	0	0	0
chr15:41184267:G:A	0	0	0	0	0	0	0	0
chr15:41190033:T:C	0	0	0	0	0	0	0	0
chr15:41396534:C:T	93	53	148	43	105	2	0	2
chr15:41527169:T:C	3	0	3	3	0	1	1	0
chr15:41845623:G:A	1	1	2	0	2	2	0	2
chr15:41857398:C:G	1	0	1	1	0	1	1	0
chr15:41858690:G:A	1	0	1	1	0	1	1	0
chr15:41867092:C:T	0	0	0	0	0	0	0	0
chr15:41876202:C:T	0	0	0	0	0	0	0	0
chr15:41879264:C:T	0	0	0	0	0	0	0	0
chr15:41879339:A:G	0	0	0	0	0	0	0	0
chr15:41885957:T:C	1	1	2	0	2	2	0	2
chr15:41943118:C:T	161	76	239	87	152	1	1	0
chr15:41989521:G:A	0	0	0	0	0	0	0	0
chr15:42142056:G:A	0	0	0	0	0	0	0	0
chr15:42147246:C:T	0	0	0	0	0	0	0	0
chr15:42389001:G:A	2	2	4	0	4	2.0	0.0	2.0
chr15:42548488:A:T	66	39	105	27	78	2.0	0.0	2.0
chr15:43185915:G:C	129	55	186	76	110	1	1	0
chr15:43239213:G:C	0	0	0	0	0	0	0	0
chr15:43253530:G:A	0	0	0	0	0	0	0	0
chr15:43279192:C:G	0	0	0	0	0	0	0	0
chr15:43287368:A:G	0	0	0	0	0	0	0	0
chr15:43329749:A:G	6	2	8	4	4	1.0	1.0	0.0
chr15:43330067:C:A	6	2	8	4	4	1.0	1.0	0.0
chr15:43340351:T:C	14	6	20	8	12	1.0	1.0	0.0
chr15:43369604:T:C	5	3	8	2	6	2	0	2
chr15:43432448:T:G	9	6	15	3	12	2	0	2
chr15:43456106:A:G	5	2	8	4	4	2	1	0
chr15:43469998:C:T	6	3	9	3	6	1.5	0.5	1.0
chr15:43475576:G:C	5	2	7	3	4	1	1	0
chr15:43524719:G:A	0	0	0	0	0	0	0	0
chr15:43525208:T:C	0	0	0	0	0	0	0	0
chr15:43525854:G:A	0	0	0	0	0	0	0	0
chr15:43599314:C:T	0	0	0	0	0	0	0	0
chr15:43600874:G:A	0	0	0	0	0	0	0	0
chr15:43601535:C:T	2	2	4	0	4	2.0	0.0	2.0
chr15:43601620:G:A	2	0	2	2	0	1.0	1.0	0.0
chr15:43603444:GC:AT	0	0	0	0	0	0	0	0
chr15:43639905:G:C	13	4	18	10	8	1	1	0
chr15:43647444:C:T	4	1	5	3	2	1.0	1.0	0.0
chr15:43696406:G:A	0	0	0	0	0	0	0	0
chr15:43703591:C:T	1	0	1	1	0	1	1	0
chr15:43746701:C:T	1481	801	2734	952	1782	2	1	2
chr15:43776871:G:C	46	28	74	18	56	2.0	0.0	2.0
chr15:43797024:C:G	11	6	17	5	12	2	0	2
chr15:43799188:G:A	11	7	18	4	14	2	0	2
chr15:43801729:T:C	684	387	1181	355	826	2.0	0.0	2.0
chr15:43809812:A:C	69	39	109	31	78	2	0	2
chr15:43905851:A:G	0	0	0	0	0	0	0	0
chr15:44572696:C:T	33	16	49	17	32	1	1	0
chr15:44651599:TG:CA	88	45	135	43	92	2.0	0.0	2.0
chr15:44755204:A:G	16	10	26	6	20	2.0	0.0	2.0
chr15:44755375:C:T	16	6	22	10	12	1.0	1.0	0.0
chr15:44756453:C:T	18	12	30	6	24	2.0	0.0	2.0
chr15:45099877:G:A	0	0	0	0	0	0	0	0
chr15:45100816:G:C	0	0	0	0	0	0	0	0
chr15:45105691:C:T	0	0	0	0	0	0	0	0
chr15:45106171:C:T	0	0	0	0	0	0	0	0
chr15:45106240:T:C	0	0	0	0	0	0	0	0
chr15:45111868:G:A	0	0	0	0	0	0	0	0
chr15:45116735:T:C	0	0	0	0	0	0	0	0
chr15:45116815:G:A	0	0	0	0	0	0	0	0
chr15:45117073:C:T	0	0	0	0	0	0	0	0
chr15:45152320:A:G	4	2	6	2	4	1.5	0.5	1.0
chr15:45164908:G:T	4	3	7	1	6	2.0	0.0	2.0
chr15:45164929:C:T	4	3	7	1	6	2.0	0.0	2.0
chr15:45253280:C:T	5	4	9	1	8	2	0	2
chr15:45262069:C:A	0	0	0	0	0	0	0	0
chr15:45267719:C:T	0	0	0	0	0	0	0	0
chr15:45362129:A:G	14	3	17	11	6	1.0	1.0	0.0
chr15:45369480:T:A	14	3	17	11	6	1.0	1.0	0.0
chr15:45376857:C:A	0	0	0	0	0	0	0	0
chr15:45376896:G:A	0	0	0	0	0	0	0	0
chr15:45402318:G:T	0	0	0	0	0	0	0	0
chr15:45402381:C:T	4	3	7	1	6	2.0	0.0	2.0
chr15:45402412:C:T	17	9	26	8	18	2	0	2
chr15:45403497:G:A	22	12	35	11	24	2.0	0.5	2.0
chr15:49625144:G:A	126	70	201	59	142	2.0	0.0	2.0
chr15:50490506:A:G	27	15	42	12	30	2	0	2
chr15:50915621:G:C	4	2	6	2	4	1.5	0.5	1.0
chr15:50925164:T:C	12	7	19	5	14	2.0	0.0	2.0
chr15:51342058:T:G	2	0	2	2	0	1.0	1.0	0.0
chr15:51377428:A:C	0	0	0	0	0	0	0	0
chr15:51397575:G:A	0	0	0	0	0	0	0	0
chr15:51458649:G:A	1	0	1	1	0	1	1	0
chr15:51491623:T:C	0	0	0	0	0	0	0	0
chr15:51499362:A:G	0	0	0	0	0	0	0	0
chr15:52275654:G:A	5	4	9	1	8	2	0	2
chr15:52319254:A:G	8	5	13	3	10	2.0	0.0	2.0
chr15:52372211:G:A	17	9	30	8	22	2	0	2
chr15:52609236:C:T	65	26	93	41	52	1	1	0
chr15:52609441:T:C	63	25	89	39	50	1	1	0
chr15:52609780:G:A	51	20	72	32	40	1	1	0
chr15:52611575:T:C	55	34	61	21	40	1	0	1
chr15:53615751:G:A	0	0	0	0	0	0	0	0
chr15:53710894:G:A	0	0	0	0	0	0	0	0
chr15:54555479:C:T	0	0	0	0	0	0	0	0
chr15:55360833:A:G	134	72	206	62	144	2.0	0.0	2.0
chr15:56094944:G:A	4	3	7	1	6	2.0	0.0	2.0
chr15:57439375:C:T	0	0	0	0	0	0	0	0
chr15:57543705:T:G	0	0	0	0	0	0	0	0
chr15:57547590:A:T	0	0	0	0	0	0	0	0
chr15:57547633:A:G	0	0	0	0	0	0	0	0
chr15:57625871:A:G	0	0	0	0	0	0	0	0
chr15:57708783:C:T	97	52	149	45	104	2	0	2
chr15:58542542:G:T	0	0	0	0	0	0	0	0
chr15:58545839:C:G	0	0	0	0	0	0	0	0
chr15:58563834:T:C	0	0	0	0	0	0	0	0
chr15:59207747:T:G	0	0	0	0	0	0	0	0
chr15:59217990:G:A	51	31	82	20	62	2	0	2
chr15:59492294:C:T	2	1	3	1	2	1.5	0.5	1.0
chr15:59689448:A:G	40	24	66	16	50	2.0	0.0	2.0
chr15:60361006:C:A	515	268	849	295	554	2	1	2
chr15:60442498:A:G	43	27	70	16	54	2	0	2
chr15:61910283:C:T	16	5	21	11	10	1.0	1.0	0.0
chr15:62755579:C:T	0	0	0	0	0	0	0	0
chr15:62755594:C:T	0	0	0	0	0	0	0	0
chr15:62809954:C:T	0	0	0	0	0	0	0	0
chr15:63056897:G:A	0	0	0	0	0	0	0	0
chr15:63056933:T:A	0	0	0	0	0	0	0	0
chr15:63059641:C:A	20	8	28	12	16	1.0	1.0	0.0
chr15:63063982:G:A	1	1	2	0	2	2	0	2
chr15:63141567:G:A	55	25	82	30	52	1	1	0
chr15:63157344:A:C	557	286	948	334	614	2	1	2
chr15:63157481:C:G	483	269	794	237	557	2	0	2
chr15:63630553:T:A	11	6	17	5	12	2	0	2
chr15:63661830:C:T	7	2	9	5	4	1	1	0
chr15:63696158:C:G	37	16	53	21	32	1	1	0
chr15:64418628:T:C	71	36	109	36	73	2	1	1
chr15:64943580:A:G	0	0	0	0	0	0	0	0
chr15:64944678:C:T	0	0	0	0	0	0	0	0
chr15:64981061:T:C	5	2	7	3	4	1	1	0
chr15:65055067:G:A	0	0	0	0	0	0	0	0
chr15:65201874:A:G	0	0	0	0	0	0	0	0
chr15:65260908:C:T	25	13	40	12	28	2	0	2
chr15:65329103:C:A	0	0	0	0	0	0	0	0
chr15:65384279:T:C	0	0	0	0	0	0	0	0
chr15:65385803:A:T	0	0	0	0	0	0	0	0
chr15:65392195:A:G	0	0	0	0	0	0	0	0
chr15:65396929:T:C	0	0	0	0	0	0	0	0
chr15:65512554:G:A	77	36	113	41	72	1	1	0
chr15:65702395:C:T	56	26	83	31	52	1.0	1.0	0.0
chr15:66326004:A:G	17	6	23	11	12	1	1	0
chr15:66500423:A:G	20	9	29	11	18	1.0	1.0	0.0
chr15:67164997:A:G	0	0	0	0	0	0	0	0
chr15:67822161:G:A	0	0	0	0	0	0	0	0
chr15:67832327:C:A	0	0	0	0	0	0	0	0
chr15:68199690:G:A	1	1	2	0	2	2	0	2
chr15:68312831:G:A	0	0	0	0	0	0	0	0
chr15:68357249:G:A	0	0	0	0	0	0	0	0
chr15:68403010:G:A	0	0	0	0	0	0	0	0
chr15:68711574:G:A	0	0	0	0	0	0	0	0
chr15:68718780:C:T	0	0	0	0	0	0	0	0
chr15:68930573:C:T	0	0	0	0	0	0	0	0
chr15:68946106:G:A	0	0	0	0	0	0	0	0
chr15:69035886:C:T	0	0	0	0	0	0	0	0
chr15:69269179:G:A	2	0	2	2	0	1.0	1.0	0.0
chr15:70053287:C:T	32	20	54	12	42	2.0	0.0	2.0
chr15:70054584:C:T	22	16	40	6	34	2.0	0.0	2.0
chr15:70059449:T:C	15	12	26	3	23	2	0	2
chr15:70667729:G:A	0	0	0	0	0	0	0	0
chr15:70687551:G:A	2	0	2	2	0	1.0	1.0	0.0
chr15:70699586:G:C	2	2	4	0	4	2.0	0.0	2.0
chr15:71898732:T:C	5	2	7	3	4	1	1	0
chr15:72170009:G:T	0	0	0	0	0	0	0	0
chr15:72209800:G:A	863	476	1671	566	1105	2	1	2
chr15:72783368:G:A	187	92	291	99	192	1	1	0
chr15:73249172:A:G	0	0	0	0	0	0	0	0
chr15:73258909:A:G	0	0	0	0	0	0	0	0
chr15:73272540:C:T	0	0	0	0	0	0	0	0
chr15:73289103:A:G	0	0	0	0	0	0	0	0
chr15:74175455:C:T	0	0	0	0	0	0	0	0
chr15:74175515:G:A	0	0	0	0	0	0	0	0
chr15:74176153:C:T	0	0	0	0	0	0	0	0
chr15:74179953:A:G	0	0	0	0	0	0	0	0
chr15:74195505:G:A	0	0	0	0	0	0	0	0
chr15:74195628:A:T	0	0	0	0	0	0	0	0
chr15:74196083:G:A	0	0	0	0	0	0	0	0
chr15:74414874:G:A	5	2	7	3	4	1	1	0
chr15:74837752:T:C	62	1	66	64	2	1.0	1.0	0.0
chr15:74839618:A:G	105	48	158	62	96	1	1	0
chr15:74893329:A:G	1	0	1	1	0	1	1	0
chr15:74897589:A:G	48	31	79	17	62	2.0	0.0	2.0
chr15:75206403:G:C	3	2	5	1	4	2	0	2
chr15:75207654:T:G	1	0	1	1	0	1	1	0
chr15:75338221:C:T	26	10	36	16	20	1.0	1.0	0.0
chr15:75338294:A:T	26	10	36	16	20	1.0	1.0	0.0
chr15:75598348:G:T	74	38	112	36	76	2.0	0.0	2.0
chr15:75639788:G:T	469	221	740	282	458	2	1	0
chr15:75676994:C:T	0	0	0	0	0	0	0	0
chr15:75685579:A:G	0	0	0	0	0	0	0	0
chr15:75687771:A:G	0	0	0	0	0	0	0	0
chr15:75689886:T:G	0	0	0	0	0	0	0	0
chr15:75689898:G:A	0	0	0	0	0	0	0	0
chr15:75725111:C:T	2	1	3	1	2	1.5	0.5	1.0
chr15:75844427:C:T	82	45	127	37	90	2.0	0.0	2.0
chr15:76203891:G:A	0	0	0	0	0	0	0	0
chr15:76203999:C:T	0	0	0	0	0	0	0	0
chr15:76260201:GCTGT:ATCGC	0	0	0	0	0	0	0	0
chr15:76260219:T:G	0	0	0	0	0	0	0	0
chr15:76260239:ACTT:GCTC	0	0	0	0	0	0	0	0
chr15:76260253:T:C	0	0	0	0	0	0	0	0
chr15:76260275:A:G	0	0	0	0	0	0	0	0
chr15:76260284:T:C	0	0	0	0	0	0	0	0
chr15:76260302:AA:CC	0	0	0	0	0	0	0	0
chr15:76260319:C:G	0	0	0	0	0	0	0	0
chr15:76260449:T:G	0	0	0	0	0	0	0	0
chr15:76260460:T:C	0	0	0	0	0	0	0	0
chr15:76260514:C:T	0	0	0	0	0	0	0	0
chr15:76260522:A:G	0	0	0	0	0	0	0	0
chr15:76260541:C:T	0	0	0	0	0	0	0	0
chr15:76260587:T:C	0	0	0	0	0	0	0	0
chr15:76260617:A:G	0	0	0	0	0	0	0	0
chr15:76260633:A:G	0	0	0	0	0	0	0	0
chr15:76260661:C:G	0	0	0	0	0	0	0	0
chr15:76260709:T:C	0	0	0	0	0	0	0	0
chr15:76260783:A:G	0	0	0	0	0	0	0	0
chr15:76260798:A:G	0	0	0	0	0	0	0	0
chr15:76260812:A:G	0	0	0	0	0	0	0	0
chr15:76260829:C:T	0	0	0	0	0	0	0	0
chr15:76260877:A:G	0	0	0	0	0	0	0	0
chr15:76381375:T:C	7	5	12	2	10	2	0	2
chr15:76434124:G:T	4	1	5	3	2	1.0	1.0	0.0
chr15:76471173:C:A	32	20	52	12	40	2.0	0.0	2.0
chr15:77052451:T:A	230	130	379	110	269	2.0	0.0	2.0
chr15:77158622:C:T	0	0	0	0	0	0	0	0
chr15:77180529:G:A	5	2	7	3	4	1	1	0
chr15:77896689:C:T	0	0	0	0	0	0	0	0
chr15:77896733:G:A	0	0	0	0	0	0	0	0
chr15:77896864:C:T	0	0	0	0	0	0	0	0
chr15:77896926:A:T	0	0	0	0	0	0	0	0
chr15:77897170:A:G	0	0	0	0	0	0	0	0
chr15:77897197:T:A	0	0	0	0	0	0	0	0
chr15:77897298:A:G	0	0	0	0	0	0	0	0
chr15:77921418:C:T	0	0	0	0	0	0	0	0
chr15:77921426:C:A	0	0	0	0	0	0	0	0
chr15:77921733:T:C	0	0	0	0	0	0	0	0
chr15:77941501:C:T	0	0	0	0	0	0	0	0
chr15:77986887:ACTGC:GCTGG	0	0	0	0	0	0	0	0
chr15:77986944:C:T	0	0	0	0	0	0	0	0
chr15:77986972:G:A	0	0	0	0	0	0	0	0
chr15:78098072:T:C	0	0	0	0	0	0	0	0
chr15:78098567:C:T	0	0	0	0	0	0	0	0
chr15:78105804:G:A	9	5	14	4	10	2	0	2
chr15:78149427:T:C	117	62	181	59	122	2	1	2
chr15:78166143:T:C	2	1	3	1	2	1.5	0.5	1.0
chr15:78166455:C:T	4	1	5	3	2	1.0	1.0	0.0
chr15:78171548:G:T	1	1	2	0	2	2	0	2
chr15:78173785:T:C	3	2	5	1	4	2	0	2
chr15:78180967:G:A	0	0	0	0	0	0	0	0
chr15:78275511:G:T	0	0	0	0	0	0	0	0
chr15:78340488:C:G	0	0	0	0	0	0	0	0
chr15:78985144:C:T	57	35	95	23	72	2	0	2
chr15:78998007:C:T	3	1	4	2	2	1	1	0
chr15:78998258:C:T	5	1	6	4	2	1	1	0
chr15:79003830:G:A	117	52	174	66	108	1	1	0
chr15:79456261:C:T	0	0	0	0	0	0	0	0
chr15:79457105:G:T	0	0	0	0	0	0	0	0
chr15:79560136:C:A	0	0	0	0	0	0	0	0
chr15:79971003:A:C	103	59	180	54	126	2	0	2
chr15:79971064:C:T	103	59	184	54	130	2	0	2
chr15:80157986:T:C	0	0	0	0	0	0	0	0
chr15:80158047:G:A	0	0	0	0	0	0	0	0
chr15:80162403:T:C	0	0	0	0	0	0	0	0
chr15:80180184:C:T	0	0	0	0	0	0	0	0
chr15:80201771:C:T	0	0	0	0	0	0	0	0
chr15:80591684:G:A	0	0	0	0	0	0	0	0
chr15:80979216:C:A	172	89	262	84	178	2.0	0.0	2.0
chr15:81290527:G:A	0	0	0	0	0	0	0	0
chr15:82571543:A:C	0	0	0	0	0	0	0	0
chr15:82759440:C:T	0	0	0	0	0	0	0	0
chr15:82813128:A:G	81	32	115	51	64	1	1	0
chr15:83011577:G:A	518	267	836	286	550	2.0	1.0	2.0
chr15:83163946:T:G	1	0	1	1	0	1	1	0
chr15:83913137:G:A	0	0	0	0	0	0	0	0
chr15:83970598:C:T	0	0	0	0	0	0	0	0
chr15:83982433:C:A	0	0	0	0	0	0	0	0
chr15:84643606:T:C	19	12	31	7	24	2	0	2
chr15:84816870:T:C	0	0	0	0	0	0	0	0
chr15:84858028:C:T	0	0	0	0	0	0	0	0
chr15:84858188:T:C	0	0	0	0	0	0	0	0
chr15:84904200:G:A	0	0	0	0	0	0	0	0
chr15:84905644:C:A	0	0	0	0	0	0	0	0
chr15:84933210:G:A	0	0	0	0	0	0	0	0
chr15:84935498:G:A	0	0	0	0	0	0	0	0
chr15:85579423:T:C	13	9	22	4	18	2	0	2
chr15:85579685:T:C	9	7	16	2	14	2	0	2
chr15:85579788:C:T	9	7	16	2	14	2	0	2
chr15:85580231:T:C	7	5	12	2	10	2	0	2
chr15:85580602:T:C	7	5	12	2	10	2	0	2
chr15:85580693:C:T	7	5	12	2	10	2	0	2
chr15:85580757:G:A	7	5	12	2	10	2	0	2
chr15:85581252:C:G	7	6	13	1	12	2	0	2
chr15:85581324:G:A	7	6	13	1	12	2	0	2
chr15:85581800:G:A	11	8	19	3	16	2	0	2
chr15:85710537:T:A	5	2	7	3	4	1	1	0
chr15:85768362:C:A	1	0	1	1	0	1	1	0
chr15:85769063:C:T	1	0	1	1	0	1	1	0
chr15:88652014:C:T	8	6	14	2	12	2.0	0.0	2.0
chr15:88847929:C:A	0	0	0	0	0	0	0	0
chr15:88854874:C:T	0	0	0	0	0	0	0	0
chr15:88855099:G:A	0	0	0	0	0	0	0	0
chr15:88855176:C:T	0	0	0	0	0	0	0	0
chr15:88855374:G:T	0	0	0	0	0	0	0	0
chr15:88855400:T:A	0	0	0	0	0	0	0	0
chr15:88857108:A:C	0	0	0	0	0	0	0	0
chr15:88857878:A:G	0	0	0	0	0	0	0	0
chr15:88858384:T:G	0	0	0	0	0	0	0	0
chr15:88858820:A:G	0	0	0	0	0	0	0	0
chr15:88859008:T:C	0	0	0	0	0	0	0	0
chr15:88859365:T:G	0	0	0	0	0	0	0	0
chr15:88872016:C:G	0	0	0	0	0	0	0	0
chr15:88878018:G:A	0	0	0	0	0	0	0	0
chr15:88878096:A:G	0	0	0	0	0	0	0	0
chr15:88878174:G:A	0	0	0	0	0	0	0	0
chr15:88879055:C:T	0	0	0	0	0	0	0	0
chr15:88881350:A:G	1	0	1	1	0	1	1	0
chr15:88887275:C:T	1	0	1	1	0	1	1	0
chr15:88893064:G:A	1	0	1	1	0	1	1	0
chr15:88899375:C:T	0	0	0	0	0	0	0	0
chr15:88907315:C:T	0	0	0	0	0	0	0	0
chr15:89193327:T:C	20	12	32	8	24	2.0	0.0	2.0
chr15:89285210:C:T	0	0	0	0	0	0	0	0
chr15:89315371:T:C	2	2	4	0	4	2.0	0.0	2.0
chr15:89317555:A:C	13	10	23	3	20	2	0	2
chr15:89321842:T:C	23	11	34	12	22	1	1	0
chr15:89323723:A:G	0	0	0	0	0	0	0	0
chr15:89479606:C:T	0	0	0	0	0	0	0	0
chr15:89595439:C:T	0	0	0	0	0	0	0	0
chr15:89618124:G:A	0	0	0	0	0	0	0	0
chr15:89624877:C:T	0	0	0	0	0	0	0	0
chr15:89625462:T:A	0	0	0	0	0	0	0	0
chr15:89627006:C:T	0	0	0	0	0	0	0	0
chr15:89629603:T:G	0	0	0	0	0	0	0	0
chr15:89633201:T:G	0	0	0	0	0	0	0	0
chr15:89652736:C:G	1	0	1	1	0	1	1	0
chr15:89683716:C:A	10	2	12	8	4	1.0	1.0	0.0
chr15:89791009:A:G	17	11	30	6	24	2	0	2
chr15:89792303:G:A	17	11	30	6	24	2	0	2
chr15:89792557:C:T	17	11	30	6	24	2	0	2
chr15:89793142:T:C	0	0	0	0	0	0	0	0
chr15:89803630:C:T	0	0	0	0	0	0	0	0
chr15:89806327:C:T	0	0	0	0	0	0	0	0
chr15:90225727:A:C	65	33	98	32	66	2	0	2
chr15:90228518:T:G	67	33	102	34	68	1	1	0
chr15:90241018:T:C	10	5	15	5	10	1.5	0.5	1.0
chr15:90241698:C:A	9	4	13	5	8	1	1	0
chr15:90241828:C:T	8	4	12	4	8	1.5	0.5	1.0
chr15:90811291:G:A	8	2	10	6	4	1.0	1.0	0.0
chr15:90876959:G:A	1	1	2	0	2	2	0	2
chr15:90881344:G:C	3	1	4	2	2	1	1	0
chr15:90885060:C:T	16	10	26	6	20	2.0	0.0	2.0
chr15:90885359:T:G	2	1	3	1	2	1.5	0.5	1.0
chr15:90885406:G:A	2	1	3	1	2	1.5	0.5	1.0
chr15:90905361:C:A	0	0	0	0	0	0	0	0
chr15:90906005:G:A	0	0	0	0	0	0	0	0
chr15:92094963:G:A	0	0	0	0	0	0	0	0
chr15:92171901:A:T	0	0	0	0	0	0	0	0
chr15:92472048:T:C	0	0	0	0	0	0	0	0
chr15:92734199:C:G	0	0	0	0	0	0	0	0
chr15:93045034:G:C	0	0	0	0	0	0	0	0
chr15:93073704:C:G	0	0	0	0	0	0	0	0
chr15:93073746:A:G	0	0	0	0	0	0	0	0
chr15:94298462:G:A	225	95	333	141	192	1	1	0
chr15:94402653:C:T	17	2	19	15	4	1	1	0
chr15:97960870:G:C	0	0	0	0	0	0	0	0
chr15:97971259:A:G	0	0	0	0	0	0	0	0
chr15:98934996:G:A	0	0	0	0	0	0	0	0
chr15:99113595:T:C	0	0	0	0	0	0	0	0
chr15:99130784:T:C	0	0	0	0	0	0	0	0
chr15:99131555:T:C	0	0	0	0	0	0	0	0
chr15:99132517:A:G	0	0	0	0	0	0	0	0
chr15:99175147:A:G	3	0	3	3	0	1	1	0
chr15:99712600:G:T	28	19	48	10	38	2.0	0.0	2.0
chr15:100152640:A:G	0	0	0	0	0	0	0	0
chr15:100501691:T:C	0	0	0	0	0	0	0	0
chr15:100501838:C:T	0	0	0	0	0	0	0	0
chr15:100503827:G:A	0	0	0	0	0	0	0	0
chr15:100569472:C:A	11	6	17	5	12	2	0	2
chr15:100569589:C:G	9	5	14	4	10	2	0	2
chr15:100569613:G:A	9	5	14	4	10	2	0	2
chr15:100569688:C:A	9	5	14	4	10	2	0	2
chr15:100573745:A:G	29	16	45	13	32	2	0	2
chr15:100574213:G:A	29	16	45	13	32	2	0	2
chr15:100580758:T:C	33	20	53	13	40	2	0	2
chr15:101051718:A:G	0	0	0	0	0	0	0	0
chr15:101057995:G:A	2	2	6	0	6	3.0	0.0	3.0
chr15:101058109:C:T	2	2	6	0	6	3.0	0.0	3.0
chr15:101066684:GC:AA	10	6	16	4	12	2.0	0.0	2.0
chr15:101177475:G:T	3	1	4	2	2	1	1	0
chr15:101177892:C:G	2	0	2	2	0	1.0	1.0	0.0
chr15:101178495:G:A	1	1	2	0	2	2	0	2
chr15:101307410:C:T	0	0	0	0	0	0	0	0
chr15:101382118:A:G	0	0	0	0	0	0	0	0
chr15:101651831:A:G	82	35	115	47	68	1.0	1.0	0.0
chr15:101652215:C:T	84	48	132	37	95	2.0	0.0	2.0
chr15:101652337:T:G	272	138	423	141	282	2.0	1.0	2.0
chr15:101714943:G:A	50	29	83	23	60	2.0	0.0	2.0
chr16:61249:C:T	2	1	3	1	2	1.5	0.5	1.0
chr16:83208:G:A	1001	496	1714	631	1083	2	1	0
chr16:231300:G:A	0	0	0	0	0	0	0	0
chr16:269512:A:G	0	0	0	0	0	0	0	0
chr16:284543:C:G	0	0	0	0	0	0	0	0
chr16:284580:G:C	0	0	0	0	0	0	0	0
chr16:284732:C:T	0	0	0	0	0	0	0	0
chr16:286660:G:A	1	0	1	1	0	1	1	0
chr16:286916:C:T	1	1	2	0	2	2	0	2
chr16:297184:A:G	8	4	12	4	8	1.5	0.5	1.0
chr16:298222:C:T	8	4	12	4	8	1.5	0.5	1.0
chr16:399574:C:T	0	0	0	0	0	0	0	0
chr16:552595:G:C	0	0	0	0	0	0	0	0
chr16:625985:G:A	10	8	18	2	16	2.0	0.0	2.0
chr16:631279:C:T	0	0	0	0	0	0	0	0
chr16:657113:G:A	0	0	0	0	0	0	0	0
chr16:672331:C:T	159	66	229	95	134	1	1	0
chr16:672548:A:G	158	64	226	96	130	1.0	1.0	0.0
chr16:893107:A:G	0	0	0	0	0	0	0	0
chr16:893130:C:G	0	0	0	0	0	0	0	0
chr16:1079010:C:A	0	0	0	0	0	0	0	0
chr16:1079501:C:T	0	0	0	0	0	0	0	0
chr16:1210481:T:C	0	0	0	0	0	0	0	0
chr16:1211377:G:A	0	0	0	0	0	0	0	0
chr16:1218494:C:T	0	0	0	0	0	0	0	0
chr16:1219029:T:C	0	0	0	0	0	0	0	0
chr16:1220162:G:A	0	0	0	0	0	0	0	0
chr16:1220349:T:C	0	0	0	0	0	0	0	0
chr16:1221890:G:T	0	0	0	0	0	0	0	0
chr16:1222038:G:A	0	0	0	0	0	0	0	0
chr16:1222684:C:G	0	0	0	0	0	0	0	0
chr16:1222865:G:A	0	0	0	0	0	0	0	0
chr16:1223490:C:T	0	0	0	0	0	0	0	0
chr16:1223562:C:T	0	0	0	0	0	0	0	0
chr16:1256345:CG:GC	0	0	0	0	0	0	0	0
chr16:1314364:A:G	1181	634	2042	715	1327	2	1	2
chr16:1324817:A:G	1084	578	1902	642	1260	2.0	1.0	2.0
chr16:1338617:G:A	2	1	3	1	2	1.5	0.5	1.0
chr16:1344506:A:C	0	0	0	0	0	0	0	0
chr16:1366354:C:T	38	20	58	18	40	2.0	0.0	2.0
chr16:1369946:A:G	26	16	45	11	34	2.0	0.0	2.0
chr16:1397277:A:G	74	34	108	40	68	1.0	1.0	0.0
chr16:1434391:G:C	11	2	14	10	4	1	1	0
chr16:1434454:T:C	13	10	25	3	22	2	0	2
chr16:1436461:C:T	10	8	18	2	16	2.0	0.0	2.0
chr16:1437974:A:G	0	0	0	0	0	0	0	0
chr16:1438014:A:G	0	0	0	0	0	0	0	0
chr16:1438038:C:T	0	0	0	0	0	0	0	0
chr16:1438140:C:T	7	4	11	3	8	2	0	2
chr16:1438223:T:C	0	0	0	0	0	0	0	0
chr16:1438645:A:G	6	4	10	2	8	2.0	0.0	2.0
chr16:1438696:G:A	5	2	7	3	4	1	1	0
chr16:1486371:G:A	0	0	0	0	0	0	0	0
chr16:1486534:C:T	0	0	0	0	0	0	0	0
chr16:1487838:G:A	0	0	0	0	0	0	0	0
chr16:1488362:C:A	0	0	0	0	0	0	0	0
chr16:1488432:A:G	0	0	0	0	0	0	0	0
chr16:1488463:C:T	0	0	0	0	0	0	0	0
chr16:1494300:GA:CG	41	24	65	17	48	2	0	2
chr16:1495447:A:G	39	16	56	24	32	1	1	0
chr16:1524029:G:C	0	0	0	0	0	0	0	0
chr16:1666009:A:C	0	0	0	0	0	0	0	0
chr16:1809431:G:C	14	1	15	13	2	1.0	1.0	0.0
chr16:1809849:A:G	1	0	1	1	0	1	1	0
chr16:1819948:G:A	236	125	367	115	252	2.0	0.0	2.0
chr16:1911673:G:C	0	0	0	0	0	0	0	0
chr16:1911730:G:A	0	0	0	0	0	0	0	0
chr16:1911841:C:T	0	0	0	0	0	0	0	0
chr16:1911851:C:T	0	0	0	0	0	0	0	0
chr16:1912131:G:A	0	0	0	0	0	0	0	0
chr16:1944742:G:A	0	0	0	0	0	0	0	0
chr16:1944748:A:C	0	0	0	0	0	0	0	0
chr16:1944775:C:A	0	0	0	0	0	0	0	0
chr16:1947063:G:A	0	0	0	0	0	0	0	0
chr16:1985761:T:C	19	10	29	9	20	2	0	2
chr16:1985783:C:T	19	10	29	9	20	2	0	2
chr16:1986047:T:C	136	72	209	66	143	2.0	0.0	2.0
chr16:1998795:C:T	14	6	20	8	12	1.0	1.0	0.0
chr16:1998825:C:G	14	6	20	8	12	1.0	1.0	0.0
chr16:1999848:T:C	9	5	14	4	10	2	0	2
chr16:2000191:G:T	6	2	8	4	4	1.0	1.0	0.0
chr16:2102618:C:T	1	0	1	1	0	1	1	0
chr16:2107078:T:C	0	0	0	0	0	0	0	0
chr16:2110493:C:T	0	0	0	0	0	0	0	0
chr16:2210934:G:A	0	0	0	0	0	0	0	0
chr16:2251519:G:C	219	117	347	107	240	2	0	2
chr16:2462522:G:A	4	1	5	3	2	1.0	1.0	0.0
chr16:2771572:C:T	59	24	84	36	48	1	1	0
chr16:2771762:C:G	58	37	96	22	74	2.0	0.0	2.0
chr16:2799406:C:T	0	0	0	0	0	0	0	0
chr16:2821120:T:C	0	0	0	0	0	0	0	0
chr16:2821554:G:A	0	0	0	0	0	0	0	0
chr16:2830613:T:C	0	0	0	0	0	0	0	0
chr16:2830869:G:C	0	0	0	0	0	0	0	0
chr16:2832196:G:T	0	0	0	0	0	0	0	0
chr16:3015923:G:A	0	0	0	0	0	0	0	0
chr16:3067936:G:A	0	0	0	0	0	0	0	0
chr16:3089309:G:C	1	1	2	0	2	2	0	2
chr16:3092462:A:G	0	0	0	0	0	0	0	0
chr16:3092910:C:G	0	0	0	0	0	0	0	0
chr16:3115424:A:G	3	0	3	3	0	1	1	0
chr16:3120187:C:T	0	0	0	0	0	0	0	0
chr16:3141355:G:A	3	0	3	3	0	1	1	0
chr16:3254463:C:T	0	0	0	0	0	0	0	0
chr16:3317229:T:C	16	7	22	9	13	1.0	1.0	0.0
chr16:3440922:G:C	4	0	4	4	0	1.0	1.0	0.0
chr16:3533173:C:T	4	2	6	2	4	1.5	0.5	1.0
chr16:3563125:C:T	2	0	2	2	0	1.0	1.0	0.0
chr16:3563149:A:G	2	0	2	2	0	1.0	1.0	0.0
chr16:3563416:G:A	2	0	2	2	0	1.0	1.0	0.0
chr16:3589138:A:G	0	0	0	0	0	0	0	0
chr16:3606481:C:T	8	5	13	3	10	2.0	0.0	2.0
chr16:3674464:G:C	112	72	184	41	143	2.0	0.0	2.0
chr16:4192092:C:T	0	0	0	0	0	0	0	0
chr16:4260467:C:G	40	19	61	21	40	1.0	1.0	0.0
chr16:4381201:A:G	0	0	0	0	0	0	0	0
chr16:4382028:A:C	0	0	0	0	0	0	0	0
chr16:4395326:C:T	59	36	96	24	72	2	0	2
chr16:4426088:T:C	153	84	240	70	170	2	0	2
chr16:4434395:A:T	144	79	224	66	158	2.0	0.0	2.0
chr16:4446972:T:A	40	24	64	16	48	2.0	0.0	2.0
chr16:4469547:A:G	17	8	25	9	16	1	1	0
chr16:4575273:A:G	0	0	0	0	0	0	0	0
chr16:4575937:A:T	0	0	0	0	0	0	0	0
chr16:4683252:C:T	14	7	21	7	14	1.5	0.5	1.0
chr16:4701044:C:T	11	7	18	4	14	2	0	2
chr16:4702133:A:G	12	7	19	5	14	2.0	0.0	2.0
chr16:4737986:G:A	0	0	0	0	0	0	0	0
chr16:4740272:G:A	0	0	0	0	0	0	0	0
chr16:4744872:C:T	1	1	2	0	2	2	0	2
chr16:4746392:A:G	0	0	0	0	0	0	0	0
chr16:4747456:C:T	0	0	0	0	0	0	0	0
chr16:4751722:G:A	7	4	11	3	8	2	0	2
chr16:4752369:C:A	8	3	11	5	6	1.0	1.0	0.0
chr16:4752385:G:T	8	3	11	5	6	1.0	1.0	0.0
chr16:4783420:A:G	0	0	0	0	0	0	0	0
chr16:4783969:C:T	0	0	0	0	0	0	0	0
chr16:4787544:A:G	0	0	0	0	0	0	0	0
chr16:4796067:T:C	1	0	1	1	0	1	1	0
chr16:4796335:G:A	1	0	1	1	0	1	1	0
chr16:4805278:A:G	24	9	33	15	18	1.0	1.0	0.0
chr16:4858955:C:T	12	3	15	9	6	1.0	1.0	0.0
chr16:4874315:G:A	3	1	4	2	2	1	1	0
chr16:4880099:C:T	4	1	5	3	2	1.0	1.0	0.0
chr16:4883322:A:T	0	0	0	0	0	0	0	0
chr16:4883938:G:C	0	0	0	0	0	0	0	0
chr16:4884548:G:A	0	0	0	0	0	0	0	0
chr16:4884563:C:G	0	0	0	0	0	0	0	0
chr16:4885145:C:T	0	0	0	0	0	0	0	0
chr16:4892098:C:T	3	3	6	0	6	2	0	2
chr16:4897747:T:C	0	0	0	0	0	0	0	0
chr16:5011084:A:C	0	0	0	0	0	0	0	0
chr16:5011112:G:A	0	0	0	0	0	0	0	0
chr16:5025541:G:A	117	75	197	43	154	2	0	2
chr16:5025632:G:A	112	41	157	73	84	1.0	1.0	0.0
chr16:5028214:G:C	0	0	0	0	0	0	0	0
chr16:5028219:C:T	0	0	0	0	0	0	0	0
chr16:5028856:C:T	1	0	1	1	0	1	1	0
chr16:5044569:G:A	0	0	0	0	0	0	0	0
chr16:5047946:A:G	0	0	0	0	0	0	0	0
chr16:5073269:C:T	1	0	1	1	0	1	1	0
chr16:5078000:C:T	43	24	70	19	51	2	0	2
chr16:5084773:T:A	55	31	90	24	66	2	0	2
chr16:5084909:G:A	54	30	88	24	64	2.0	0.0	2.0
chr16:5089185:G:C	41	18	59	23	36	1	1	0
chr16:5089216:C:G	41	18	59	23	36	1	1	0
chr16:8774919:C:A	10	2	12	8	4	1.0	1.0	0.0
chr16:8855117:T:C	114	64	182	52	130	2.0	0.0	2.0
chr16:8859224:C:G	167	99	271	71	200	2	0	2
chr16:8898485:G:A	1	0	1	1	0	1	1	0
chr16:8902070:G:A	9	4	13	5	8	1	1	0
chr16:9798443:G:A	0	0	0	0	0	0	0	0
chr16:10481967:C:A	11	6	17	5	12	2	0	2
chr16:10761882:G:A	3	1	4	2	2	1	1	0
chr16:10768057:T:C	10	6	16	4	12	2.0	0.0	2.0
chr16:10769107:A:G	145	75	229	77	152	2	0	2
chr16:10775281:G:C	2	0	2	2	0	1.0	1.0	0.0
chr16:10901993:G:T	5	2	7	3	4	1	1	0
chr16:11003098:A:G	38	25	63	13	50	2.0	0.0	2.0
chr16:11060913:G:A	1	1	2	0	2	2	0	2
chr16:11268038:C:G	0	0	0	0	0	0	0	0
chr16:11268872:G:A	0	0	0	0	0	0	0	0
chr16:11679806:C:G	67	30	98	38	60	1	1	0
chr16:11875867:G:C	52	30	85	23	62	2.0	0.0	2.0
chr16:11887630:G:A	60	29	92	32	60	1.0	1.0	0.0
chr16:12069112:A:G	173	83	263	94	169	1	1	0
chr16:12568563:C:T	2	1	3	1	2	1.5	0.5	1.0
chr16:12803721:G:T	58	36	97	25	72	2.0	0.0	2.0
chr16:12908502:T:C	0	0	0	0	0	0	0	0
chr16:13948101:T:C	1	1	2	0	2	2	0	2
chr16:13948251:G:A	2	2	4	0	4	2.0	0.0	2.0
chr16:14247189:A:G	0	0	0	0	0	0	0	0
chr16:14248909:T:G	2	1	3	1	2	1.5	0.5	1.0
chr16:14875159:T:A	11	0	11	11	0	1	1	0
chr16:15691192:C:T	241	111	358	137	221	1	1	0
chr16:15750042:G:A	0	0	0	0	0	0	0	0
chr16:15775944:T:C	0	0	0	0	0	0	0	0
chr16:15823340:G:A	0	0	0	0	0	0	0	0
chr16:17108944:G:A	0	0	0	0	0	0	0	0
chr16:17134511:G:A	144	44	194	106	88	1.0	1.0	0.0
chr16:17198217:G:C	14	9	23	5	18	2.0	0.0	2.0
chr16:17932879:G:A	0	0	0	0	0	0	0	0
chr16:18347924:G:A	0	0	0	0	0	0	0	0
chr16:18798689:T:A	28	13	41	15	26	1.0	1.0	0.0
chr16:18828040:T:C	3	1	4	2	2	1	1	0
chr16:18838536:C:T	2	2	4	0	4	2.0	0.0	2.0
chr16:18896107:G:T	103	49	153	55	98	1	1	0
chr16:19067715:G:A	56	33	90	24	66	2.0	0.0	2.0
chr16:19071881:T:A	0	0	0	0	0	0	0	0
chr16:19073976:C:T	16	5	21	11	10	1.0	1.0	0.0
chr16:19183586:C:T	60	42	102	18	84	2.0	0.0	2.0
chr16:19183808:C:T	64	46	110	18	92	2.0	0.0	2.0
chr16:19498011:C:T	1	1	2	0	2	2	0	2
chr16:19536794:G:A	14	5	19	9	10	1.0	1.0	0.0
chr16:19536968:G:A	14	5	19	9	10	1.0	1.0	0.0
chr16:19569377:A:G	4	2	6	2	4	1.5	0.5	1.0
chr16:19669224:T:C	21	10	31	11	20	1	1	0
chr16:20032008:T:C	0	0	0	0	0	0	0	0
chr16:20324003:G:A	0	0	0	0	0	0	0	0
chr16:20429731:C:G	0	0	0	0	0	0	0	0
chr16:20429762:T:C	0	0	0	0	0	0	0	0
chr16:20437198:T:C	0	0	0	0	0	0	0	0
chr16:20437205:T:C	0	0	0	0	0	0	0	0
chr16:20460128:G:A	0	0	0	0	0	0	0	0
chr16:20465530:T:C	0	0	0	0	0	0	0	0
chr16:20475803:T:G	0	0	0	0	0	0	0	0
chr16:20477374:A:G	0	0	0	0	0	0	0	0
chr16:20480982:ATGG:TTGA	0	0	0	0	0	0	0	0
chr16:20480994:C:T	0	0	0	0	0	0	0	0
chr16:20738811:G:A	39	21	59	18	41	2	0	2
chr16:20738815:C:T	39	18	57	21	36	1	1	0
chr16:20798745:T:C	1	1	2	0	2	2	0	2
chr16:20862445:T:G	0	0	0	0	0	0	0	0
chr16:20997368:T:C	0	0	0	0	0	0	0	0
chr16:21983090:G:A	666	346	1074	366	708	2.0	1.0	2.0
chr16:22132997:C:T	0	0	0	0	0	0	0	0
chr16:22915190:A:G	0	0	0	0	0	0	0	0
chr16:23087101:A:G	0	0	0	0	0	0	0	0
chr16:23189440:T:C	0	0	0	0	0	0	0	0
chr16:23189527:T:C	0	0	0	0	0	0	0	0
chr16:23189602:C:T	0	0	0	0	0	0	0	0
chr16:23348878:T:C	0	0	0	0	0	0	0	0
chr16:23388890:G:C	36	15	52	22	30	1.0	1.0	0.0
chr16:23710074:A:G	0	0	0	0	0	0	0	0
chr16:24154809:T:C	109	58	166	52	114	1	0	1
chr16:24191137:C:T	186	92	289	103	186	2.0	1.0	0.0
chr16:24191294:A:G	23	12	36	12	24	2	0	2
chr16:24572085:A:G	59	28	89	31	58	1	1	0
chr16:24777324:T:A	5	2	7	3	4	1	1	0
chr16:24790416:G:A	10	5	15	5	10	1.5	0.5	1.0
chr16:24790658:C:T	11	5	16	6	10	1	1	0
chr16:24791004:C:T	8	3	11	5	6	1.0	1.0	0.0
chr16:24791329:T:C	6	2	8	4	4	1.0	1.0	0.0
chr16:24805171:A:G	0	0	0	0	0	0	0	0
chr16:24823847:G:A	18	10	28	8	20	2.0	0.0	2.0
chr16:24877325:T:C	0	0	0	0	0	0	0	0
chr16:24906727:C:T	0	0	0	0	0	0	0	0
chr16:25228484:G:C	0	0	0	0	0	0	0	0
chr16:25228551:G:C	0	0	0	0	0	0	0	0
chr16:25244185:C:T	0	0	0	0	0	0	0	0
chr16:25246714:A:G	6	4	10	2	8	2.0	0.0	2.0
chr16:25251957:G:A	4	4	8	0	8	2.0	0.0	2.0
chr16:25257047:A:G	21	15	34	6	28	2	0	2
chr16:28591670:A:G	84	46	134	42	92	2.0	0.0	2.0
chr16:28592014:T:C	0	0	0	0	0	0	0	0
chr16:28592021:A:G	0	0	0	0	0	0	0	0
chr16:28592334:T:G	0	0	0	0	0	0	0	0
chr16:28595639:T:A	1	1	2	0	2	2	0	2
chr16:28900625:G:A	36	18	56	18	38	1.5	0.5	1.0
chr16:28933075:C:G	596	307	967	333	634	2.0	1.0	2.0
chr16:28938730:G:A	674	345	1115	385	730	2.0	1.0	2.0
chr16:28981728:A:C	4	3	7	1	6	2.0	0.0	2.0
chr16:28986676:G:A	4	0	4	4	0	1.0	1.0	0.0
chr16:30499250:C:T	1	0	1	1	0	1	1	0
chr16:30505171:A:G	6	5	11	1	10	2.0	0.0	2.0
chr16:30655046:C:T	115	50	166	66	100	1	1	0
chr16:30739119:C:T	11	6	18	6	12	2	1	2
chr16:30761273:G:A	4	2	8	2	6	1.5	0.5	1.0
chr16:30761667:C:T	5	3	7	2	5	1	0	1
chr16:30985473:CC:CT	1	0	1	1	0	1	1	0
chr16:30987877:C:T	1	1	2	0	2	2	0	2
chr16:30988048:C:T	1	1	2	0	2	2	0	2
chr16:31080754:G:A	4	2	6	2	4	1.5	0.5	1.0
chr16:31130950:A:G	36	13	49	23	26	1.0	1.0	0.0
chr16:31182621:C:A	1927	1067	3842	1323	2519	2	1	2
chr16:31219142:C:T	0	0	0	0	0	0	0	0
chr16:31278075:T:C	9	3	12	6	6	1	1	0
chr16:31355997:T:C	287	150	452	148	304	2	0	2
chr16:31360353:G:A	44	14	60	32	28	1.0	1.0	0.0
chr16:31403683:C:T	0	0	0	0	0	0	0	0
chr16:31459219:T:C	20	8	28	12	16	1.0	1.0	0.0
chr16:31464664:G:A	17	7	24	10	14	1	1	0
chr16:31465137:C:T	5	3	8	2	6	2	0	2
chr16:31477595:C:G	0	0	0	0	0	0	0	0
chr16:31569209:A:C	0	0	0	0	0	0	0	0
chr16:34266896:G:A	0	0	0	0	0	0	0	0
chr16:47663707:A:G	45	16	61	29	32	1	1	0
chr16:48224287:C:T	0	0	0	0	0	0	0	0
chr16:48551460:G:A	7	4	11	3	8	2	0	2
chr16:49636479:A:G	0	0	0	0	0	0	0	0
chr16:49638609:A:G	0	0	0	0	0	0	0	0
chr16:50025589:C:T	48	32	80	16	64	2.0	0.0	2.0
chr16:50308747:C:T	22	12	36	10	26	2.0	0.0	2.0
chr16:50314498:A:T	4	1	5	3	2	1.0	1.0	0.0
chr16:50334752:G:A	33	18	51	15	36	2	0	2
chr16:50608290:G:C	0	0	0	0	0	0	0	0
chr16:50675812:G:A	132	62	202	74	128	1.0	1.0	0.0
chr16:50699948:C:G	26	14	40	12	28	2.0	0.0	2.0
chr16:50710713:C:T	6	4	10	2	8	2.0	0.0	2.0
chr16:50711288:C:T	6	4	10	2	8	2.0	0.0	2.0
chr16:50711672:T:G	7	2	9	5	4	1	1	0
chr16:51138766:G:A	0	0	0	0	0	0	0	0
chr16:51139648:G:A	0	0	0	0	0	0	0	0
chr16:53307836:T:G	7	4	13	3	10	2	0	2
chr16:53370291:C:A	0	0	0	0	0	0	0	0
chr16:53370991:T:A	0	0	0	0	0	0	0	0
chr16:53470022:G:A	72	26	99	47	52	1.0	1.0	0.0
chr16:53470809:T:C	93	36	132	60	72	1	1	0
chr16:53479143:T:C	8	4	12	4	8	1.5	0.5	1.0
chr16:53492639:C:T	0	0	0	0	0	0	0	0
chr16:53826018:C:G	47	28	77	19	58	2	0	2
chr16:55481783:A:T	0	0	0	0	0	0	0	0
chr16:55502815:C:T	0	0	0	0	0	0	0	0
chr16:55528554:G:A	0	0	0	0	0	0	0	0
chr16:55567476:A:G	0	0	0	0	0	0	0	0
chr16:55849706:T:C	0	0	0	0	0	0	0	0
chr16:56328813:T:C	7	7	14	0	14	2	0	2
chr16:56609431:G:C	164	109	301	67	234	2.0	0.0	2.0
chr16:56626773:A:G	0	0	0	0	0	0	0	0
chr16:56626904:G:A	2	0	2	2	0	1.0	1.0	0.0
chr16:56626929:C:T	2	0	2	2	0	1.0	1.0	0.0
chr16:56657981:G:T	177	89	270	92	178	2	1	2
chr16:56805527:C:T	63	28	91	35	56	1	1	0
chr16:56887057:C:T	4	2	6	2	4	1.5	0.5	1.0
chr16:56894607:C:T	4	3	7	1	6	2.0	0.0	2.0
chr16:56932159:T:G	928	486	1665	566	1099	2.0	1.0	2.0
chr16:56935236:G:A	923	487	1653	558	1095	2	1	2
chr16:56982180:G:A	5	4	9	1	8	2	0	2
chr16:56983407:G:A	6	5	11	1	10	2.0	0.0	2.0
chr16:56983750:G:A	6	1	7	5	2	1.0	1.0	0.0
chr16:57025515:C:T	10	6	16	4	12	2.0	0.0	2.0
chr16:57358821:A:C	0	0	0	0	0	0	0	0
chr16:57456809:G:A	1	1	2	0	2	2	0	2
chr16:57469301:C:T	20	9	29	11	18	1.0	1.0	0.0
chr16:57469861:G:A	15	8	23	7	16	2	0	2
chr16:57655473:C:G	0	0	0	0	0	0	0	0
chr16:57655893:A:C	0	0	0	0	0	0	0	0
chr16:57663620:T:G	0	0	0	0	0	0	0	0
chr16:57701988:G:C	0	0	0	0	0	0	0	0
chr16:57707700:G:C	0	0	0	0	0	0	0	0
chr16:57722731:C:T	0	0	0	0	0	0	0	0
chr16:57728489:T:C	0	0	0	0	0	0	0	0
chr16:57737214:G:T	25	13	38	12	26	2	0	2
chr16:57752605:C:T	0	0	0	0	0	0	0	0
chr16:57752799:C:T	15	6	21	9	12	1	1	0
chr16:57753072:T:G	0	0	0	0	0	0	0	0
chr16:57757008:T:C	27	16	43	11	32	2	0	2
chr16:57761482:G:A	1	0	1	1	0	1	1	0
chr16:57771264:A:G	1	0	1	1	0	1	1	0
chr16:57816237:C:G	0	0	0	0	0	0	0	0
chr16:57884131:T:C	0	0	0	0	0	0	0	0
chr16:57903952:G:C	0	0	0	0	0	0	0	0
chr16:57916153:G:A	0	0	0	0	0	0	0	0
chr16:57963028:G:A	0	0	0	0	0	0	0	0
chr16:57985492:G:A	6	6	12	0	12	2.0	0.0	2.0
chr16:57996497:T:C	0	0	0	0	0	0	0	0
chr16:57996730:C:T	0	0	0	0	0	0	0	0
chr16:58011565:G:A	2	0	2	2	0	1.0	1.0	0.0
chr16:58017274:C:T	2	0	2	2	0	1.0	1.0	0.0
chr16:58045261:G:A	0	0	0	0	0	0	0	0
chr16:58115178:C:T	7	4	11	3	8	2	0	2
chr16:58115193:T:C	7	4	11	3	8	2	0	2
chr16:58129192:G:A	69	38	109	34	75	2	0	2
chr16:58503993:G:A	3	3	6	0	6	2	0	2
chr16:58508997:G:A	3	3	6	0	6	2	0	2
chr16:58516580:G:A	24	14	38	10	28	2.0	0.0	2.0
chr16:58518324:G:A	2	0	2	2	0	1.0	1.0	0.0
chr16:58532400:G:A	2	1	3	1	2	1.5	0.5	1.0
chr16:58539997:G:A	10	6	16	4	12	2.0	0.0	2.0
chr16:58541585:G:A	8	2	11	7	4	1.0	1.0	0.0
chr16:58545370:C:T	5	2	7	3	4	1	1	0
chr16:58672063:A:G	0	0	0	0	0	0	0	0
chr16:58679894:G:A	8	4	12	4	8	1.5	0.5	1.0
chr16:64982005:C:G	0	0	0	0	0	0	0	0
chr16:65004771:G:A	0	0	0	0	0	0	0	0
chr16:66379292:G:A	0	0	0	0	0	0	0	0
chr16:66386982:C:T	0	0	0	0	0	0	0	0
chr16:66398520:T:C	0	0	0	0	0	0	0	0
chr16:66403228:A:T	0	0	0	0	0	0	0	0
chr16:66469802:C:A	0	0	0	0	0	0	0	0
chr16:66565807:G:A	14	12	26	2	24	2.0	0.0	2.0
chr16:66751493:C:T	66	30	97	37	60	1.0	1.0	0.0
chr16:66778894:C:T	0	0	0	0	0	0	0	0
chr16:66828063:G:A	25	8	33	17	16	1	1	0
chr16:67201769:C:T	18	4	22	14	8	1.0	1.0	0.0
chr16:67237745:G:A	4	3	7	1	6	2.0	0.0	2.0
chr16:67287017:C:T	0	0	0	0	0	0	0	0
chr16:67934804:C:T	1159	617	2074	697	1377	2	1	2
chr16:68310793:C:T	117	50	169	71	98	1	1	0
chr16:68353470:C:T	5	4	9	1	8	2	0	2
chr16:68355869:C:T	28	13	43	15	28	1.0	1.0	0.0
chr16:68357286:C:G	1	0	1	1	0	1	1	0
chr16:68361191:G:A	0	0	0	0	0	0	0	0
chr16:68363627:T:G	0	0	0	0	0	0	0	0
chr16:68365021:C:T	0	0	0	0	0	0	0	0
chr16:68564104:A:G	6	4	10	2	8	2.0	0.0	2.0
chr16:68679827:G:A	0	0	0	0	0	0	0	0
chr16:68679920:C:A	1	1	2	0	2	2	0	2
chr16:68687567:T:C	0	0	0	0	0	0	0	0
chr16:68687630:G:C	0	0	0	0	0	0	0	0
chr16:68691880:G:A	0	0	0	0	0	0	0	0
chr16:68695882:C:A	0	0	0	0	0	0	0	0
chr16:68698146:A:C	0	0	0	0	0	0	0	0
chr16:69167028:A:T	11	6	17	5	12	2	0	2
chr16:69321060:A:G	177	79	265	101	164	1	1	0
chr16:69322792:A:G	10	3	13	7	6	1.0	1.0	0.0
chr16:69339511:T:C	22	9	31	13	18	1.0	1.0	0.0
chr16:69341755:G:A	196	108	312	94	218	2.0	0.0	2.0
chr16:69929452:G:A	3	1	4	2	2	1	1	0
chr16:69931689:A:G	2	2	4	0	4	2.0	0.0	2.0
chr16:69933994:T:C	5	2	7	3	4	1	1	0
chr16:69936426:A:G	5	1	6	4	2	1	1	0
chr16:69939394:C:T	4	0	4	4	0	1.0	1.0	0.0
chr16:69939922:G:A	4	0	4	4	0	1.0	1.0	0.0
chr16:69954470:T:C	2	1	3	1	2	1.5	0.5	1.0
chr16:69996021:T:C	13	5	18	8	10	1	1	0
chr16:70253274:A:G	33	18	55	17	38	2	0	2
chr16:70381664:C:T	10	6	16	4	12	2.0	0.0	2.0
chr16:70473004:T:C	8	3	11	5	6	1.0	1.0	0.0
chr16:70478332:G:A	14	7	21	7	14	1.5	0.5	1.0
chr16:70481452:C:T	103	53	156	50	106	2	0	2
chr16:70512331:G:A	97	41	142	60	82	1	1	0
chr16:70535312:A:T	29	15	44	14	30	2	0	2
chr16:70657086:G:C	0	0	0	0	0	0	0	0
chr16:70692892:C:A	25	9	34	16	18	1	1	0
chr16:70938692:T:C	0	0	0	0	0	0	0	0
chr16:70981426:G:T	0	0	0	0	0	0	0	0
chr16:71284098:G:T	9	6	15	3	12	2	0	2
chr16:71285636:C:T	9	0	9	9	0	1	1	0
chr16:71576373:G:A	1	1	2	0	2	2	0	2
chr16:71626407:G:A	12	10	24	2	22	2.0	0.0	2.0
chr16:71626501:G:A	12	1	13	11	2	1.0	1.0	0.0
chr16:71634731:T:G	3	3	6	0	6	2	0	2
chr16:71640979:C:G	0	0	0	0	0	0	0	0
chr16:71649815:A:G	0	0	0	0	0	0	0	0
chr16:71734597:T:C	11	6	17	5	12	2	0	2
chr16:71851520:A:G	2	0	2	2	0	1.0	1.0	0.0
chr16:71894790:C:T	72	25	100	50	50	1.0	1.0	0.0
chr16:71921497:T:G	46	27	73	19	54	2.0	0.0	2.0
chr16:71930021:C:T	12	7	19	5	14	2.0	0.0	2.0
chr16:71934024:C:T	0	0	0	0	0	0	0	0
chr16:71949873:G:C	0	0	0	0	0	0	0	0
chr16:71967237:G:A	0	0	0	0	0	0	0	0
chr16:71993292:T:A	0	0	0	0	0	0	0	0
chr16:71999902:G:T	0	0	0	0	0	0	0	0
chr16:72008783:A:C	46	23	70	24	46	2.0	0.5	1.0
chr16:72008926:T:G	15	10	25	5	20	2	0	2
chr16:72054568:A:G	0	0	0	0	0	0	0	0
chr16:72077049:C:G	1	1	2	0	2	2	0	2
chr16:72096304:C:G	143	74	221	71	150	2	0	2
chr16:72096916:C:A	147	78	231	72	159	2	0	2
chr16:72103662:G:A	3	1	4	2	2	1	1	0
chr16:72104213:G:T	2	0	2	2	0	1.0	1.0	0.0
chr16:72105285:C:A	9	3	12	6	6	1	1	0
chr16:72108696:C:A	1	1	2	0	2	2	0	2
chr16:72119226:C:G	0	0	0	0	0	0	0	0
chr16:72129067:G:T	0	0	0	0	0	0	0	0
chr16:72150667:C:T	0	0	0	0	0	0	0	0
chr16:72793859:T:C	0	0	0	0	0	0	0	0
chr16:72798236:T:A	3	1	4	2	2	1	1	0
chr16:72889801:C:T	1	1	2	0	2	2	0	2
chr16:72950769:C:T	1	0	1	1	0	1	1	0
chr16:72958370:G:A	1	0	1	1	0	1	1	0
chr16:72958393:C:T	1	1	2	0	2	2	0	2
chr16:72958544:G:A	1	1	2	0	2	2	0	2
chr16:72958864:T:G	1	1	2	0	2	2	0	2
chr16:74360847:A:G	30	19	49	11	38	2.0	0.0	2.0
chr16:74456658:G:A	29	12	41	17	24	1	1	0
chr16:74465691:G:A	34	20	54	14	40	2.0	0.0	2.0
chr16:74469133:G:T	19	11	31	9	22	2	0	2
chr16:74469962:T:A	18	10	29	9	20	2.0	0.0	2.0
chr16:74480385:A:T	42	24	66	18	48	2.0	0.0	2.0
chr16:74503693:C:T	72	33	107	41	66	1.0	1.0	0.0
chr16:74630912:A:T	2	2	4	0	4	2.0	0.0	2.0
chr16:74636560:C:T	8	7	15	1	14	2.0	0.0	2.0
chr16:74661181:G:T	42	30	72	12	60	2.0	0.0	2.0
chr16:74675839:C:A	1	0	1	1	0	1	1	0
chr16:74716498:T:C	11	6	17	5	12	2	0	2
chr16:74886293:G:A	11	9	20	2	18	2	0	2
chr16:75170427:C:T	13	6	19	7	12	1	1	0
chr16:75204205:C:T	0	0	0	0	0	0	0	0
chr16:75235025:G:A	0	0	0	0	0	0	0	0
chr16:75235369:A:G	0	0	0	0	0	0	0	0
chr16:75235636:C:T	0	0	0	0	0	0	0	0
chr16:75236823:C:A	0	0	0	0	0	0	0	0
chr16:75242877:G:A	0	0	0	0	0	0	0	0
chr16:75248066:A:C	0	0	0	0	0	0	0	0
chr16:75641711:T:C	155	74	232	84	148	1	1	0
chr16:76553305:T:G	0	0	0	0	0	0	0	0
chr16:76553434:T:C	0	0	0	0	0	0	0	0
chr16:77194969:T:C	9	6	15	3	12	2	0	2
chr16:77212321:G:A	63	49	114	14	100	2	0	2
chr16:77212620:C:A	98	79	187	20	167	2.0	0.0	2.0
chr16:77212898:C:G	100	81	191	19	172	2.0	0.0	2.0
chr16:77212950:T:G	100	80	189	20	169	2.0	0.0	2.0
chr16:77293121:G:A	0	0	0	0	0	0	0	0
chr16:77294998:C:T	0	0	0	0	0	0	0	0
chr16:77295093:C:A	0	0	0	0	0	0	0	0
chr16:78099774:C:T	70	47	120	24	96	2.0	0.0	2.0
chr16:81108652:T:C	0	0	0	0	0	0	0	0
chr16:81112150:A:T	0	0	0	0	0	0	0	0
chr16:81123780:G:T	0	0	0	0	0	0	0	0
chr16:81139588:C:T	0	0	0	0	0	0	0	0
chr16:81147383:C:G	0	0	0	0	0	0	0	0
chr16:81149720:T:A	0	0	0	0	0	0	0	0
chr16:81159716:C:T	0	0	0	0	0	0	0	0
chr16:81177891:C:A	0	0	0	0	0	0	0	0
chr16:81177943:G:A	0	0	0	0	0	0	0	0
chr16:81179773:A:G	0	0	0	0	0	0	0	0
chr16:81185582:C:T	0	0	0	0	0	0	0	0
chr16:81188983:T:A	0	0	0	0	0	0	0	0
chr16:81215140:A:G	0	0	0	0	0	0	0	0
chr16:81216349:T:A	0	0	0	0	0	0	0	0
chr16:81220312:A:G	0	0	0	0	0	0	0	0
chr16:81693258:C:G	0	0	0	0	0	0	0	0
chr16:81883307:A:G	231	128	362	106	256	2	0	2
chr16:81889208:C:T	224	102	331	123	208	1.0	1.0	0.0
chr16:81937798:T:C	53	27	79	26	53	1	0	1
chr16:81938678:T:G	2	1	3	1	2	1.5	0.5	1.0
chr16:81938684:A:C	2	1	3	1	2	1.5	0.5	1.0
chr16:82148749:G:A	260	124	390	144	246	1.0	1.0	0.0
chr16:83032059:G:A	0	0	0	0	0	0	0	0
chr16:83032299:T:C	0	0	0	0	0	0	0	0
chr16:83809187:G:T	11	4	15	7	8	1	1	0
chr16:83966048:A:G	2	2	4	0	4	2.0	0.0	2.0
chr16:84041958:C:A	0	0	0	0	0	0	0	0
chr16:84179173:G:A	27	14	41	13	28	2	0	2
chr16:84236870:G:A	0	0	0	0	0	0	0	0
chr16:84425818:C:G	0	0	0	0	0	0	0	0
chr16:84439181:C:T	0	0	0	0	0	0	0	0
chr16:84442594:A:T	0	0	0	0	0	0	0	0
chr16:84462155:G:C	0	0	0	0	0	0	0	0
chr16:84462219:G:A	0	0	0	0	0	0	0	0
chr16:84482598:G:A	5	3	8	2	6	2	0	2
chr16:84845858:A:G	0	0	0	0	0	0	0	0
chr16:84849305:T:C	0	0	0	0	0	0	0	0
chr16:84849368:C:A	0	0	0	0	0	0	0	0
chr16:84849496:C:T	0	0	0	0	0	0	0	0
chr16:84981935:G:A	23	14	37	9	28	2	0	2
chr16:85672441:A:C	2	1	3	1	2	1.5	0.5	1.0
chr16:85678254:C:T	20	6	28	14	14	1.0	1.0	0.0
chr16:85710126:C:G	56	42	100	14	86	2.0	0.0	2.0
chr16:85911625:C:T	179	82	262	98	164	1	1	0
chr16:87317167:C:A	11	8	19	3	16	2	0	2
chr16:87644538:T:C	0	0	0	0	0	0	0	0
chr16:87708523:G:A	1	1	2	0	2	2	0	2
chr16:87730661:A:T	18	12	30	6	24	2.0	0.0	2.0
chr16:87748716:G:C	53	18	71	35	36	1	1	0
chr16:87755258:G:A	54	19	73	35	38	1.0	1.0	0.0
chr16:87888048:G:A	0	0	0	0	0	0	0	0
chr16:87888240:T:A	0	0	0	0	0	0	0	0
chr16:87904792:G:A	0	0	0	0	0	0	0	0
chr16:87984203:C:T	85	45	133	42	91	2	0	2
chr16:88072119:G:A	41	23	64	18	46	2	0	2
chr16:88431813:C:T	0	0	0	0	0	0	0	0
chr16:88433131:C:G	0	0	0	0	0	0	0	0
chr16:88434022:G:T	0	0	0	0	0	0	0	0
chr16:88434626:G:C	0	0	0	0	0	0	0	0
chr16:88434978:C:A	0	0	0	0	0	0	0	0
chr16:88435563:T:A	0	0	0	0	0	0	0	0
chr16:88438442:G:C	0	0	0	0	0	0	0	0
chr16:88439227:A:G	0	0	0	0	0	0	0	0
chr16:88439340:G:A	0	0	0	0	0	0	0	0
chr16:88535073:C:T	17	8	25	9	16	1	1	0
chr16:88643329:C:T	4060	2739	14304	5278	9026	3.0	1.0	2.0
chr16:88647093:A:G	58	50	109	8	101	2.0	0.0	2.0
chr16:88657939:G:T	153	79	238	78	160	2	0	2
chr16:88699760:C:T	3	2	5	1	4	2	0	2
chr16:88701361:G:C	102	61	166	42	124	2.0	0.0	2.0
chr16:88701453:C:G	0	0	0	0	0	0	0	0
chr16:88712102:G:A	1	0	1	1	0	1	1	0
chr16:88712207:G:A	1	1	2	0	2	2	0	2
chr16:88712624:G:C	34	19	56	16	40	2.0	0.0	2.0
chr16:88713331:A:G	36	17	56	20	36	1.5	1.0	0.0
chr16:88714632:A:G	38	19	60	20	40	2.0	0.5	1.0
chr16:88715150:G:A	14	7	21	7	14	1.5	0.5	1.0
chr16:88715671:G:A	81	35	121	49	72	1	1	0
chr16:88722552:C:A	0	0	0	0	0	0	0	0
chr16:88736716:T:C	0	0	0	0	0	0	0	0
chr16:88738210:G:A	0	0	0	0	0	0	0	0
chr16:88738775:G:A	0	0	0	0	0	0	0	0
chr16:88738823:G:A	0	0	0	0	0	0	0	0
chr16:88738828:G:A	0	0	0	0	0	0	0	0
chr16:88741733:T:C	0	0	0	0	0	0	0	0
chr16:88806103:T:C	0	0	0	0	0	0	0	0
chr16:88814403:C:T	92	48	142	44	98	2.0	0.0	2.0
chr16:88818058:C:T	76	42	120	34	86	2.0	0.0	2.0
chr16:88835775:G:A	75	36	113	39	74	1	1	0
chr16:88842968:C:T	0	0	0	0	0	0	0	0
chr16:88866361:C:G	1	1	2	0	2	2	0	2
chr16:88898149:C:G	7	4	11	3	8	2	0	2
chr16:88951075:C:G	2	2	4	0	4	2.0	0.0	2.0
chr16:89133243:G:A	115	60	175	55	120	2	0	2
chr16:89154065:C:T	19	13	32	6	26	2	0	2
chr16:89171782:G:A	0	0	0	0	0	0	0	0
chr16:89180262:T:C	0	0	0	0	0	0	0	0
chr16:89185368:G:A	0	0	0	0	0	0	0	0
chr16:89185390:C:T	0	0	0	0	0	0	0	0
chr16:89185443:A:G	0	0	0	0	0	0	0	0
chr16:89196082:G:A	0	0	0	0	0	0	0	0
chr16:89196249:G:A	0	0	0	0	0	0	0	0
chr16:89198679:A:G	0	0	0	0	0	0	0	0
chr16:89198693:C:T	0	0	0	0	0	0	0	0
chr16:89199058:A:G	0	0	0	0	0	0	0	0
chr16:89221073:C:A	4	3	7	1	6	2.0	0.0	2.0
chr16:89223216:G:A	4	3	7	1	6	2.0	0.0	2.0
chr16:89226863:A:C	2	1	3	1	2	1.5	0.5	1.0
chr16:89226883:G:A	2	1	3	1	2	1.5	0.5	1.0
chr16:89227206:A:G	2	1	3	1	2	1.5	0.5	1.0
chr16:89227776:G:A	3	2	5	1	4	2	0	2
chr16:89227973:T:C	3	2	5	1	4	2	0	2
chr16:89228031:G:T	3	2	5	1	4	2	0	2
chr16:89228103:C:T	2	2	4	0	4	2.0	0.0	2.0
chr16:89228289:C:T	2	2	4	0	4	2.0	0.0	2.0
chr16:89228390:A:G	2	0	2	2	0	1.0	1.0	0.0
chr16:89228638:T:C	2	0	2	2	0	1.0	1.0	0.0
chr16:89229419:T:C	0	0	0	0	0	0	0	0
chr16:89229449:G:C	0	0	0	0	0	0	0	0
chr16:89233491:A:G	0	0	0	0	0	0	0	0
chr16:89544791:G:A	0	0	0	0	0	0	0	0
chr16:89561665:G:A	5070	4832	72787	23235	49552	13.0	4.0	8.0
chr16:89711353:C:T	10	4	14	6	8	1.0	1.0	0.0
chr16:89723490:T:C	34	21	54	13	41	2.0	0.0	2.0
chr16:89738853:A:G	16	8	24	8	16	1.5	0.5	1.0
chr16:89739569:G:A	33	15	48	18	30	1	1	0
chr16:89739939:A:T	31	15	46	16	30	1	1	0
chr16:89769915:C:T	0	0	0	0	0	0	0	0
chr16:89783072:C:T	0	0	0	0	0	0	0	0
chr16:89791616:A:G	1	1	2	0	2	2	0	2
chr16:89798834:T:C	2	1	3	1	2	1.5	0.5	1.0
chr16:89919436:G:T	7	4	11	3	8	2	0	2
chr16:89971420:G:A	16	11	27	5	22	2.0	0.0	2.0
chr16:90042424:C:T	0	0	0	0	0	0	0	0
chr16:90094545:T:C	0	0	0	0	0	0	0	0
chr16:90094657:A:T	0	0	0	0	0	0	0	0
chr16:90095345:T:C	0	0	0	0	0	0	0	0
chr16:90095778:T:C	0	0	0	0	0	0	0	0
chr17:3062979:G:A	0	0	0	0	0	0	0	0
chr17:3063014:C:T	0	0	0	0	0	0	0	0
chr17:18494397:G:A	2	0	2	2	0	1.0	1.0	0.0
chr17:18639206:T:G	0	0	0	0	0	0	0	0
chr17:19382211:T:A	12	0	12	12	0	1.0	1.0	0.0
chr17:21302148:C:T	101	0	102	102	0	1	1	0
chr17:21415291:C:T	0	0	0	0	0	0	0	0
chr17:21415317:C:A	0	0	0	0	0	0	0	0
chr17:21415351:G:A	0	0	0	0	0	0	0	0
chr17:26981762:C:T	0	0	0	0	0	0	0	0
chr17:27301794:T:C	252	161	423	95	328	2.0	0.0	2.0
chr17:27303362:T:C	15	11	28	4	24	2	0	2
chr17:27582790:C:T	0	0	0	0	0	0	0	0
chr17:27879388:C:A	98	55	156	44	112	2.0	0.0	2.0
chr17:28349109:C:T	179	86	269	95	174	1	1	0
chr17:28355800:C:T	199	109	313	93	220	2	0	2
chr17:28364299:A:G	1	1	2	0	2	2	0	2
chr17:28368811:A:G	0	0	0	0	0	0	0	0
chr17:28547296:G:A	298	130	441	175	266	1.0	1.0	0.0
chr17:28556295:A:G	1	0	1	1	0	1	1	0
chr17:28673373:A:G	44	20	65	25	40	1.0	1.0	0.0
chr17:28682731:C:T	0	0	0	0	0	0	0	0
chr17:28717464:C:A	56	0	56	56	0	1.0	1.0	0.0
chr17:28759125:C:T	4	0	4	4	0	1.0	1.0	0.0
chr17:28880435:G:A	224	115	353	119	234	2.0	1.0	2.0
chr17:28880553:C:T	201	102	317	105	212	2	1	2
chr17:29250258:G:A	1	0	1	1	0	1	1	0
chr17:29562968:T:C	35	17	52	19	33	1	1	0
chr17:29581305:G:A	0	0	0	0	0	0	0	0
chr17:29609328:C:T	2	0	2	2	0	1.0	1.0	0.0
chr17:29617071:C:T	4	1	5	3	2	1.0	1.0	0.0
chr17:30249058:T:C	46	18	64	28	36	1.0	1.0	0.0
chr17:30285430:G:C	43	18	62	26	36	1	1	0
chr17:30519865:C:T	1	0	1	1	0	1	1	0
chr17:30559682:G:A	0	0	0	0	0	0	0	0
chr17:31319014:G:A	239	151	420	100	320	2	0	2
chr17:31522461:C:T	0	0	0	0	0	0	0	0
chr17:31528643:G:A	6	5	11	1	10	2.0	0.0	2.0
chr17:31530442:G:A	6	1	7	5	2	1.0	1.0	0.0
chr17:31856838:T:C	114	65	193	51	142	2.0	0.0	2.0
chr17:31901637:G:A	215	112	334	106	228	2	0	2
chr17:32206951:A:G	38	14	52	24	28	1.0	1.0	0.0
chr17:32298186:G:A	0	0	0	0	0	0	0	0
chr17:32369273:C:T	52	23	75	29	46	1.0	1.0	0.0
chr17:34037703:T:C	0	0	0	0	0	0	0	0
chr17:34038126:C:G	0	0	0	0	0	0	0	0
chr17:34038967:G:A	0	0	0	0	0	0	0	0
chr17:34039528:G:A	0	0	0	0	0	0	0	0
chr17:34156218:A:G	0	0	0	0	0	0	0	0
chr17:34156251:C:G	0	0	0	0	0	0	0	0
chr17:34579019:G:C	0	0	0	0	0	0	0	0
chr17:34635045:C:A	0	0	0	0	0	0	0	0
chr17:34961344:C:T	32	16	48	16	32	1.5	0.5	1.0
chr17:35003131:A:C	12	5	17	7	10	1.0	1.0	0.0
chr17:35004556:C:T	6	0	6	6	0	1.0	1.0	0.0
chr17:35106468:C:T	52	25	77	27	50	1.0	1.0	0.0
chr17:35352421:C:T	10	7	17	3	14	2.0	0.0	2.0
chr17:35362907:T:C	2	1	3	1	2	1.5	0.5	1.0
chr17:35363447:C:A	4	0	4	4	0	1.0	1.0	0.0
chr17:35745245:G:T	0	0	0	0	0	0	0	0
chr17:35745536:G:A	0	0	0	0	0	0	0	0
chr17:36013794:G:A	0	0	0	0	0	0	0	0
chr17:36486677:G:A	130	41	178	94	84	1.0	1.0	0.0
chr17:36498436:G:A	19	12	33	7	26	2	0	2
chr17:36513312:A:G	17	6	23	11	12	1	1	0
chr17:36587289:C:T	34	20	54	14	40	2.0	0.0	2.0
chr17:36594897:C:T	0	0	0	0	0	0	0	0
chr17:36989342:T:C	213	104	328	114	214	1	1	0
chr17:37252940:C:T	2	0	2	2	0	1.0	1.0	0.0
chr17:37536021:T:C	14	6	20	8	12	1.0	1.0	0.0
chr17:37596344:G:C	168	99	272	71	201	2.0	0.0	2.0
chr17:38466241:C:G	0	0	0	0	0	0	0	0
chr17:38548593:G:A	0	0	0	0	0	0	0	0
chr17:38770478:T:G	0	0	0	0	0	0	0	0
chr17:38841426:G:A	0	0	0	0	0	0	0	0
chr17:38898519:C:T	100	51	153	49	104	2.0	0.0	2.0
chr17:38898631:A:G	19	13	31	6	25	2	0	2
chr17:39657827:G:A	115	55	175	63	112	1	1	0
chr17:39666058:A:C	9	2	11	7	4	1	1	0
chr17:39727784:C:G	4	2	6	2	4	1.5	0.5	1.0
chr17:39766006:G:A	79	39	119	41	78	1	1	0
chr17:39864166:T:C	536	240	836	337	499	1.0	1.0	0.0
chr17:39868373:C:T	4	4	8	0	8	2.0	0.0	2.0
chr17:39872381:G:T	1	1	2	0	2	2	0	2
chr17:39875421:C:T	0	0	0	0	0	0	0	0
chr17:39905943:G:A	14	1	15	13	2	1.0	1.0	0.0
chr17:39905964:C:T	14	1	15	13	2	1.0	1.0	0.0
chr17:39965740:G:A	2	2	4	0	4	2.0	0.0	2.0
chr17:39966427:G:T	2	0	2	2	0	1.0	1.0	0.0
chr17:39966433:G:A	2	0	2	2	0	1.0	1.0	0.0
chr17:39974934:C:A	1	1	2	0	2	2	0	2
chr17:39981111:G:A	295	153	471	157	314	2	1	2
chr17:39997622:T:A	278	139	434	150	284	2.0	1.0	1.0
chr17:40015415:C:G	0	0	0	0	0	0	0	0
chr17:40016890:G:A	0	0	0	0	0	0	0	0
chr17:40020003:A:T	7	4	11	3	8	2	0	2
chr17:40023239:A:G	24	10	35	15	20	1.0	1.0	0.0
chr17:40026837:G:T	2	2	4	0	4	2.0	0.0	2.0
chr17:40032166:C:T	2	2	4	0	4	2.0	0.0	2.0
chr17:40033540:T:C	0	0	0	0	0	0	0	0
chr17:40192875:G:A	0	0	0	0	0	0	0	0
chr17:40300899:G:A	0	0	0	0	0	0	0	0
chr17:40484492:C:T	0	0	0	0	0	0	0	0
chr17:40488873:A:G	0	0	0	0	0	0	0	0
chr17:40754960:G:A	0	0	0	0	0	0	0	0
chr17:40755075:C:G	0	0	0	0	0	0	0	0
chr17:40771762:A:G	0	0	0	0	0	0	0	0
chr17:40779560:A:G	0	0	0	0	0	0	0	0
chr17:40782064:C:T	0	0	0	0	0	0	0	0
chr17:40782339:C:G	0	0	0	0	0	0	0	0
chr17:40794020:T:C	0	0	0	0	0	0	0	0
chr17:40799739:C:T	0	0	0	0	0	0	0	0
chr17:40818360:T:C	2757	1672	6337	2103	4234	2	1	2
chr17:40822210:C:T	1	0	2	2	0	2	2	0
chr17:40834427:T:A	64	42	108	24	84	2.0	0.0	2.0
chr17:40834800:TT:GA	64	24	91	41	50	1.0	1.0	0.0
chr17:40925294:A:G	0	0	0	0	0	0	0	0
chr17:40925461:A:G	0	0	0	0	0	0	0	0
chr17:40928252:T:C	0	0	0	0	0	0	0	0
chr17:41059685:G:T	0	0	0	0	0	0	0	0
chr17:41084252:A:G	0	0	0	0	0	0	0	0
chr17:41084259:A:T	0	0	0	0	0	0	0	0
chr17:41084409:C:G	0	0	0	0	0	0	0	0
chr17:41097563:G:A	0	0	0	0	0	0	0	0
chr17:41097583:C:T	0	0	0	0	0	0	0	0
chr17:41105681:C:T	0	0	0	0	0	0	0	0
chr17:41105697:T:C	0	0	0	0	0	0	0	0
chr17:41117983:G:A	0	0	0	0	0	0	0	0
chr17:41118266:C:T	0	0	0	0	0	0	0	0
chr17:41149704:G:A	0	0	0	0	0	0	0	0
chr17:41232559:C:A	0	0	0	0	0	0	0	0
chr17:41250157:C:A	0	0	0	0	0	0	0	0
chr17:41250195:A:G	0	0	0	0	0	0	0	0
chr17:41302224:A:T	0	0	0	0	0	0	0	0
chr17:41302513:A:G	0	0	0	0	0	0	0	0
chr17:41302641:G:A	0	0	0	0	0	0	0	0
chr17:41307794:G:C	0	0	0	0	0	0	0	0
chr17:41308235:G:C	0	0	0	0	0	0	0	0
chr17:41308484:C:G	0	0	0	0	0	0	0	0
chr17:41308842:C:T	1	0	1	1	0	1	1	0
chr17:41309137:T:A	1	0	1	1	0	1	1	0
chr17:41315526:C:T	0	0	0	0	0	0	0	0
chr17:41315677:G:A	0	0	0	0	0	0	0	0
chr17:41364793:C:T	0	0	0	0	0	0	0	0
chr17:41422172:G:T	0	0	0	0	0	0	0	0
chr17:41422860:G:A	0	0	0	0	0	0	0	0
chr17:41423878:G:A	0	0	0	0	0	0	0	0
chr17:41424307:TGGT:AGGC	0	0	0	0	0	0	0	0
chr17:41424408:T:C	0	0	0	0	0	0	0	0
chr17:41424564:G:C	0	0	0	0	0	0	0	0
chr17:41438557:C:T	0	0	0	0	0	0	0	0
chr17:41462863:G:A	0	0	0	0	0	0	0	0
chr17:41464147:C:T	0	0	0	0	0	0	0	0
chr17:41465816:G:T	0	0	0	0	0	0	0	0
chr17:41477065:A:G	0	0	0	0	0	0	0	0
chr17:41477102:C:T	0	0	0	0	0	0	0	0
chr17:41486309:T:A	0	0	0	0	0	0	0	0
chr17:41486978:G:A	0	0	0	0	0	0	0	0
chr17:41489769:A:G	0	0	0	0	0	0	0	0
chr17:41567738:T:A	0	0	0	0	0	0	0	0
chr17:41571564:T:G	0	0	0	0	0	0	0	0
chr17:41571798:G:A	0	0	0	0	0	0	0	0
chr17:41586466:A:G	0	0	0	0	0	0	0	0
chr17:41586555:C:T	0	0	0	0	0	0	0	0
chr17:41586604:G:A	0	0	0	0	0	0	0	0
chr17:41586829:G:A	0	0	0	0	0	0	0	0
chr17:41611492:A:G	0	0	0	0	0	0	0	0
chr17:41622908:G:C	0	0	0	0	0	0	0	0
chr17:41624515:C:G	0	0	0	0	0	0	0	0
chr17:41811190:T:C	5	3	8	2	6	2	0	2
chr17:41949187:C:T	0	0	0	0	0	0	0	0
chr17:42027088:G:A	3	1	4	2	2	1	1	0
chr17:42114921:G:A	91	47	138	44	94	2	0	2
chr17:42189891:G:A	77	42	124	38	86	2	0	2
chr17:43661455:G:A	0	0	0	0	0	0	0	0
chr17:43769596:T:C	21	12	33	9	24	2	0	2
chr17:43801706:T:C	0	0	0	0	0	0	0	0
chr17:43909694:A:G	0	0	0	0	0	0	0	0
chr17:43941103:T:C	0	0	0	0	0	0	0	0
chr17:44006699:T:C	2	0	2	2	0	1.0	1.0	0.0
chr17:44008604:C:T	5	5	10	0	10	2	0	2
chr17:44087517:G:C	51	19	70	32	38	1	1	0
chr17:44110943:C:G	0	0	0	0	0	0	0	0
chr17:44148179:A:C	3	2	5	1	4	2	0	2
chr17:44161981:T:C	2	1	3	1	2	1.5	0.5	1.0
chr17:44170978:A:T	4	3	7	1	6	2.0	0.0	2.0
chr17:44177159:T:G	47	25	73	22	51	2	0	2
chr17:44177729:T:C	24	14	38	10	28	2.0	0.0	2.0
chr17:44190906:C:T	160	85	249	78	171	2.0	0.0	2.0
chr17:44195218:G:A	2	2	4	0	4	2.0	0.0	2.0
chr17:44210151:C:T	62	35	97	27	70	2.0	0.0	2.0
chr17:44321434:G:A	474	250	517	249	268	1.0	1.0	1.0
chr17:44351170:G:A	0	0	0	0	0	0	0	0
chr17:44666870:A:C	0	0	0	0	0	0	0	0
chr17:44876041:A:G	53	28	85	27	58	2	0	2
chr17:44911720:C:T	0	0	0	0	0	0	0	0
chr17:44926116:T:C	0	0	0	0	0	0	0	0
chr17:44926210:C:T	0	0	0	0	0	0	0	0
chr17:44927068:G:A	0	0	0	0	0	0	0	0
chr17:44931602:T:C	0	0	0	0	0	0	0	0
chr17:45034320:G:A	47	26	76	22	54	2	0	2
chr17:45093786:C:T	59	32	91	27	64	2	0	2
chr17:45098538:C:T	53	24	77	29	48	1	1	0
chr17:45105660:G:A	41	19	60	22	38	1	1	0
chr17:45113478:G:A	1	1	2	0	2	2	0	2
chr17:45139105:A:G	41	19	60	22	38	1	1	0
chr17:45238993:G:A	10	6	16	4	12	2.0	0.0	2.0
chr17:45395459:G:C	11	6	17	5	12	2	0	2
chr17:45397074:C:G	0	0	0	0	0	0	0	0
chr17:46872756:T:C	0	0	0	0	0	0	0	0
chr17:47283364:T:C	1	0	1	1	0	1	1	0
chr17:47808390:C:T	19	13	32	6	26	2	0	2
chr17:47819112:T:C	1	1	2	0	2	2	0	2
chr17:47973907:G:C	7	3	10	4	6	1	1	0
chr17:48059389:G:C	7	1	8	6	2	1	1	0
chr17:48552231:G:T	0	0	0	0	0	0	0	0
chr17:48787797:G:A	0	0	0	0	0	0	0	0
chr17:49040068:T:A	0	0	0	0	0	0	0	0
chr17:49510457:C:T	1	1	2	0	2	2	0	2
chr17:49838592:G:C	0	0	0	0	0	0	0	0
chr17:49993514:C:T	0	0	0	0	0	0	0	0
chr17:49995062:G:A	0	0	0	0	0	0	0	0
chr17:50077097:C:T	1	1	2	0	2	2	0	2
chr17:50081316:A:G	1	0	1	1	0	1	1	0
chr17:50095415:A:C	183	77	269	113	156	1	1	0
chr17:50196103:T:C	0	0	0	0	0	0	0	0
chr17:50278607:C:T	0	0	0	0	0	0	0	0
chr17:50278899:G:C	0	0	0	0	0	0	0	0
chr17:50353671:G:A	7	5	12	2	10	2	0	2
chr17:50353836:C:T	7	5	12	2	10	2	0	2
chr17:50354963:G:C	6	4	10	2	8	2.0	0.0	2.0
chr17:50378624:A:T	4	1	7	3	4	1.0	1.0	0.0
chr17:50378832:T:C	4	1	7	3	4	1.0	1.0	0.0
chr17:50380248:C:G	3	1	4	2	2	1	1	0
chr17:50521424:G:A	5	5	10	0	10	2	0	2
chr17:50522089:A:T	5	5	10	0	10	2	0	2
chr17:50526142:C:T	0	0	0	0	0	0	0	0
chr17:50529176:C:G	0	0	0	0	0	0	0	0
chr17:50531356:T:C	1	1	2	0	2	2	0	2
chr17:50536476:A:G	0	0	0	0	0	0	0	0
chr17:50537024:G:A	0	0	0	0	0	0	0	0
chr17:50552097:A:G	98	50	149	49	100	2.0	0.5	2.0
chr17:50575993:C:A	0	0	0	0	0	0	0	0
chr17:50626391:T:C	0	0	0	0	0	0	0	0
chr17:50664178:A:C	0	0	0	0	0	0	0	0
chr17:53823368:C:T	0	0	0	0	0	0	0	0
chr17:53824024:C:T	0	0	0	0	0	0	0	0
chr17:55081131:G:A	2	0	2	2	0	1.0	1.0	0.0
chr17:55751317:G:A	0	0	0	0	0	0	0	0
chr17:55822816:T:C	4	1	5	3	2	1.0	1.0	0.0
chr17:57105517:C:T	9	6	15	3	12	2	0	2
chr17:57744810:T:C	0	0	0	0	0	0	0	0
chr17:57744853:T:A	1	1	2	0	2	2	0	2
chr17:57745106:G:A	0	0	0	0	0	0	0	0
chr17:57872703:C:T	0	0	0	0	0	0	0	0
chr17:58155314:G:A	0	0	0	0	0	0	0	0
chr17:58156138:C:T	0	0	0	0	0	0	0	0
chr17:58169740:C:A	0	0	0	0	0	0	0	0
chr17:58192760:T:C	0	0	0	0	0	0	0	0
chr17:58193733:G:C	0	0	0	0	0	0	0	0
chr17:58195029:A:G	0	0	0	0	0	0	0	0
chr17:58249160:G:C	0	0	0	0	0	0	0	0
chr17:58249495:C:T	0	0	0	0	0	0	0	0
chr17:58250638:A:G	0	0	0	0	0	0	0	0
chr17:58254966:G:A	0	0	0	0	0	0	0	0
chr17:58357719:G:C	3	2	5	1	4	2	0	2
chr17:58360940:G:A	8	2	10	6	4	1.0	1.0	0.0
chr17:58507147:T:C	1	0	1	1	0	1	1	0
chr17:58521630:T:A	1	0	1	1	0	1	1	0
chr17:58543925:G:T	2	0	2	2	0	1.0	1.0	0.0
chr17:58543998:T:C	2	0	2	2	0	1.0	1.0	0.0
chr17:58599007:T:C	0	0	0	0	0	0	0	0
chr17:59878393:G:C	2	2	4	0	4	2.0	0.0	2.0
chr17:59886176:A:G	67	24	91	43	48	1	1	0
chr17:61456507:G:C	0	0	0	0	0	0	0	0
chr17:61483324:C:T	0	0	0	0	0	0	0	0
chr17:61590660:G:C	0	0	0	0	0	0	0	0
chr17:61590991:C:T	0	0	0	0	0	0	0	0
chr17:62137028:G:A	0	0	0	0	0	0	0	0
chr17:62606142:A:G	17	3	20	14	6	1	1	0
chr17:62676543:A:C	1	0	1	1	0	1	1	0
chr17:62692442:A:G	1	0	1	1	0	1	1	0
chr17:62736266:G:A	0	0	0	0	0	0	0	0
chr17:62736912:A:G	0	0	0	0	0	0	0	0
chr17:63237911:G:A	2	2	4	0	4	2.0	0.0	2.0
chr17:63395964:C:A	1	1	2	0	2	2	0	2
chr17:63481680:G:A	0	0	0	0	0	0	0	0
chr17:63530347:T:C	0	0	0	0	0	0	0	0
chr17:63534062:T:C	0	0	0	0	0	0	0	0
chr17:63728247:G:A	91	41	133	51	82	1	1	0
chr17:63728387:G:A	118	56	176	64	112	1.0	1.0	0.0
chr17:63823837:T:A	25	15	40	10	30	2	0	2
chr17:63827364:TCTCG:CCTCA	0	0	0	0	0	0	0	0
chr17:63829486:T:C	2	2	4	0	4	2.0	0.0	2.0
chr17:63830911:C:T	793	450	1351	402	949	2	0	2
chr17:63831196:C:T	808	458	1379	411	968	2.0	0.0	2.0
chr17:63834901:C:T	5	4	9	1	8	2	0	2
chr17:63909628:A:G	0	0	0	0	0	0	0	0
chr17:63910210:G:T	0	0	0	0	0	0	0	0
chr17:63910216:G:A	0	0	0	0	0	0	0	0
chr17:63930138:A:G	1836	973	3755	1409	2346	2.0	1.0	2.0
chr17:63972378:G:A	0	0	0	0	0	0	0	0
chr17:64323758:T:C	70	26	96	44	52	1.0	1.0	0.0
chr17:64356203:C:T	53	34	87	19	68	2	0	2
chr17:64377783:A:T	0	0	0	0	0	0	0	0
chr17:64377836:C:G	26	9	35	17	18	1.0	1.0	0.0
chr17:64485684:A:G	42	22	65	21	44	2.0	0.0	2.0
chr17:64496464:C:T	203	101	309	107	202	2	1	0
chr17:64497049:A:G	198	91	291	112	179	1.0	1.0	0.0
chr17:65558473:G:A	2	0	2	2	0	1.0	1.0	0.0
chr17:66029213:A:G	0	0	0	0	0	0	0	0
chr17:66214639:C:A	0	0	0	0	0	0	0	0
chr17:66688960:G:A	0	0	0	0	0	0	0	0
chr17:67366436:T:A	212	117	334	99	235	2.0	0.0	2.0
chr17:67982205:C:A	8	5	13	3	10	2.0	0.0	2.0
chr17:68130272:A:G	11	8	19	3	16	2	0	2
chr17:68248437:T:C	128	72	202	58	144	2.0	0.0	2.0
chr17:68250275:A:G	195	107	311	93	218	2	0	2
chr17:68271550:A:T	2	2	4	0	4	2.0	0.0	2.0
chr17:68368608:T:C	21	7	28	14	14	1	1	0
chr17:68368663:T:C	21	7	28	14	14	1	1	0
chr17:68426017:A:G	5	3	8	2	6	2	0	2
chr17:68428782:C:T	14	7	21	7	14	1.5	0.5	1.0
chr17:68542098:G:T	0	0	0	0	0	0	0	0
chr17:68543706:C:T	1	1	2	0	2	2	0	2
chr17:68875696:C:T	0	0	0	0	0	0	0	0
chr17:68876661:G:C	0	0	0	0	0	0	0	0
chr17:68877602:G:A	0	0	0	0	0	0	0	0
chr17:69035316:C:T	21	12	33	9	24	2	0	2
chr17:69085137:A:G	127	63	191	65	126	1	1	0
chr17:69153416:A:T	1	0	1	1	0	1	1	0
chr17:69153832:G:A	0	0	0	0	0	0	0	0
chr17:69153977:C:T	0	0	0	0	0	0	0	0
chr17:69277741:C:A	8	3	11	5	6	1.0	1.0	0.0
chr17:70132276:C:T	0	0	0	0	0	0	0	0
chr17:72122794:C:T	0	0	0	0	0	0	0	0
chr17:72124410:A:C	0	0	0	0	0	0	0	0
chr17:72649203:C:T	9	6	15	3	12	2	0	2
chr17:73390438:G:T	2	1	3	1	2	1.5	0.5	1.0
chr17:73394227:C:A	1	0	1	1	0	1	1	0
chr17:73402031:G:C	5	4	9	1	8	2	0	2
chr17:73414752:C:T	7	1	8	6	2	1	1	0
chr17:73507497:T:C	3	0	3	3	0	1	1	0
chr17:73737869:C:T	0	0	0	0	0	0	0	0
chr17:73750657:A:G	0	0	0	0	0	0	0	0
chr17:73755947:T:C	0	0	0	0	0	0	0	0
chr17:74305293:A:G	0	0	0	0	0	0	0	0
chr17:74309395:C:T	0	0	0	0	0	0	0	0
chr17:74350716:T:C	0	0	0	0	0	0	0	0
chr17:74352901:C:T	0	0	0	0	0	0	0	0
chr17:74352928:C:T	0	0	0	0	0	0	0	0
chr17:74354263:G:A	0	0	0	0	0	0	0	0
chr17:74354273:G:A	0	0	0	0	0	0	0	0
chr17:74354885:T:C	0	0	0	0	0	0	0	0
chr17:74357606:G:T	0	0	0	0	0	0	0	0
chr17:74372411:T:C	0	0	0	0	0	0	0	0
chr17:74447053:G:T	7	5	12	2	10	2	0	2
chr17:74447148:C:G	7	5	12	2	10	2	0	2
chr17:74545841:A:G	137	96	257	47	210	2	0	2
chr17:74592667:C:A	0	0	0	0	0	0	0	0
chr17:74617450:T:G	0	0	0	0	0	0	0	0
chr17:74772831:G:A	15	4	19	11	8	1	1	0
chr17:74773600:A:G	105	58	164	48	116	2	0	2
chr17:74775627:C:G	204	113	321	93	228	2.0	0.0	2.0
chr17:74836789:G:A	0	0	0	0	0	0	0	0
chr17:74838815:C:A	1	1	2	0	2	2	0	2
chr17:74842510:C:A	0	0	0	0	0	0	0	0
chr17:74847239:C:T	3	2	5	1	4	2	0	2
chr17:74864131:G:A	0	0	0	0	0	0	0	0
chr17:74931028:G:T	0	0	0	0	0	0	0	0
chr17:74941510:G:A	0	0	0	0	0	0	0	0
chr17:74941756:G:A	0	0	0	0	0	0	0	0
chr17:74942005:T:C	0	0	0	0	0	0	0	0
chr17:74947031:G:A	0	0	0	0	0	0	0	0
chr17:74953051:C:T	1	1	2	0	2	2	0	2
chr17:74960029:G:A	3	2	5	1	4	2	0	2
chr17:75093757:T:C	19	15	36	4	32	2	0	2
chr17:75114184:C:T	48	20	68	28	40	1.0	1.0	0.0
chr17:75129078:A:G	21	12	33	9	24	2	0	2
chr17:75131122:G:C	943	563	1667	458	1209	2	0	2
chr17:75209881:T:C	47	27	76	20	56	2	0	2
chr17:75232049:T:C	10	9	19	1	18	2.0	0.0	2.0
chr17:75234761:C:T	45	15	61	31	30	1	1	0
chr17:75261905:C:T	596	324	994	316	678	2.0	0.0	2.0
chr17:75273595:C:T	192	74	280	124	156	1.0	1.0	0.0
chr17:75497793:G:C	14	7	21	7	14	1.5	0.5	1.0
chr17:75517075:G:A	2	2	4	0	4	2.0	0.0	2.0
chr17:75517208:C:G	82	39	122	44	78	1.0	1.0	0.0
chr17:75522122:G:C	83	43	126	40	86	2	0	2
chr17:75522247:A:C	85	42	127	43	84	1	1	0
chr17:75523332:C:T	56	32	88	24	64	2.0	0.0	2.0
chr17:75556104:G:A	91	46	138	46	92	2	1	2
chr17:75563261:G:A	1	0	1	1	0	1	1	0
chr17:75563482:G:A	2	0	2	2	0	1.0	1.0	0.0
chr17:75563548:A:G	2	0	2	2	0	1.0	1.0	0.0
chr17:75570480:G:A	7	3	10	4	6	1	1	0
chr17:75571765:C:T	10	4	14	6	8	1.0	1.0	0.0
chr17:75571974:C:T	11	4	15	7	8	1	1	0
chr17:75574637:C:G	11	4	15	7	8	1	1	0
chr17:75590103:C:G	6	5	11	1	10	2.0	0.0	2.0
chr17:75590244:G:A	5	1	6	4	2	1	1	0
chr17:75590277:G:A	5	4	9	1	8	2	0	2
chr17:75591829:C:T	1	0	1	1	0	1	1	0
chr17:75591986:A:G	14	3	18	12	6	1.0	1.0	0.0
chr17:75606000:G:A	2	0	2	2	0	1.0	1.0	0.0
chr17:75610229:G:A	11	4	15	8	7	1	1	0
chr17:75613031:GC:AT	6	1	8	6	2	1.0	1.0	0.0
chr17:75613058:C:T	6	5	13	1	12	2.0	0.0	2.0
chr17:75617895:G:A	13	12	25	1	24	2	0	2
chr17:75620773:G:C	26	21	46	5	41	2.0	0.0	2.0
chr17:75620784:C:A	26	21	47	5	42	2.0	0.0	2.0
chr17:75623840:G:A	2	2	4	0	4	2.0	0.0	2.0
chr17:75629206:G:A	12	7	19	5	14	2.0	0.0	2.0
chr17:75631459:T:C	9	4	13	5	8	1	1	0
chr17:75640288:C:T	0	0	0	0	0	0	0	0
chr17:75651058:CA:TG	1	1	2	0	2	2	0	2
chr17:75667292:A:T	5	1	6	4	2	1	1	0
chr17:75752241:C:T	2	1	3	1	2	1.5	0.5	1.0
chr17:75754778:C:G	1	1	2	0	2	2	0	2
chr17:75757422:T:C	1	1	2	0	2	2	0	2
chr17:75778760:G:A	4046	2797	15872	5867	10005	3.0	1.0	2.0
chr17:75816828:A:G	2	0	2	2	0	1.0	1.0	0.0
chr17:75819945:A:G	2	0	2	2	0	1.0	1.0	0.0
chr17:75823444:C:T	6	5	11	1	10	2.0	0.0	2.0
chr17:75831124:T:C	30	15	45	15	30	1.5	0.5	1.0
chr17:75840005:A:C	0	0	0	0	0	0	0	0
chr17:75840081:C:G	10	6	15	4	11	1.5	0.0	1.5
chr17:75841045:T:A	1	1	2	0	2	2	0	2
chr17:75841061:A:C	1	1	2	0	2	2	0	2
chr17:75843056:G:A	96	55	152	42	110	2.0	0.0	2.0
chr17:75843245:C:T	98	56	155	43	112	2.0	0.0	2.0
chr17:75851718:G:A	8	3	11	5	6	1.0	1.0	0.0
chr17:75890807:A:G	9	2	11	7	4	1	1	0
chr17:75892693:C:A	4	1	5	3	2	1.0	1.0	0.0
chr17:75904607:T:C	353	154	518	212	306	1	1	0
chr17:75913946:C:T	3	3	6	0	6	2	0	2
chr17:75926860:T:C	2	2	4	0	4	2.0	0.0	2.0
chr17:75938154:C:T	3	1	4	2	2	1	1	0
chr17:75953459:G:C	18	7	25	11	14	1.0	1.0	0.0
chr17:76082032:G:A	11	5	18	6	12	1	1	0
chr17:76167740:G:A	0	0	0	0	0	0	0	0
chr17:76274177:C:A	14	7	21	7	14	1.5	0.5	1.0
chr17:76293927:G:T	0	0	0	0	0	0	0	0
chr17:76385474:G:A	2	2	4	0	4	2.0	0.0	2.0
chr17:76387394:T:C	2	0	2	2	0	1.0	1.0	0.0
chr17:76391203:C:T	11	5	16	6	10	1	1	0
chr17:76398294:G:A	8	4	12	4	8	1.5	0.5	1.0
chr17:76479893:C:A	2	2	4	0	4	2.0	0.0	2.0
chr17:76481609:C:T	8	5	13	3	10	2.0	0.0	2.0
chr17:76567571:A:G	0	0	0	0	0	0	0	0
chr17:76585832:C:G	0	0	0	0	0	0	0	0
chr17:76585863:AA:GC	0	0	0	0	0	0	0	0
chr17:76688319:T:C	0	0	0	0	0	0	0	0
chr17:76882177:G:A	0	0	0	0	0	0	0	0
chr17:76882338:C:T	0	0	0	0	0	0	0	0
chr17:76940494:G:A	0	0	0	0	0	0	0	0
chr17:77194880:C:T	47	22	70	26	44	1	1	0
chr17:77211884:A:G	0	0	0	0	0	0	0	0
chr17:78118020:G:A	23	6	29	17	12	1	1	0
chr17:78119220:G:A	12	9	21	3	18	2.0	0.0	2.0
chr17:78125783:A:G	123	51	180	72	108	1	1	0
chr17:78132279:G:A	17	10	27	7	20	2	0	2
chr17:78134494:A:T	83	39	124	46	78	1	1	0
chr17:78134989:G:A	87	42	130	46	84	1	1	0
chr17:78234648:T:C	0	0	0	0	0	0	0	0
chr17:78453423:G:C	0	0	0	0	0	0	0	0
chr17:78459183:C:T	0	0	0	0	0	0	0	0
chr17:78459935:C:G	0	0	0	0	0	0	0	0
chr17:78498968:C:T	0	0	0	0	0	0	0	0
chr17:78500410:A:G	0	0	0	0	0	0	0	0
chr17:78500495:C:T	0	0	0	0	0	0	0	0
chr17:78501838:C:A	0	0	0	0	0	0	0	0
chr17:78502610:C:T	0	0	0	0	0	0	0	0
chr17:78502762:A:G	0	0	0	0	0	0	0	0
chr17:78510583:T:C	0	0	0	0	0	0	0	0
chr17:78526702:G:A	0	0	0	0	0	0	0	0
chr17:78529483:A:G	0	0	0	0	0	0	0	0
chr17:78532509:C:T	0	0	0	0	0	0	0	0
chr17:78532708:A:G	0	0	0	0	0	0	0	0
chr17:78539866:T:C	0	0	0	0	0	0	0	0
chr17:78551552:T:C	0	0	0	0	0	0	0	0
chr17:78803713:G:A	95	54	153	43	110	2	0	2
chr17:78803778:T:C	90	51	141	41	100	2.0	0.0	2.0
chr17:78803816:A:G	90	51	145	41	104	2.0	0.0	2.0
chr17:78836051:T:C	19	5	24	14	10	1	1	0
chr17:78891350:C:A	3	3	6	0	6	2	0	2
chr17:79094391:A:G	0	0	0	0	0	0	0	0
chr17:79094430:G:C	0	0	0	0	0	0	0	0
chr17:79731150:C:T	0	0	0	0	0	0	0	0
chr17:79731283:C:T	0	0	0	0	0	0	0	0
chr17:79735540:C:G	0	0	0	0	0	0	0	0
chr17:79735606:C:T	0	0	0	0	0	0	0	0
chr17:79784685:G:A	0	0	0	0	0	0	0	0
chr17:80047415:T:C	0	0	0	0	0	0	0	0
chr17:80049923:C:T	0	0	0	0	0	0	0	0
chr17:80081959:T:G	0	0	0	0	0	0	0	0
chr17:80086090:G:A	0	0	0	0	0	0	0	0
chr17:80088180:A:C	0	0	0	0	0	0	0	0
chr17:80090585:C:T	0	0	0	0	0	0	0	0
chr17:80097448:A:G	0	0	0	0	0	0	0	0
chr17:80099556:A:G	0	0	0	0	0	0	0	0
chr17:80099790:T:C	0	0	0	0	0	0	0	0
chr17:80105844:C:T	9	4	13	5	8	1	1	0
chr17:80107862:A:T	7	4	11	3	8	2	0	2
chr17:80109992:C:T	7	4	11	3	8	2	0	2
chr17:80113310:A:G	9	5	14	4	10	2	0	2
chr17:80119422:G:A	19	13	32	6	26	2	0	2
chr17:80140234:G:A	0	0	0	0	0	0	0	0
chr17:80184196:G:A	0	0	0	0	0	0	0	0
chr17:80188371:G:A	0	0	0	0	0	0	0	0
chr17:80192586:C:T	0	0	0	0	0	0	0	0
chr17:80198145:G:C	0	0	0	0	0	0	0	0
chr17:80198493:G:A	0	0	0	0	0	0	0	0
chr17:80205117:C:T	0	0	0	0	0	0	0	0
chr17:80209604:G:C	20	9	29	11	18	1.0	1.0	0.0
chr17:80209612:T:C	20	9	29	11	18	1.0	1.0	0.0
chr17:80210594:C:T	12	6	18	6	12	1.5	0.5	1.0
chr17:80211757:G:A	6	2	8	4	4	1.0	1.0	0.0
chr17:80211843:G:A	6	2	8	4	4	1.0	1.0	0.0
chr17:80214155:A:G	1	0	1	1	0	1	1	0
chr17:80298494:C:T	20	10	30	10	20	1.5	0.5	1.0
chr17:80332071:G:A	10	6	16	4	12	2.0	0.0	2.0
chr17:80332302:G:C	13	9	22	4	18	2	0	2
chr17:80332480:A:G	15	10	25	5	20	2	0	2
chr17:80332508:C:G	16	11	26	5	21	2.0	0.0	2.0
chr17:80334336:G:A	1	0	1	1	0	1	1	0
chr17:80337560:C:T	8	5	13	3	10	2.0	0.0	2.0
chr17:80337708:G:A	8	5	13	3	10	2.0	0.0	2.0
chr17:80345336:G:A	1	0	1	1	0	1	1	0
chr17:80345580:G:C	0	0	0	0	0	0	0	0
chr17:80353558:G:A	4	1	5	3	2	1.0	1.0	0.0
chr17:80360040:T:C	3	2	5	1	4	2	0	2
chr17:80380861:C:T	29	12	41	17	24	1	1	0
chr17:80470858:T:G	0	0	0	0	0	0	0	0
chr17:80471902:A:G	0	0	0	0	0	0	0	0
chr17:80880423:A:G	4	2	6	2	4	1.5	0.5	1.0
chr17:80891746:T:C	3	3	6	0	6	2	0	2
chr17:80923761:C:T	0	0	0	0	0	0	0	0
chr17:80923787:A:G	0	0	0	0	0	0	0	0
chr17:80940445:G:T	1	1	2	0	2	2	0	2
chr17:80945587:G:A	3	2	5	1	4	2	0	2
chr17:80945758:C:T	4	3	7	1	6	2.0	0.0	2.0
chr17:81115734:C:T	0	0	0	0	0	0	0	0
chr17:81182003:A:G	0	0	0	0	0	0	0	0
chr17:81189849:G:A	2	0	2	2	0	1.0	1.0	0.0
chr17:81190688:C:T	6	3	9	3	6	1.5	0.5	1.0
chr17:81195870:C:T	5	2	7	3	4	1	1	0
chr17:81196776:C:T	5	3	8	2	6	2	0	2
chr17:81199598:A:G	0	0	0	0	0	0	0	0
chr17:81199662:C:T	0	0	0	0	0	0	0	0
chr17:81208978:T:C	6	3	9	3	6	1.5	0.5	1.0
chr17:81229156:T:C	41	18	61	23	38	1	1	0
chr17:81231936:G:A	28	15	43	13	30	2.0	0.0	2.0
chr17:81236907:G:A	1	0	1	1	0	1	1	0
chr17:81246216:T:C	70	33	103	37	66	1.0	1.0	0.0
chr17:81246424:G:C	66	34	100	32	68	2.0	0.0	2.0
chr17:81252562:G:A	46	22	68	24	44	1.0	1.0	0.0
chr17:81271002:T:C	46	18	64	28	36	1.0	1.0	0.0
chr17:81451744:C:T	0	0	0	0	0	0	0	0
chr17:81457490:A:G	0	0	0	0	0	0	0	0
chr17:81459455:A:G	0	0	0	0	0	0	0	0
chr17:81462826:C:T	0	0	0	0	0	0	0	0
chr17:81511459:A:G	3084	2089	11535	3886	7649	2.0	1.0	2.0
chr17:81528493:C:T	1	1	2	0	2	2	0	2
chr17:81528864:C:T	1	1	2	0	2	2	0	2
chr17:81547103:G:A	17	9	26	8	18	2	0	2
chr17:81613431:C:A	205	163	379	45	334	2	0	2
chr17:81629785:C:T	321	80	419	258	161	1	1	0
chr17:81642384:G:T	1	0	1	1	0	1	1	0
chr17:81645135:C:T	1	0	1	1	0	1	1	0
chr17:81645307:G:A	1	0	1	1	0	1	1	0
chr17:81645607:T:C	1	1	2	0	2	2	0	2
chr17:81651029:C:T	39	17	56	22	34	1	1	0
chr17:81665333:C:T	362	187	572	190	382	2.0	1.0	2.0
chr17:81670337:C:G	109	51	166	60	106	1	1	0
chr17:81671605:GCG:ACA	12	9	21	3	18	2.0	0.0	2.0
chr17:81672520:G:A	40	20	62	20	42	1.5	0.5	1.0
chr17:81672678:C:T	40	20	62	20	42	1.5	0.5	1.0
chr17:81682274:A:G	151	58	217	99	118	1	1	0
chr17:81683151:A:G	14	7	22	8	14	2.0	0.5	1.0
chr17:81683645:C:G	37	25	63	13	50	2	0	2
chr17:81683798:T:G	5	3	8	2	6	2	0	2
chr17:81686281:T:C	18	10	28	8	20	2.0	0.0	2.0
chr17:81686291:T:C	18	10	28	8	20	2.0	0.0	2.0
chr17:81690810:A:G	3	1	4	2	2	1	1	0
chr17:81691382:T:G	4	1	5	3	2	1.0	1.0	0.0
chr17:81695037:A:G	26	8	34	18	16	1.0	1.0	0.0
chr17:81695719:C:T	0	0	0	0	0	0	0	0
chr17:81696850:T:C	45	19	64	26	38	1	1	0
chr17:81696901:T:C	51	22	73	29	44	1	1	0
chr17:81701105:G:T	93	43	138	50	88	1	1	0
chr17:81701522:C:T	100	44	145	57	88	1.0	1.0	0.0
chr17:81701634:C:T	109	51	161	59	102	1	1	0
chr17:81704684:T:C	292	141	467	174	293	1.0	1.0	0.0
chr17:81715528:T:C	3	0	3	3	0	1	1	0
chr17:81720188:G:A	1	0	1	1	0	1	1	0
chr17:81809839:G:A	0	0	0	0	0	0	0	0
chr17:81811293:C:G	1	1	2	0	2	2	0	2
chr17:81855428:A:G	2	1	3	1	2	1.5	0.5	1.0
chr17:81909572:G:A	101	50	153	53	100	2	1	0
chr17:82015025:C:T	0	0	0	0	0	0	0	0
chr17:82016855:T:C	113	50	174	70	104	1	1	0
chr17:82022880:C:A	287	140	445	155	290	2	1	0
chr17:82050011:A:G	3	2	5	1	4	2	0	2
chr17:82050021:G:T	3	2	5	1	4	2	0	2
chr17:82050516:G:T	4	4	8	0	8	2.0	0.0	2.0
chr17:82056985:T:G	11	5	16	6	10	1	1	0
chr17:82059847:G:A	0	0	0	0	0	0	0	0
chr17:82060838:C:T	0	0	0	0	0	0	0	0
chr17:82063098:C:T	0	0	0	0	0	0	0	0
chr17:82315358:C:T	0	0	0	0	0	0	0	0
chr17:82322989:G:A	4	1	5	3	2	1.0	1.0	0.0
chr17:82362113:C:G	0	0	0	0	0	0	0	0
chr17:82362127:C:G	0	0	0	0	0	0	0	0
chr17:82362685:G:A	0	0	0	0	0	0	0	0
chr17:82392455:G:A	140	70	218	74	144	2.0	1.0	1.0
chr17:82415576:C:T	145	74	226	74	152	2	1	2
chr17:82433808:A:G	47	28	75	19	56	2	0	2
chr17:82444420:G:A	10	6	16	4	12	2.0	0.0	2.0
chr17:82627218:C:T	95	39	135	57	78	1	1	0
chr17:82752221:G:T	11	9	20	2	18	2	0	2
chr17:82905981:T:C	11	8	19	3	16	2	0	2
chr17:82929575:A:G	2	1	3	1	2	1.5	0.5	1.0
chr17:82932762:T:C	2	0	2	2	0	1.0	1.0	0.0
chr17:82941405:G:A	28	7	36	22	14	1.0	1.0	0.0
chr17:82965660:C:T	14	6	20	8	12	1.0	1.0	0.0
chr18:49034:G:A	0	0	0	0	0	0	0	0
chr18:658170:G:T	0	0	0	0	0	0	0	0
chr18:672792:C:T	0	0	0	0	0	0	0	0
chr18:672836:A:G	0	0	0	0	0	0	0	0
chr18:673016:C:T	0	0	0	0	0	0	0	0
chr18:907563:CCT:ACC	0	0	0	0	0	0	0	0
chr18:908228:A:T	0	0	0	0	0	0	0	0
chr18:909560:A:G	0	0	0	0	0	0	0	0
chr18:2547481:T:C	11	6	17	5	12	2	0	2
chr18:2656249:G:C	1191	682	2167	686	1481	2	1	2
chr18:2913433:T:C	18	7	25	11	14	1.0	1.0	0.0
chr18:2920290:G:A	0	0	0	0	0	0	0	0
chr18:2945560:C:T	2	1	3	1	2	1.5	0.5	1.0
chr18:2951059:C:T	6	3	9	3	6	1.5	0.5	1.0
chr18:3164387:C:T	3	1	4	2	2	1	1	0
chr18:3168818:G:A	3	1	4	2	2	1	1	0
chr18:3173966:G:A	2	0	2	2	0	1.0	1.0	0.0
chr18:3188859:A:G	3	1	4	2	2	1	1	0
chr18:3188875:G:A	3	1	4	2	2	1	1	0
chr18:3580487:G:T	0	0	0	0	0	0	0	0
chr18:3581968:G:A	2	2	4	0	4	2.0	0.0	2.0
chr18:3656058:T:C	3	3	6	0	6	2	0	2
chr18:5891638:C:A	0	0	0	0	0	0	0	0
chr18:6889974:A:G	0	0	0	0	0	0	0	0
chr18:6890435:A:G	0	0	0	0	0	0	0	0
chr18:6943265:G:A	0	0	0	0	0	0	0	0
chr18:6986228:G:A	0	0	0	0	0	0	0	0
chr18:7008592:T:C	0	0	0	0	0	0	0	0
chr18:7011414:G:A	0	0	0	0	0	0	0	0
chr18:7012124:A:G	0	0	0	0	0	0	0	0
chr18:7034509:T:G	0	0	0	0	0	0	0	0
chr18:8783837:T:C	1	1	2	0	2	2	0	2
chr18:10471735:G:A	1	1	2	0	2	2	0	2
chr18:10471767:C:T	1	1	2	0	2	2	0	2
chr18:10471776:C:G	1	1	2	0	2	2	0	2
chr18:10487921:C:T	0	0	0	0	0	0	0	0
chr18:10488067:C:T	0	0	0	0	0	0	0	0
chr18:10488094:G:T	0	0	0	0	0	0	0	0
chr18:10539742:A:G	2	0	2	2	0	1.0	1.0	0.0
chr18:10540435:A:C	5	1	6	4	2	1	1	0
chr18:10672695:G:A	0	0	0	0	0	0	0	0
chr18:10741013:G:A	0	0	0	0	0	0	0	0
chr18:10758025:G:A	0	0	0	0	0	0	0	0
chr18:10759842:C:A	0	0	0	0	0	0	0	0
chr18:10762964:G:A	0	0	0	0	0	0	0	0
chr18:10763009:T:C	0	0	0	0	0	0	0	0
chr18:10807169:C:T	0	0	0	0	0	0	0	0
chr18:11610333:G:T	0	0	0	0	0	0	0	0
chr18:11610350:G:A	0	0	0	0	0	0	0	0
chr18:11610383:C:A	0	0	0	0	0	0	0	0
chr18:11644537:A:T	0	0	0	0	0	0	0	0
chr18:11644565:G:A	0	0	0	0	0	0	0	0
chr18:11851481:C:A	210	92	307	120	187	1.0	1.0	0.0
chr18:12254786:G:C	0	0	0	0	0	0	0	0
chr18:12254817:A:G	0	0	0	0	0	0	0	0
chr18:12274105:G:T	0	0	0	0	0	0	0	0
chr18:12329537:C:G	35	9	45	27	18	1	1	0
chr18:12348286:T:C	29	21	50	8	42	2	0	2
chr18:12351343:C:T	25	19	44	6	38	2	0	2
chr18:12984145:C:A	32	16	49	17	32	1.5	1.0	1.0
chr18:13056334:C:T	2	1	3	1	2	1.5	0.5	1.0
chr18:13681963:A:T	45	29	74	16	58	2	0	2
chr18:13825728:A:C	0	0	0	0	0	0	0	0
chr18:13826089:C:T	0	0	0	0	0	0	0	0
chr18:13826392:C:G	0	0	0	0	0	0	0	0
chr18:13826509:C:T	0	0	0	0	0	0	0	0
chr18:14183721:C:T	5	5	10	0	10	2	0	2
chr18:14183735:A:G	5	0	5	5	0	1	1	0
chr18:14183748:T:C	5	0	5	5	0	1	1	0
chr18:14222101:G:C	1	0	1	1	0	1	1	0
chr18:14542891:G:C	0	0	0	0	0	0	0	0
chr18:14542932:C:T	0	0	0	0	0	0	0	0
chr18:14542950:T:C	0	0	0	0	0	0	0	0
chr18:14543058:T:G	0	0	0	0	0	0	0	0
chr18:14613455:T:G	0	0	0	0	0	0	0	0
chr18:21454595:T:C	0	0	0	0	0	0	0	0
chr18:21574182:G:A	88	50	144	38	106	2.0	0.0	2.0
chr18:22200895:G:A	0	0	0	0	0	0	0	0
chr18:22415790:T:C	0	0	0	0	0	0	0	0
chr18:22416048:G:A	0	0	0	0	0	0	0	0
chr18:23373756:G:A	16	8	24	8	16	1.5	0.5	1.0
chr18:23538663:G:A	2	1	3	1	2	1.5	0.5	1.0
chr18:24477006:A:G	0	0	0	0	0	0	0	0
chr18:26285904:A:G	1	1	2	0	2	2	0	2
chr18:26547349:C:T	0	0	0	0	0	0	0	0
chr18:26862092:A:G	0	0	0	0	0	0	0	0
chr18:26865728:C:T	0	0	0	0	0	0	0	0
chr18:27963423:G:A	0	0	0	0	0	0	0	0
chr18:31355412:C:T	0	0	0	0	0	0	0	0
chr18:32208144:G:A	0	0	0	0	0	0	0	0
chr18:32513759:A:C	0	0	0	0	0	0	0	0
chr18:33370050:C:T	0	0	0	0	0	0	0	0
chr18:34890327:G:A	0	0	0	0	0	0	0	0
chr18:34890495:C:T	0	0	0	0	0	0	0	0
chr18:35972635:C:T	17	13	30	4	26	2	0	2
chr18:35977503:A:G	127	63	198	70	128	2	1	0
chr18:36652647:C:T	0	0	0	0	0	0	0	0
chr18:39335564:T:C	0	0	0	0	0	0	0	0
chr18:44952641:G:A	25	14	39	11	28	2	0	2
chr18:44952728:C:A	26	12	38	14	24	1.0	1.0	0.0
chr18:45682394:G:A	0	0	0	0	0	0	0	0
chr18:45682536:C:T	0	0	0	0	0	0	0	0
chr18:45682567:C:A	0	0	0	0	0	0	0	0
chr18:45901110:G:A	4	1	5	3	2	1.0	1.0	0.0
chr18:45917745:A:G	0	0	0	0	0	0	0	0
chr18:46072237:G:A	61	30	96	33	63	1	1	0
chr18:46086986:C:A	4	2	6	2	4	1.5	0.5	1.0
chr18:46087562:T:C	1	0	1	1	0	1	1	0
chr18:46098058:G:A	16	4	21	13	8	1.0	1.0	0.0
chr18:46098069:T:C	16	4	21	13	8	1.0	1.0	0.0
chr18:46118343:C:T	2	1	3	1	2	1.5	0.5	1.0
chr18:46546946:T:C	0	0	0	0	0	0	0	0
chr18:46692071:A:C	1	0	1	1	0	1	1	0
chr18:47084347:T:C	7	6	13	1	12	2	0	2
chr18:48758216:T:C	1	1	2	0	2	2	0	2
chr18:48859577:A:G	1	0	1	1	0	1	1	0
chr18:49491450:A:G	64	38	101	26	75	2.0	0.0	2.0
chr18:49849733:C:G	0	0	0	0	0	0	0	0
chr18:49902652:C:T	0	0	0	0	0	0	0	0
chr18:49929553:C:T	0	0	0	0	0	0	0	0
chr18:49984743:C:A	0	0	0	0	0	0	0	0
chr18:50250874:C:T	3	2	5	1	4	2	0	2
chr18:50273809:G:C	45	22	68	25	43	1	1	0
chr18:50275430:G:A	0	0	0	0	0	0	0	0
chr18:50283501:G:T	16	9	25	7	18	2.0	0.0	2.0
chr18:50283981:A:G	75	36	111	39	72	1	1	0
chr18:50285004:G:A	75	37	112	38	74	1	1	0
chr18:50663901:T:G	0	0	0	0	0	0	0	0
chr18:50801445:G:A	5	1	6	4	2	1	1	0
chr18:52906232:C:G	0	0	0	0	0	0	0	0
chr18:54269477:G:T	46	27	78	20	58	2.0	0.0	2.0
chr18:54294435:G:A	18	8	26	10	16	1.0	1.0	0.0
chr18:54598077:A:C	0	0	0	0	0	0	0	0
chr18:56781547:G:A	9	7	16	2	14	2	0	2
chr18:57027221:C:T	3	3	6	0	6	2	0	2
chr18:57147794:G:T	0	0	0	0	0	0	0	0
chr18:57476534:C:T	0	0	0	0	0	0	0	0
chr18:57554416:T:C	16	11	27	5	22	2.0	0.0	2.0
chr18:57559151:G:C	15	11	26	4	22	2	0	2
chr18:57602545:G:A	30	13	42	17	25	1.0	1.0	0.0
chr18:57616004:T:C	7	4	11	3	8	2	0	2
chr18:57621844:C:T	16	8	24	8	16	1.5	0.5	1.0
chr18:57655270:C:T	13	5	18	8	10	1	1	0
chr18:58529219:C:T	0	0	0	0	0	0	0	0
chr18:58534999:T:C	0	0	0	0	0	0	0	0
chr18:58535536:C:A	0	0	0	0	0	0	0	0
chr18:58535750:A:T	0	0	0	0	0	0	0	0
chr18:58535842:G:A	0	0	0	0	0	0	0	0
chr18:58535888:C:T	0	0	0	0	0	0	0	0
chr18:58536215:A:G	0	0	0	0	0	0	0	0
chr18:58536605:G:A	0	0	0	0	0	0	0	0
chr18:58536659:G:T	0	0	0	0	0	0	0	0
chr18:58536666:T:G	0	0	0	0	0	0	0	0
chr18:58537018:A:C	0	0	0	0	0	0	0	0
chr18:58537178:C:T	0	0	0	0	0	0	0	0
chr18:58537439:A:T	0	0	0	0	0	0	0	0
chr18:58537536:G:A	0	0	0	0	0	0	0	0
chr18:58537759:C:T	0	0	0	0	0	0	0	0
chr18:58538030:A:C	0	0	0	0	0	0	0	0
chr18:58538249:G:A	0	0	0	0	0	0	0	0
chr18:58579210:T:C	0	0	0	0	0	0	0	0
chr18:59220275:C:A	0	0	0	0	0	0	0	0
chr18:59355522:T:C	460	228	725	251	474	2.0	1.0	0.0
chr18:59359204:C:T	459	242	732	242	490	2	1	2
chr18:62287430:G:A	6	2	8	4	4	1.0	1.0	0.0
chr18:62354528:C:T	0	0	0	0	0	0	0	0
chr18:62570155:A:G	4	2	6	2	4	1.5	0.5	1.0
chr18:62895065:A:T	0	0	0	0	0	0	0	0
chr18:63597064:G:A	0	0	0	0	0	0	0	0
chr18:63597234:C:T	0	0	0	0	0	0	0	0
chr18:63643140:C:T	0	0	0	0	0	0	0	0
chr18:63655615:G:C	0	0	0	0	0	0	0	0
chr18:63655778:C:G	0	0	0	0	0	0	0	0
chr18:63723127:T:C	0	0	0	0	0	0	0	0
chr18:63723336:T:G	0	0	0	0	0	0	0	0
chr18:63897160:A:G	0	0	0	0	0	0	0	0
chr18:63915517:T:G	0	0	0	0	0	0	0	0
chr18:63915633:A:G	0	0	0	0	0	0	0	0
chr18:63918026:T:C	0	0	0	0	0	0	0	0
chr18:63933150:C:T	0	0	0	0	0	0	0	0
chr18:63979835:G:A	100	49	154	55	99	1.5	1.0	0.0
chr18:63986336:C:G	12	5	17	7	10	1.0	1.0	0.0
chr18:63987229:A:G	57	32	95	25	70	2	0	2
chr18:68837114:G:A	5	2	7	3	4	1	1	0
chr18:69677798:T:C	0	0	0	0	0	0	0	0
chr18:70020753:G:A	3	2	5	1	4	2	0	2
chr18:70051452:A:G	1	0	1	1	0	1	1	0
chr18:70166070:T:C	6	2	8	4	4	1.0	1.0	0.0
chr18:70204107:A:C	35	23	63	13	50	2	0	2
chr18:74499889:C:G	80	48	130	32	98	2.0	0.0	2.0
chr18:74501251:T:C	4	2	6	2	4	1.5	0.5	1.0
chr18:74501373:G:A	114	61	177	53	124	2.0	0.0	2.0
chr18:74508848:T:C	101	53	157	49	108	2	0	2
chr18:74510926:T:C	94	51	148	44	104	2.0	0.0	2.0
chr18:74511065:G:T	5	2	7	3	4	1	1	0
chr18:74516460:T:A	15	11	26	4	22	2	0	2
chr18:74567400:C:T	0	0	0	0	0	0	0	0
chr18:74635526:T:C	2	2	4	0	4	2.0	0.0	2.0
chr18:75202325:G:A	56	30	86	26	60	2.0	0.0	2.0
chr18:75286944:G:A	1	0	1	1	0	1	1	0
chr18:76379762:G:A	2	1	3	1	2	1.5	0.5	1.0
chr18:78993588:A:G	0	0	0	0	0	0	0	0
chr18:78993768:C:G	0	0	0	0	0	0	0	0
chr18:78994226:G:A	0	0	0	0	0	0	0	0
chr18:78994466:C:T	0	0	0	0	0	0	0	0
chr18:78994871:G:T	0	0	0	0	0	0	0	0
chr18:79372793:G:A	1	0	1	1	0	1	1	0
chr18:79410477:C:A	88	54	145	34	111	2.0	0.0	2.0
chr18:79411061:T:G	87	51	141	36	105	2	0	2
chr18:79451764:T:C	113	41	157	75	82	1	1	0
chr18:79461264:C:T	5	1	6	4	2	1	1	0
chr18:79461278:G:A	5	1	6	4	2	1	1	0
chr18:79486406:T:G	13	7	20	6	14	2	0	2
chr18:79713086:G:A	2	1	3	1	2	1.5	0.5	1.0
chr18:79713127:C:T	2	1	3	1	2	1.5	0.5	1.0
chr18:79714921:G:A	2	1	3	1	2	1.5	0.5	1.0
chr18:79753841:G:A	31	20	53	11	42	2	0	2
chr18:79903940:G:A	21	9	30	12	18	1	1	0
chr18:79943476:A:G	0	0	0	0	0	0	0	0
chr18:80045856:A:C	112	64	184	52	132	2.0	0.0	2.0
chr18:80045949:A:C	109	48	165	67	98	1	1	0
chr18:80135800:A:G	3	1	4	2	2	1	1	0
chr18:80137309:G:A	3	2	5	1	4	2	0	2
chr19:281383:C:T	0	0	0	0	0	0	0	0
chr19:374016:G:A	0	0	0	0	0	0	0	0
chr19:374492:G:C	0	0	0	0	0	0	0	0
chr19:425182:G:A	0	0	0	0	0	0	0	0
chr19:498524:A:G	0	0	0	0	0	0	0	0
chr19:501786:C:A	0	0	0	0	0	0	0	0
chr19:501801:AG:CC	0	0	0	0	0	0	0	0
chr19:501900:C:A	0	0	0	0	0	0	0	0
chr19:504830:C:G	0	0	0	0	0	0	0	0
chr19:507450:G:T	2	1	3	1	2	1.5	0.5	1.0
chr19:541685:C:T	21	13	34	8	26	2	0	2
chr19:549678:A:G	4	1	5	3	2	1.0	1.0	0.0
chr19:603634:T:C	0	0	0	0	0	0	0	0
chr19:603769:T:C	0	0	0	0	0	0	0	0
chr19:603826:C:T	0	0	0	0	0	0	0	0
chr19:603874:C:T	0	0	0	0	0	0	0	0
chr19:613307:C:T	0	0	0	0	0	0	0	0
chr19:619021:G:C	17	7	24	10	14	1	1	0
chr19:621712:A:G	5	3	8	2	6	2	0	2
chr19:625198:A:G	5	5	10	0	10	2	0	2
chr19:652238:A:G	526	247	824	312	512	1.0	1.0	0.0
chr19:652816:G:A	29	11	40	18	22	1	1	0
chr19:731144:A:G	0	0	0	0	0	0	0	0
chr19:746712:C:T	0	0	0	0	0	0	0	0
chr19:756985:T:G	0	0	0	0	0	0	0	0
chr19:757399:A:C	0	0	0	0	0	0	0	0
chr19:757412:A:G	0	0	0	0	0	0	0	0
chr19:757606:T:C	0	0	0	0	0	0	0	0
chr19:757752:G:A	0	0	0	0	0	0	0	0
chr19:805441:G:C	15	8	23	7	16	2	0	2
chr19:829568:C:T	0	0	0	0	0	0	0	0
chr19:830854:T:C	0	0	0	0	0	0	0	0
chr19:855966:C:A	0	0	0	0	0	0	0	0
chr19:868115:C:T	162	91	259	73	186	2.0	0.0	2.0
chr19:868276:G:A	152	89	247	65	182	2.0	0.0	2.0
chr19:871135:A:G	134	86	225	50	175	2.0	0.0	2.0
chr19:871222:G:A	132	48	183	87	96	1.0	1.0	0.0
chr19:872089:A:G	59	17	76	42	34	1	1	0
chr19:875389:G:A	41	29	70	12	58	2	0	2
chr19:890165:G:A	68	57	125	12	113	2.0	0.0	2.0
chr19:899444:C:T	481	237	750	268	482	1	1	0
chr19:971933:A:G	57	31	91	26	65	2	0	2
chr19:990185:G:C	6	2	7	4	3	1.0	1.0	0.0
chr19:990819:G:A	5	3	8	2	6	2	0	2
chr19:1003173:C:T	0	0	0	0	0	0	0	0
chr19:1004711:C:T	0	0	0	0	0	0	0	0
chr19:1004725:A:G	0	0	0	0	0	0	0	0
chr19:1004741:T:C	0	0	0	0	0	0	0	0
chr19:1004824:G:A	0	0	0	0	0	0	0	0
chr19:1004845:T:C	0	0	0	0	0	0	0	0
chr19:1005231:C:T	0	0	0	0	0	0	0	0
chr19:1005532:G:C	0	0	0	0	0	0	0	0
chr19:1011216:G:A	99	56	157	45	112	2	0	2
chr19:1011857:C:A	5	3	8	2	6	2	0	2
chr19:1012380:CGT:GGC	123	54	179	71	108	1	1	0
chr19:1012417:G:A	123	58	183	67	116	1	1	0
chr19:1014399:A:G	193	94	292	103	189	1	1	0
chr19:1032703:C:T	58	22	82	38	44	1.0	1.0	0.0
chr19:1036445:G:A	498	227	770	294	476	1.0	1.0	0.0
chr19:1049306:C:A	6	3	9	3	6	1.5	0.5	1.0
chr19:1067423:A:G	70	37	107	33	74	2.0	0.0	2.0
chr19:1077937:C:T	69	34	104	36	68	1	1	0
chr19:1085994:G:A	202	101	312	110	202	2.0	1.0	1.0
chr19:1095337:C:T	503	270	824	258	566	2	0	2
chr19:1109214:A:G	1	1	2	0	2	2	0	2
chr19:1110830:G:A	2	0	2	2	0	1.0	1.0	0.0
chr19:1113702:G:A	0	0	0	0	0	0	0	0
chr19:1119020:C:T	0	0	0	0	0	0	0	0
chr19:1119964:A:G	1	1	2	0	2	2	0	2
chr19:1122148:G:A	3	1	4	2	2	1	1	0
chr19:1122202:G:A	3	1	4	2	2	1	1	0
chr19:1299956:G:A	0	0	0	0	0	0	0	0
chr19:1388539:C:T	768	414	1301	407	894	2.0	1.0	2.0
chr19:1434843:C:T	209	94	313	123	190	1	1	0
chr19:1438866:C:T	4616	2664	21399	12830	8569	4.0	2.0	2.0
chr19:1458178:G:A	11	4	16	8	8	1	1	0
chr19:1495635:G:A	1	0	1	1	0	1	1	0
chr19:1526932:A:C	0	0	0	0	0	0	0	0
chr19:1535180:G:A	0	0	0	0	0	0	0	0
chr19:1622117:G:A	30	19	49	11	38	2.0	0.0	2.0
chr19:1811604:C:T	1	0	1	1	0	1	1	0
chr19:1819126:T:C	19	8	27	11	16	1	1	0
chr19:1854558:A:G	5	5	10	0	10	2	0	2
chr19:1880951:T:C	0	0	0	0	0	0	0	0
chr19:1986415:G:A	36	19	55	17	38	2.0	0.0	2.0
chr19:1986456:A:G	33	18	51	15	36	2	0	2
chr19:1987280:C:T	3	3	6	0	6	2	0	2
chr19:1990826:G:A	2	1	3	1	2	1.5	0.5	1.0
chr19:1997364:A:G	16	12	30	4	26	2.0	0.0	2.0
chr19:2039728:C:T	34	15	49	19	30	1.0	1.0	0.0
chr19:2041033:T:C	4	2	6	2	4	1.5	0.5	1.0
chr19:2078222:G:C	49	24	74	26	48	2	1	0
chr19:2097987:T:C	53	35	88	18	70	2	0	2
chr19:2098016:T:C	54	36	90	18	72	2.0	0.0	2.0
chr19:2099251:G:A	88	34	133	65	68	1.0	1.0	0.0
chr19:2099363:C:T	180	89	285	97	188	1.5	1.0	0.0
chr19:2226677:G:A	5	4	9	1	8	2	0	2
chr19:2249478:G:T	0	0	0	0	0	0	0	0
chr19:2250470:G:A	0	0	0	0	0	0	0	0
chr19:2250529:G:A	0	0	0	0	0	0	0	0
chr19:2252991:C:G	11	0	11	11	0	1	1	0
chr19:2271283:T:C	27	10	37	17	20	1	1	0
chr19:2271324:A:G	28	10	38	18	20	1.0	1.0	0.0
chr19:2271742:G:A	53	24	78	30	48	1	1	0
chr19:2339959:T:C	22	10	32	12	20	1.0	1.0	0.0
chr19:2341061:GT:AC	21	9	30	12	18	1	1	0
chr19:2343144:G:A	1	0	1	1	0	1	1	0
chr19:2353152:C:A	25	13	39	13	26	2	0	2
chr19:2433892:A:G	1	0	1	1	0	1	1	0
chr19:2477279:C:T	642	341	1118	373	745	2.0	1.0	2.0
chr19:2477318:G:A	642	332	1118	375	743	2.0	1.0	2.0
chr19:2717258:C:G	0	0	0	0	0	0	0	0
chr19:2732743:G:A	137	63	202	74	128	1	1	0
chr19:2732988:T:C	136	63	201	73	128	1.0	1.0	0.0
chr19:2762587:A:C	97	47	144	50	94	1	1	0
chr19:2767194:G:T	155	85	242	73	169	2	0	2
chr19:2796023:G:A	1	0	1	1	0	1	1	0
chr19:2810250:G:A	1	0	1	1	0	1	1	0
chr19:2833804:A:G	5	4	9	1	8	2	0	2
chr19:2833866:G:A	5	4	9	1	8	2	0	2
chr19:2834810:T:C	7	2	9	5	4	1	1	0
chr19:2853268:C:T	12	6	17	6	11	1.0	0.5	0.5
chr19:3019662:G:A	1	0	1	1	0	1	1	0
chr19:3186087:G:T	87	38	127	51	76	1	1	0
chr19:3198843:G:C	29	16	47	13	34	2	0	2
chr19:3534844:G:A	59	20	79	39	40	1	1	0
chr19:3546342:G:A	52	26	80	28	52	2.0	1.0	1.0
chr19:3595925:G:A	17	7	24	10	14	1	1	0
chr19:3730043:C:T	0	0	0	0	0	0	0	0
chr19:3738651:A:C	0	0	0	0	0	0	0	0
chr19:3738973:A:G	0	0	0	0	0	0	0	0
chr19:3752517:G:A	71	42	116	32	84	2	0	2
chr19:3753771:C:T	56	23	83	35	48	1.0	1.0	0.0
chr19:3762700:C:T	988	641	1825	429	1396	2.0	0.0	2.0
chr19:3767267:C:T	985	587	1771	495	1276	2	0	2
chr19:3771882:C:T	0	0	0	0	0	0	0	0
chr19:3831711:C:T	0	0	0	0	0	0	0	0
chr19:3977488:A:G	1469	820	2810	946	1864	2	1	2
chr19:3979410:A:G	1168	633	2155	739	1416	2.0	1.0	2.0
chr19:3980826:A:G	11	6	17	5	12	2	0	2
chr19:4028785:C:T	36	17	53	19	34	1.0	1.0	0.0
chr19:4101064:G:T	27	16	46	12	34	2	0	2
chr19:4102451:G:A	20	7	28	14	14	1.0	1.0	0.0
chr19:4174953:A:G	2	1	3	1	2	1.5	0.5	1.0
chr19:4186398:T:G	10	6	16	4	12	2.0	0.0	2.0
chr19:4325436:G:A	11	5	16	6	10	1	1	0
chr19:4328863:T:C	4	4	8	0	8	2.0	0.0	2.0
chr19:4333714:C:T	16	7	23	9	14	1.0	1.0	0.0
chr19:4352962:A:G	38	25	63	13	50	2.0	0.0	2.0
chr19:4409759:A:G	15	8	23	7	16	2	0	2
chr19:4442339:C:T	88	36	129	55	74	1.0	1.0	0.0
chr19:4454003:G:A	48	23	71	25	46	1.0	1.0	0.0
chr19:4454086:C:T	48	25	73	23	50	2.0	0.0	2.0
chr19:4493711:A:G	90	46	137	45	92	2.0	0.5	2.0
chr19:4510518:G:A	4	2	6	2	4	1.5	0.5	1.0
chr19:4510711:G:A	4	2	6	2	4	1.5	0.5	1.0
chr19:4511266:C:T	0	0	0	0	0	0	0	0
chr19:4511269:G:A	0	0	0	0	0	0	0	0
chr19:4511271:CA:TG	0	0	0	0	0	0	0	0
chr19:4511353:C:G	0	0	0	0	0	0	0	0
chr19:4511441:G:A	0	0	0	0	0	0	0	0
chr19:4511513:A:G	0	0	0	0	0	0	0	0
chr19:4511635:C:G	0	0	0	0	0	0	0	0
chr19:4511713:T:C	0	0	0	0	0	0	0	0
chr19:4511718:T:C	0	0	0	0	0	0	0	0
chr19:4511908:T:C	0	0	0	0	0	0	0	0
chr19:4512397:T:C	1	0	1	1	0	1	1	0
chr19:4512502:G:C	2	1	3	1	2	1.5	0.5	1.0
chr19:4512601:T:G	1	0	1	1	0	1	1	0
chr19:4658035:A:G	632	305	1002	368	634	2.0	1.0	0.0
chr19:4684630:A:G	0	0	0	0	0	0	0	0
chr19:4816148:A:C	54	27	80	27	53	1.0	0.5	0.5
chr19:4816707:G:A	43	23	66	20	46	2	0	2
chr19:4818366:T:C	30	14	44	16	28	1.0	1.0	0.0
chr19:4929410:C:T	0	0	0	0	0	0	0	0
chr19:4930826:G:A	0	0	0	0	0	0	0	0
chr19:4954442:C:T	0	0	0	0	0	0	0	0
chr19:6374879:G:A	916	538	1670	480	1190	2.0	0.0	2.0
chr19:6375820:G:A	1	1	2	0	2	2	0	2
chr19:6389688:A:G	1	0	1	1	0	1	1	0
chr19:6411819:C:G	0	0	0	0	0	0	0	0
chr19:6419211:T:C	7	3	10	4	6	1	1	0
chr19:6427397:G:A	3	3	6	0	6	2	0	2
chr19:6586257:G:A	59	21	90	44	46	1	1	0
chr19:6677978:G:A	0	0	0	0	0	0	0	0
chr19:6732604:T:C	7	4	11	3	8	2	0	2
chr19:6743388:A:T	0	0	0	0	0	0	0	0
chr19:6743394:A:G	0	0	0	0	0	0	0	0
chr19:6754177:T:C	7	4	11	3	8	2	0	2
chr19:6754996:T:C	21	11	32	10	22	2	0	2
chr19:6897453:C:G	0	0	0	0	0	0	0	0
chr19:6901880:G:A	0	0	0	0	0	0	0	0
chr19:6903909:A:G	0	0	0	0	0	0	0	0
chr19:6904126:C:T	0	0	0	0	0	0	0	0
chr19:6926367:T:C	19	19	40	0	40	2	0	2
chr19:7125286:G:A	0	0	0	0	0	0	0	0
chr19:7125508:G:A	0	0	0	0	0	0	0	0
chr19:7163054:G:A	0	0	0	0	0	0	0	0
chr19:7166365:C:T	0	0	0	0	0	0	0	0
chr19:7166377:G:A	0	0	0	0	0	0	0	0
chr19:7469971:G:A	7	1	8	6	2	1	1	0
chr19:7482188:A:C	9	6	15	3	12	2	0	2
chr19:7485958:G:A	40	20	61	21	40	2.0	0.5	1.0
chr19:7504396:A:G	1	0	1	1	0	1	1	0
chr19:7506104:A:G	1	0	1	1	0	1	1	0
chr19:7508212:T:A	2	0	2	2	0	1.0	1.0	0.0
chr19:7508401:C:T	2	0	2	2	0	1.0	1.0	0.0
chr19:7508411:TGTGC:CGTGT	2	0	2	2	0	1.0	1.0	0.0
chr19:7519337:A:G	0	0	0	0	0	0	0	0
chr19:7528703:C:T	31	17	49	15	34	2	0	2
chr19:7542022:G:C	23	10	33	13	20	1	1	0
chr19:7542555:C:T	2	0	2	2	0	1.0	1.0	0.0
chr19:7557340:G:A	14	8	22	6	16	2.0	0.0	2.0
chr19:7616465:G:A	2	2	4	0	4	2.0	0.0	2.0
chr19:7620957:G:A	60	26	86	34	52	1.0	1.0	0.0
chr19:7629507:G:A	69	34	103	35	68	1	1	0
chr19:7630734:T:C	84	47	131	37	94	2.0	0.0	2.0
chr19:7633434:C:T	8	8	16	0	16	2.0	0.0	2.0
chr19:7645324:A:G	0	0	0	0	0	0	0	0
chr19:7646335:T:C	303	129	446	184	262	1	1	0
chr19:7647307:G:A	32	16	48	16	32	1.5	0.5	1.0
chr19:7647539:G:C	18	11	29	7	22	2.0	0.0	2.0
chr19:7682243:G:C	1734	1056	3566	1088	2478	2.0	1.0	2.0
chr19:7682407:T:G	1738	1059	3587	1096	2491	2.0	1.0	2.0
chr19:7689308:C:T	1620	1011	3632	1091	2541	2.0	1.0	2.0
chr19:7690170:G:A	1602	867	3390	1262	2128	2.0	1.0	2.0
chr19:7690197:C:T	1599	855	3365	1279	2086	2	1	2
chr19:7731701:T:G	0	0	0	0	0	0	0	0
chr19:7766161:G:A	1	0	1	1	0	1	1	0
chr19:7766543:C:G	1	0	1	1	0	1	1	0
chr19:7768990:T:A	1	0	1	1	0	1	1	0
chr19:7769054:G:A	1	1	2	0	2	2	0	2
chr19:7769096:C:T	1	1	2	0	2	2	0	2
chr19:7849088:T:C	6	4	10	2	8	2.0	0.0	2.0
chr19:7851734:A:G	7	5	12	2	10	2	0	2
chr19:7871322:A:G	0	0	0	0	0	0	0	0
chr19:7899064:A:G	0	0	0	0	0	0	0	0
chr19:7899091:T:C	0	0	0	0	0	0	0	0
chr19:7899731:G:C	0	0	0	0	0	0	0	0
chr19:7899842:G:A	0	0	0	0	0	0	0	0
chr19:7900454:C:T	0	0	0	0	0	0	0	0
chr19:7910579:A:C	2	2	3	0	3	1.5	0.0	1.5
chr19:7921753:C:G	123	57	183	69	114	1	1	0
chr19:8056476:A:G	0	0	0	0	0	0	0	0
chr19:8073170:C:A	0	0	0	0	0	0	0	0
chr19:8081037:C:T	0	0	0	0	0	0	0	0
chr19:8090106:C:T	0	0	0	0	0	0	0	0
chr19:8094478:G:T	0	0	0	0	0	0	0	0
chr19:8094525:G:T	0	0	0	0	0	0	0	0
chr19:8096013:G:C	0	0	0	0	0	0	0	0
chr19:8103661:C:T	0	0	0	0	0	0	0	0
chr19:8111685:G:A	0	0	0	0	0	0	0	0
chr19:8111756:C:T	0	0	0	0	0	0	0	0
chr19:8112035:C:T	0	0	0	0	0	0	0	0
chr19:8126300:C:T	0	0	0	0	0	0	0	0
chr19:8131759:G:A	0	0	0	0	0	0	0	0
chr19:8133099:G:A	0	0	0	0	0	0	0	0
chr19:8147379:G:A	0	0	0	0	0	0	0	0
chr19:8250963:A:G	2	2	4	0	4	2.0	0.0	2.0
chr19:8302475:G:C	103	21	131	87	44	1	1	0
chr19:8302825:C:T	101	20	127	85	42	1	1	0
chr19:8303874:G:A	96	20	119	77	42	1.0	1.0	0.0
chr19:8303910:C:A	95	20	118	76	42	1	1	0
chr19:8305012:A:C	12	3	15	9	6	1.0	1.0	0.0
chr19:8308268:T:C	105	21	132	88	44	1	1	0
chr19:8308292:C:T	105	21	133	89	44	1	1	0
chr19:8321778:T:C	248	132	397	125	272	2.0	0.0	2.0
chr19:8322114:T:C	133	68	207	69	138	2	1	2
chr19:8322765:C:T	114	59	174	56	118	2.0	0.0	2.0
chr19:8333830:A:G	0	0	0	0	0	0	0	0
chr19:8334744:A:G	0	0	0	0	0	0	0	0
chr19:8371280:C:T	1	0	1	1	0	1	1	0
chr19:8403453:C:T	516	272	839	279	560	2.0	1.0	2.0
chr19:8403601:C:T	512	267	837	290	547	2.0	1.0	2.0
chr19:8430881:G:A	23	13	40	10	30	2	0	2
chr19:8438461:G:C	341	133	495	222	273	1	1	0
chr19:8499639:T:G	0	0	0	0	0	0	0	0
chr19:8511584:A:C	15	10	25	5	20	2	0	2
chr19:8511978:G:C	19	16	36	4	32	2	0	2
chr19:8513116:G:A	48	27	76	22	54	2.0	0.0	2.0
chr19:8513151:T:C	47	21	70	26	44	1	1	0
chr19:8513234:A:G	47	26	74	22	52	2	0	2
chr19:8513315:T:C	47	26	74	22	52	2	0	2
chr19:8514127:T:C	97	61	161	39	122	2	0	2
chr19:8554577:A:G	33	11	44	22	22	1	1	0
chr19:8586678:A:G	0	0	0	0	0	0	0	0
chr19:8592987:G:C	0	0	0	0	0	0	0	0
chr19:8605262:C:T	0	0	0	0	0	0	0	0
chr19:8731196:C:T	0	0	0	0	0	0	0	0
chr19:8935145:G:A	0	0	0	0	0	0	0	0
chr19:8938219:A:C	0	0	0	0	0	0	0	0
chr19:8939050:G:A	0	0	0	0	0	0	0	0
chr19:8946306:G:A	0	0	0	0	0	0	0	0
chr19:8947045:C:T	0	0	0	0	0	0	0	0
chr19:8948266:C:T	0	0	0	0	0	0	0	0
chr19:8948483:T:G	0	0	0	0	0	0	0	0
chr19:8948505:G:A	0	0	0	0	0	0	0	0
chr19:8948631:C:T	0	0	0	0	0	0	0	0
chr19:8949865:C:T	0	0	0	0	0	0	0	0
chr19:8949980:C:T	0	0	0	0	0	0	0	0
chr19:8950239:C:T	0	0	0	0	0	0	0	0
chr19:8950883:C:G	0	0	0	0	0	0	0	0
chr19:8951739:T:G	0	0	0	0	0	0	0	0
chr19:8953002:T:G	0	0	0	0	0	0	0	0
chr19:8953259:G:A	0	0	0	0	0	0	0	0
chr19:8954527:T:C	0	0	0	0	0	0	0	0
chr19:8954834:G:A	0	0	0	0	0	0	0	0
chr19:8954956:T:C	0	0	0	0	0	0	0	0
chr19:8955583:T:C	0	0	0	0	0	0	0	0
chr19:8957854:C:T	0	0	0	0	0	0	0	0
chr19:8959403:C:G	0	0	0	0	0	0	0	0
chr19:8961637:A:G	0	0	0	0	0	0	0	0
chr19:8962066:T:C	0	0	0	0	0	0	0	0
chr19:8964274:G:T	0	0	0	0	0	0	0	0
chr19:8964541:T:A	0	0	0	0	0	0	0	0
chr19:8964670:T:A	0	0	0	0	0	0	0	0
chr19:8964889:C:T	0	0	0	0	0	0	0	0
chr19:8964908:T:A	0	0	0	0	0	0	0	0
chr19:8964959:G:A	0	0	0	0	0	0	0	0
chr19:8965293:C:T	0	0	0	0	0	0	0	0
chr19:8965407:G:A	0	0	0	0	0	0	0	0
chr19:8966052:C:T	0	0	0	0	0	0	0	0
chr19:8966182:C:T	0	0	0	0	0	0	0	0
chr19:8966253:T:G	0	0	0	0	0	0	0	0
chr19:8966274:C:A	0	0	0	0	0	0	0	0
chr19:8966315:C:T	0	0	0	0	0	0	0	0
chr19:8966384:C:T	0	0	0	0	0	0	0	0
chr19:8966588:T:G	0	0	0	0	0	0	0	0
chr19:8966760:G:A	0	0	0	0	0	0	0	0
chr19:8967127:T:C	0	0	0	0	0	0	0	0
chr19:8969786:C:G	0	0	0	0	0	0	0	0
chr19:8971838:C:A	0	0	0	0	0	0	0	0
chr19:8972467:G:A	0	0	0	0	0	0	0	0
chr19:8972498:G:A	0	0	0	0	0	0	0	0
chr19:8973507:G:A	0	0	0	0	0	0	0	0
chr19:8973540:T:C	0	0	0	0	0	0	0	0
chr19:8973623:T:C	0	0	0	0	0	0	0	0
chr19:8975447:A:C	0	0	0	0	0	0	0	0
chr19:8978046:G:A	0	0	0	0	0	0	0	0
chr19:8979855:T:C	0	0	0	0	0	0	0	0
chr19:9093631:A:G	0	0	0	0	0	0	0	0
chr19:9102403:A:C	0	0	0	0	0	0	0	0
chr19:9102456:A:G	0	0	0	0	0	0	0	0
chr19:9214576:G:A	0	0	0	0	0	0	0	0
chr19:9324254:T:C	8	6	14	2	12	2.0	0.0	2.0
chr19:9379682:C:T	2	2	4	0	4	2.0	0.0	2.0
chr19:9381465:C:T	7	3	10	4	6	1	1	0
chr19:9381694:A:T	9	3	12	6	6	1	1	0
chr19:9413509:A:G	64	42	109	23	86	2.0	0.0	2.0
chr19:9828497:G:A	291	143	458	160	298	2	1	0
chr19:9848202:A:G	9	5	14	4	10	2	0	2
chr19:9854270:G:A	1	0	1	1	0	1	1	0
chr19:9960387:T:C	0	0	0	0	0	0	0	0
chr19:9960671:C:T	0	0	0	0	0	0	0	0
chr19:9966743:C:G	0	0	0	0	0	0	0	0
chr19:9967913:T:C	0	0	0	0	0	0	0	0
chr19:9973616:C:G	0	0	0	0	0	0	0	0
chr19:9977595:C:G	0	0	0	0	0	0	0	0
chr19:10003576:C:G	0	0	0	0	0	0	0	0
chr19:10004064:T:A	0	0	0	0	0	0	0	0
chr19:10005699:G:T	0	0	0	0	0	0	0	0
chr19:10018876:C:G	0	0	0	0	0	0	0	0
chr19:10021323:TG:CA	0	0	0	0	0	0	0	0
chr19:10113904:T:C	1	0	1	1	0	1	1	0
chr19:10156401:T:C	12	6	18	6	12	1.5	0.5	1.0
chr19:10224876:G:T	1	1	2	0	2	2	0	2
chr19:10252206:G:A	102	54	159	49	110	2.0	0.0	2.0
chr19:10259866:C:T	475	251	762	248	514	2	1	2
chr19:10284974:C:T	6	2	8	4	4	1.0	1.0	0.0
chr19:10308454:C:T	4	2	6	2	4	1.5	0.5	1.0
chr19:10333490:G:A	47	13	63	39	24	1	1	0
chr19:10334150:G:A	1	0	1	1	0	1	1	0
chr19:10339609:G:A	885	486	1489	477	1012	2	1	2
chr19:10353998:A:G	10	9	19	1	18	2.0	0.0	2.0
chr19:10354011:A:G	10	9	19	1	18	2.0	0.0	2.0
chr19:10391426:C:T	1010	518	1680	613	1067	2.0	1.0	1.0
chr19:10557707:T:C	15	7	22	8	14	1	1	0
chr19:10557997:A:G	28	14	42	14	28	1.5	0.5	1.0
chr19:10559508:C:G	27	12	39	15	24	1	1	0
chr19:10560316:C:T	35	18	54	18	36	2	0	2
chr19:10561817:C:T	54	31	86	24	62	2.0	0.0	2.0
chr19:10565667:A:T	6	4	10	2	8	2.0	0.0	2.0
chr19:10565747:G:A	53	30	83	23	60	2	0	2
chr19:10581324:T:C	0	0	0	0	0	0	0	0
chr19:10583563:A:G	0	0	0	0	0	0	0	0
chr19:10583568:C:T	0	0	0	0	0	0	0	0
chr19:10683682:T:C	48	25	73	23	50	2.0	0.0	2.0
chr19:10683954:G:T	59	30	89	29	60	2	0	2
chr19:11113505:C:T	0	0	0	0	0	0	0	0
chr19:11113589:A:G	0	0	0	0	0	0	0	0
chr19:11116926:C:T	0	0	0	0	0	0	0	0
chr19:11228912:C:A	1	0	1	1	0	1	1	0
chr19:11248123:G:A	16	10	28	6	22	2.0	0.0	2.0
chr19:11296276:A:G	0	0	0	0	0	0	0	0
chr19:11301192:C:A	1	0	1	1	0	1	1	0
chr19:11325545:A:G	5	4	9	1	8	2	0	2
chr19:11337210:C:T	9	5	14	4	10	2	0	2
chr19:11350810:G:T	226	118	352	114	238	2.0	0.0	2.0
chr19:11354857:C:T	33	14	48	20	28	1	1	0
chr19:11416083:G:A	0	0	0	0	0	0	0	0
chr19:11416089:T:G	0	0	0	0	0	0	0	0
chr19:11447460:G:A	256	128	399	137	262	2.0	1.0	1.0
chr19:11576380:C:T	281	181	498	116	382	2	0	2
chr19:11576536:C:T	277	178	491	115	376	2	0	2
chr19:11577093:G:A	278	179	489	114	375	2.0	0.0	2.0
chr19:11780188:G:A	6	5	11	1	10	2.0	0.0	2.0
chr19:11832882:G:A	4	2	6	2	4	1.5	0.5	1.0
chr19:12112046:T:C	0	0	0	0	0	0	0	0
chr19:12146097:C:T	6	3	9	3	6	1.5	0.5	1.0
chr19:12273765:T:C	47	22	69	25	44	1	1	0
chr19:12350877:C:T	3	1	4	2	2	1	1	0
chr19:12430157:T:A	6	4	10	2	8	2.0	0.0	2.0
chr19:12430400:G:T	4	3	7	1	6	2.0	0.0	2.0
chr19:12431541:A:G	1	0	1	1	0	1	1	0
chr19:12431839:TT:GA	1	0	1	1	0	1	1	0
chr19:12440975:A:C	3	0	3	3	0	1	1	0
chr19:12441081:A:T	1	0	1	1	0	1	1	0
chr19:12643315:T:C	7	3	10	4	6	1	1	0
chr19:12643323:A:G	7	3	10	4	6	1	1	0
chr19:12657577:G:A	32	14	49	19	30	1.0	1.0	0.0
chr19:12752615:G:A	0	0	0	0	0	0	0	0
chr19:12766150:G:C	4	1	5	3	2	1.0	1.0	0.0
chr19:12771250:G:A	1	0	1	1	0	1	1	0
chr19:12806947:A:T	12	5	17	7	10	1.0	1.0	0.0
chr19:12828978:T:C	0	0	0	0	0	0	0	0
chr19:12847883:T:C	2	2	4	0	4	2.0	0.0	2.0
chr19:12852329:T:C	2	2	4	0	4	2.0	0.0	2.0
chr19:12874762:A:G	1	0	1	1	0	1	1	0
chr19:12891570:T:C	15	8	23	7	16	2	0	2
chr19:12891749:T:G	15	8	23	7	16	2	0	2
chr19:12897450:C:G	11	0	11	11	0	1	1	0
chr19:12897793:G:T	67	33	100	34	66	1	1	0
chr19:12899706:A:G	54	29	83	25	58	2.0	0.0	2.0
chr19:12899829:G:T	52	27	79	25	54	2.0	0.0	2.0
chr19:12904716:A:G	5	3	8	2	6	2	0	2
chr19:12928470:A:G	6	5	11	1	10	2.0	0.0	2.0
chr19:12943967:G:T	824	488	1613	469	1144	2.0	1.0	2.0
chr19:13100694:C:T	68	39	108	30	78	2.0	0.0	2.0
chr19:13138430:A:G	4	2	6	2	4	1.5	0.5	1.0
chr19:13759339:C:A	73	34	108	41	67	1	1	0
chr19:13920513:A:G	10	3	13	7	6	1.0	1.0	0.0
chr19:13930410:G:A	22	12	34	10	24	2.0	0.0	2.0
chr19:13954529:T:C	375	188	592	199	393	2	1	1
chr19:14028192:A:G	0	0	0	0	0	0	0	0
chr19:14054392:G:C	0	0	0	0	0	0	0	0
chr19:14467542:C:G	9	3	12	6	6	1	1	0
chr19:14471656:G:A	137	70	212	70	142	2	1	2
chr19:14471727:C:T	140	69	214	74	140	1.5	1.0	0.0
chr19:14472770:C:T	0	0	0	0	0	0	0	0
chr19:14518338:G:A	361	186	576	190	386	2	1	2
chr19:14565022:G:A	28	11	39	18	21	1.0	1.0	0.0
chr19:14565766:C:T	325	156	495	176	319	1	1	0
chr19:14668738:C:A	0	0	0	0	0	0	0	0
chr19:14706736:T:A	20	10	30	10	20	1.5	0.5	1.0
chr19:14717018:C:A	3	2	5	1	4	2	0	2
chr19:14799761:C:T	0	0	0	0	0	0	0	0
chr19:14841205:T:A	0	0	0	0	0	0	0	0
chr19:14841426:A:G	0	0	0	0	0	0	0	0
chr19:14841748:G:T	0	0	0	0	0	0	0	0
chr19:14881230:A:G	0	0	0	0	0	0	0	0
chr19:14881233:C:T	0	0	0	0	0	0	0	0
chr19:15020518:G:A	0	0	0	0	0	0	0	0
chr19:15022950:G:C	0	0	0	0	0	0	0	0
chr19:15022975:C:A	0	0	0	0	0	0	0	0
chr19:15023114:C:A	0	0	0	0	0	0	0	0
chr19:15056186:C:T	0	0	0	0	0	0	0	0
chr19:15087481:C:G	0	0	0	0	0	0	0	0
chr19:15087696:T:C	0	0	0	0	0	0	0	0
chr19:15087820:A:C	0	0	0	0	0	0	0	0
chr19:15087953:T:C	0	0	0	0	0	0	0	0
chr19:15115800:C:A	5	2	7	3	4	1	1	0
chr19:15116159:G:A	68	41	109	27	82	2.0	0.0	2.0
chr19:15116219:G:A	68	41	110	28	82	2.0	0.0	2.0
chr19:15122770:C:A	67	36	103	31	72	2	0	2
chr19:15122820:G:A	10	3	13	7	6	1.0	1.0	0.0
chr19:15161190:C:T	0	0	0	0	0	0	0	0
chr19:15188240:G:A	0	0	0	0	0	0	0	0
chr19:15189325:A:G	0	0	0	0	0	0	0	0
chr19:15469847:G:A	0	0	0	0	0	0	0	0
chr19:15472052:C:T	0	0	0	0	0	0	0	0
chr19:15475861:A:T	0	0	0	0	0	0	0	0
chr19:15476374:C:T	0	0	0	0	0	0	0	0
chr19:15476534:T:C	0	0	0	0	0	0	0	0
chr19:15525513:C:T	0	0	0	0	0	0	0	0
chr19:15537904:G:A	0	0	0	0	0	0	0	0
chr19:15611777:C:T	0	0	0	0	0	0	0	0
chr19:15615676:G:T	0	0	0	0	0	0	0	0
chr19:15615778:C:A	0	0	0	0	0	0	0	0
chr19:15619692:C:T	0	0	0	0	0	0	0	0
chr19:15628274:T:C	0	0	0	0	0	0	0	0
chr19:15628464:C:T	0	0	0	0	0	0	0	0
chr19:15628505:T:C	0	0	0	0	0	0	0	0
chr19:15628636:G:T	0	0	0	0	0	0	0	0
chr19:15628787:A:C	0	0	0	0	0	0	0	0
chr19:15629410:C:T	0	0	0	0	0	0	0	0
chr19:15629458:C:G	0	0	0	0	0	0	0	0
chr19:15629465:G:A	0	0	0	0	0	0	0	0
chr19:15649243:G:A	0	0	0	0	0	0	0	0
chr19:15678447:T:C	0	0	0	0	0	0	0	0
chr19:15678487:A:G	0	0	0	0	0	0	0	0
chr19:15680322:T:A	0	0	0	0	0	0	0	0
chr19:15682425:C:T	0	0	0	0	0	0	0	0
chr19:15697074:A:G	0	0	0	0	0	0	0	0
chr19:15728157:G:A	0	0	0	0	0	0	0	0
chr19:15728358:C:T	0	0	0	0	0	0	0	0
chr19:15728364:C:T	0	0	0	0	0	0	0	0
chr19:15728649:G:A	0	0	0	0	0	0	0	0
chr19:15741413:A:C	0	0	0	0	0	0	0	0
chr19:15742270:G:A	0	0	0	0	0	0	0	0
chr19:15772074:C:T	0	0	0	0	0	0	0	0
chr19:15794043:G:A	0	0	0	0	0	0	0	0
chr19:15794192:T:C	0	0	0	0	0	0	0	0
chr19:15794396:T:C	0	0	0	0	0	0	0	0
chr19:15794621:T:C	0	0	0	0	0	0	0	0
chr19:15794829:C:T	0	0	0	0	0	0	0	0
chr19:15807645:G:A	0	0	0	0	0	0	0	0
chr19:15807992:C:G	0	0	0	0	0	0	0	0
chr19:15879621:C:T	0	0	0	0	0	0	0	0
chr19:15886010:G:A	0	0	0	0	0	0	0	0
chr19:15903005:G:A	0	0	0	0	0	0	0	0
chr19:15913728:A:G	0	0	0	0	0	0	0	0
chr19:15927555:C:G	0	0	0	0	0	0	0	0
chr19:16067777:A:C	0	0	0	0	0	0	0	0
chr19:16075962:G:A	4	1	6	4	2	1.5	1.0	0.0
chr19:16490383:C:T	1	1	2	0	2	2	0	2
chr19:16523139:T:C	7	2	9	5	4	1	1	0
chr19:16555290:G:C	6	3	9	3	6	1.5	0.5	1.0
chr19:16660195:G:A	1	0	1	1	0	1	1	0
chr19:16680048:C:T	21	9	30	12	18	1	1	0
chr19:16744454:A:G	0	0	0	0	0	0	0	0
chr19:16762129:G:A	0	0	0	0	0	0	0	0
chr19:16815256:A:T	0	0	0	0	0	0	0	0
chr19:16893238:T:C	0	0	0	0	0	0	0	0
chr19:16897767:G:C	0	0	0	0	0	0	0	0
chr19:16989742:A:G	0	0	0	0	0	0	0	0
chr19:16993569:G:A	0	0	0	0	0	0	0	0
chr19:16997243:C:T	0	0	0	0	0	0	0	0
chr19:17002337:A:G	0	0	0	0	0	0	0	0
chr19:17052851:C:T	30	13	44	18	26	1.0	1.0	0.0
chr19:17102182:C:T	136	78	219	61	158	2.0	0.0	2.0
chr19:17172848:C:T	21	9	30	12	18	1	1	0
chr19:17195222:T:C	10	4	14	6	8	1.0	1.0	0.0
chr19:17207209:G:A	29	15	44	14	30	2	0	2
chr19:17210653:C:A	3	1	4	2	2	1	1	0
chr19:17215758:A:T	32	15	47	17	30	1.0	1.0	0.0
chr19:17250255:C:T	0	0	0	0	0	0	0	0
chr19:17255504:C:T	0	0	0	0	0	0	0	0
chr19:17423542:C:G	134	53	194	84	110	1.0	1.0	0.0
chr19:17487021:G:T	2	2	4	0	4	2.0	0.0	2.0
chr19:17606087:G:T	0	0	0	0	0	0	0	0
chr19:17628041:C:T	0	0	0	0	0	0	0	0
chr19:17656091:C:T	0	0	0	0	0	0	0	0
chr19:17726281:C:T	26	10	36	16	20	1.0	1.0	0.0
chr19:17726703:G:A	27	10	37	17	20	1	1	0
chr19:17811986:G:A	0	0	0	0	0	0	0	0
chr19:17816753:G:T	4	4	8	0	8	2.0	0.0	2.0
chr19:17821329:T:C	1	0	1	1	0	1	1	0
chr19:17821381:T:C	1	0	1	1	0	1	1	0
chr19:17826620:A:G	5	3	8	2	6	2	0	2
chr19:17989743:A:C	0	0	0	0	0	0	0	0
chr19:18173841:G:T	750	397	1361	463	898	2.0	1.0	2.0
chr19:18174941:G:C	8	5	13	3	10	2.0	0.0	2.0
chr19:18175134:G:A	735	397	1345	441	904	2	1	2
chr19:18178000:A:G	767	413	1397	467	930	2	1	2
chr19:18193890:A:G	79	42	123	39	84	2	0	2
chr19:18195014:C:T	83	45	130	40	90	2	0	2
chr19:18196180:G:C	64	33	103	32	71	2.0	0.0	1.5
chr19:18200389:A:G	11	4	16	8	8	1	1	0
chr19:18218974:C:T	0	0	0	0	0	0	0	0
chr19:18257185:T:A	26	9	36	18	18	1.0	1.0	0.0
chr19:18258000:G:T	13	5	18	8	10	1	1	0
chr19:18264753:G:A	1	0	1	1	0	1	1	0
chr19:18264849:C:T	1	0	1	1	0	1	1	0
chr19:18265597:T:A	1	0	1	1	0	1	1	0
chr19:18265712:T:G	1	0	1	1	0	1	1	0
chr19:18266464:A:G	17	7	24	10	14	1	1	0
chr19:18266686:C:G	21	8	29	13	16	1	1	0
chr19:18266837:G:C	21	8	29	13	16	1	1	0
chr19:18267409:A:G	22	9	31	13	18	1.0	1.0	0.0
chr19:18312592:T:C	2	1	3	1	2	1.5	0.5	1.0
chr19:18316140:T:C	6	2	8	4	4	1.0	1.0	0.0
chr19:18568569:C:G	422	204	670	242	428	2.0	1.0	0.0
chr19:18573753:C:T	2	1	3	1	2	1.5	0.5	1.0
chr19:18575154:G:T	4143	3078	17014	5767	11247	3	1	2
chr19:18589180:T:C	430	192	650	257	393	1.0	1.0	0.0
chr19:18592267:T:C	1243	594	2115	830	1285	2	1	0
chr19:18616046:T:C	0	0	0	0	0	0	0	0
chr19:18863391:A:G	1	1	2	0	2	2	0	2
chr19:18900435:T:C	1280	729	2373	730	1643	2.0	1.0	2.0
chr19:18905641:G:A	12	6	20	6	14	1.5	0.5	1.0
chr19:18911161:T:C	9	6	17	3	14	2	0	2
chr19:18913044:T:C	1312	746	2424	742	1682	2.0	1.0	2.0
chr19:18921828:T:C	1	0	1	1	0	1	1	0
chr19:18929414:G:A	5	3	8	2	6	2	0	2
chr19:18938389:G:A	4	1	5	3	2	1.0	1.0	0.0
chr19:19194090:G:C	214	106	329	115	214	1.0	1.0	0.0
chr19:19626877:C:T	70	34	108	36	72	1.0	1.0	0.0
chr19:19647381:T:C	1	1	2	0	2	2	0	2
chr19:20039366:G:C	257	137	403	125	278	2	0	2
chr19:20039438:A:C	255	137	401	123	278	2	0	2
chr19:21294601:T:G	59	31	90	28	62	2	0	2
chr19:21294629:T:C	59	28	87	31	56	1	1	0
chr19:21536411:G:A	30	18	50	12	38	2.0	0.0	2.0
chr19:21536599:T:C	27	12	40	16	24	1	1	0
chr19:22138046:C:T	0	0	0	0	0	0	0	0
chr19:22181431:C:T	2	0	3	3	0	1.5	1.5	0.0
chr19:22857380:G:T	0	0	0	0	0	0	0	0
chr19:23362448:A:G	32	12	44	20	24	1.0	1.0	0.0
chr19:29606361:C:G	93	49	148	46	102	2	0	2
chr19:29702814:G:A	73	47	122	28	94	2	0	2
chr19:29823759:C:T	10	5	15	5	10	1.5	0.5	1.0
chr19:30548088:T:C	0	0	0	0	0	0	0	0
chr19:31278857:G:A	0	0	0	0	0	0	0	0
chr19:31279103:C:T	0	0	0	0	0	0	0	0
chr19:32439163:G:A	8	5	13	3	10	2.0	0.0	2.0
chr19:32862558:G:A	0	0	0	0	0	0	0	0
chr19:32864149:A:G	1	0	1	1	0	1	1	0
chr19:32864175:G:A	1	0	1	1	0	1	1	0
chr19:32953801:C:T	52	32	85	21	64	2.0	0.0	2.0
chr19:32976714:T:C	9	5	14	4	10	2	0	2
chr19:32990482:C:T	0	0	0	0	0	0	0	0
chr19:32996165:G:C	0	0	0	0	0	0	0	0
chr19:32996276:A:G	0	0	0	0	0	0	0	0
chr19:32999660:T:C	0	0	0	0	0	0	0	0
chr19:33008072:A:G	1	1	2	0	2	2	0	2
chr19:33008165:G:A	1	1	2	0	2	2	0	2
chr19:33211339:A:G	0	0	0	0	0	0	0	0
chr19:33211353:A:G	0	0	0	0	0	0	0	0
chr19:34351583:T:C	12	4	16	8	8	1.0	1.0	0.0
chr19:34352856:C:A	15	5	20	10	10	1	1	0
chr19:34377737:A:G	197	98	309	106	203	2	1	0
chr19:34399417:G:A	0	0	0	0	0	0	0	0
chr19:34469074:A:G	307	156	481	163	318	2	1	2
chr19:34500289:T:A	0	0	0	0	0	0	0	0
chr19:34684870:C:T	22	9	31	13	18	1.0	1.0	0.0
chr19:34944165:A:G	5	2	7	3	4	1	1	0
chr19:34944685:C:T	5	2	7	3	4	1	1	0
chr19:34958178:G:A	1	0	1	1	0	1	1	0
chr19:34958505:G:A	1	1	2	0	2	2	0	2
chr19:34958856:G:C	1	1	2	0	2	2	0	2
chr19:34963700:AA:CG	1	0	1	1	0	1	1	0
chr19:34996221:G:A	0	0	0	0	0	0	0	0
chr19:35015718:G:T	2	0	2	2	0	1.0	1.0	0.0
chr19:35015825:G:A	20	3	23	17	6	1.0	1.0	0.0
chr19:35019198:G:C	29	12	40	17	23	1	1	0
chr19:35033920:T:C	0	0	0	0	0	0	0	0
chr19:35121382:A:G	0	0	0	0	0	0	0	0
chr19:35228117:C:T	0	0	0	0	0	0	0	0
chr19:35228203:A:G	0	0	0	0	0	0	0	0
chr19:35250553:T:C	370	201	590	182	408	2.0	0.0	2.0
chr19:35266524:G:A	364	174	558	202	356	1.0	1.0	0.0
chr19:35279153:G:A	22	10	32	12	20	1.0	1.0	0.0
chr19:35279271:A:G	275	145	438	140	298	2	0	2
chr19:35359658:G:A	0	0	0	0	0	0	0	0
chr19:35487397:C:T	0	0	0	0	0	0	0	0
chr19:35507460:T:G	40	35	87	5	82	2.0	0.0	2.0
chr19:35511808:C:A	0	0	0	0	0	0	0	0
chr19:35513269:C:A	0	0	0	0	0	0	0	0
chr19:35527026:G:C	0	0	0	0	0	0	0	0
chr19:35527370:C:T	0	0	0	0	0	0	0	0
chr19:35542558:C:T	4	2	6	2	4	1.5	0.5	1.0
chr19:35547319:T:C	13	6	20	8	12	2	1	0
chr19:35547488:A:G	492	262	814	272	542	2.0	1.0	2.0
chr19:35560067:A:G	0	0	0	0	0	0	0	0
chr19:35613988:C:T	20	7	27	13	14	1.0	1.0	0.0
chr19:35643306:G:A	1	0	1	1	0	1	1	0
chr19:35668466:T:G	1	0	1	1	0	1	1	0
chr19:35678012:T:C	0	0	0	0	0	0	0	0
chr19:35715148:A:C	604	330	1026	344	682	2.0	1.0	2.0
chr19:35732846:A:G	4	2	6	2	4	1.5	0.5	1.0
chr19:35733804:A:G	13	6	20	8	12	2	1	0
chr19:35739866:A:G	1682	901	3437	1289	2148	2.0	1.0	2.0
chr19:35752289:T:C	0	0	0	0	0	0	0	0
chr19:35762416:C:T	77	38	115	39	76	1	1	0
chr19:35767820:C:T	1	1	2	0	2	2	0	2
chr19:35767941:G:C	1	1	2	0	2	2	0	2
chr19:35777869:C:T	5	3	8	2	6	2	0	2
chr19:35782406:G:A	3	1	4	2	2	1	1	0
chr19:35806608:G:A	0	0	0	0	0	0	0	0
chr19:35831368:C:T	0	0	0	0	0	0	0	0
chr19:35851310:C:T	0	0	0	0	0	0	0	0
chr19:35876607:C:G	4	3	9	3	6	2.0	0.0	2.0
chr19:36006456:C:G	1	0	1	1	0	1	1	0
chr19:36008271:C:T	0	0	0	0	0	0	0	0
chr19:36010543:C:T	1	0	1	1	0	1	1	0
chr19:36032364:C:T	9	4	13	5	8	1	1	0
chr19:36101683:C:T	1	1	2	0	2	2	0	2
chr19:36101826:G:A	1	1	2	0	2	2	0	2
chr19:36103757:A:T	2	1	3	1	2	1.5	0.5	1.0
chr19:36104534:A:C	2	1	3	1	2	1.5	0.5	1.0
chr19:36112801:T:A	0	0	0	0	0	0	0	0
chr19:36114329:C:T	7	4	11	3	8	2	0	2
chr19:36114650:G:A	28	11	41	17	24	1.0	1.0	0.0
chr19:36114745:T:C	83	48	138	38	100	2	0	2
chr19:36114892:C:T	209	70	298	154	144	1	1	0
chr19:36183403:A:G	3	2	5	1	4	2	0	2
chr19:36236463:G:A	58	25	85	35	50	1.0	1.0	0.0
chr19:36548167:A:C	17	9	26	8	18	2	0	2
chr19:36626588:A:G	23	9	32	14	18	1	1	0
chr19:36627537:C:T	22	8	30	14	16	1.0	1.0	0.0
chr19:36719627:A:G	27	8	35	19	16	1	1	0
chr19:36750239:A:G	2	0	2	2	0	1.0	1.0	0.0
chr19:36773115:C:T	0	0	0	0	0	0	0	0
chr19:36773288:G:A	12	3	15	9	6	1.0	1.0	0.0
chr19:36949595:A:T	38	22	60	16	44	2.0	0.0	2.0
chr19:36991249:A:G	4	1	5	3	2	1.0	1.0	0.0
chr19:37152015:G:A	14	8	22	6	16	2.0	0.0	2.0
chr19:37152666:T:G	12	8	20	4	16	2.0	0.0	2.0
chr19:37153149:T:C	11	8	19	3	16	2	0	2
chr19:37344756:C:T	2	1	3	1	2	1.5	0.5	1.0
chr19:37363138:G:A	21	6	27	15	12	1	1	0
chr19:37363678:C:T	26	17	43	9	34	2.0	0.0	2.0
chr19:37537677:G:A	4	3	7	1	6	2.0	0.0	2.0
chr19:37669482:T:G	3	1	4	2	2	1	1	0
chr19:37791958:G:A	0	0	0	0	0	0	0	0
chr19:37885026:C:T	0	0	0	0	0	0	0	0
chr19:37885463:A:G	0	0	0	0	0	0	0	0
chr19:37888806:C:T	1	0	1	1	0	1	1	0
chr19:37891688:C:T	1	0	1	1	0	1	1	0
chr19:38162353:C:T	17	11	28	6	22	2	0	2
chr19:38182658:C:G	5	3	8	2	6	2	0	2
chr19:38304255:T:C	0	0	0	0	0	0	0	0
chr19:38304519:G:A	0	0	0	0	0	0	0	0
chr19:38304610:G:A	1	0	1	1	0	1	1	0
chr19:38307446:T:C	158	88	256	76	180	2.0	0.0	2.0
chr19:38309525:C:T	149	84	242	70	172	2	0	2
chr19:38315691:G:C	8	1	9	7	2	1.0	1.0	0.0
chr19:38326687:C:T	24	14	38	10	28	2.0	0.0	2.0
chr19:38326846:T:C	24	10	34	14	20	1.0	1.0	0.0
chr19:38327236:G:A	26	11	37	15	22	1.0	1.0	0.0
chr19:38337320:T:C	17	4	21	13	8	1	1	0
chr19:38356791:T:C	3	0	3	3	0	1	1	0
chr19:38358221:C:G	0	0	0	0	0	0	0	0
chr19:38359606:G:A	0	0	0	0	0	0	0	0
chr19:38362657:G:A	2	1	3	1	2	1.5	0.5	1.0
chr19:38411020:G:A	0	0	0	0	0	0	0	0
chr19:38411075:C:A	0	0	0	0	0	0	0	0
chr19:38415043:A:G	1	0	1	1	0	1	1	0
chr19:38444640:A:G	0	0	0	0	0	0	0	0
chr19:38448768:T:C	0	0	0	0	0	0	0	0
chr19:38455542:G:A	0	0	0	0	0	0	0	0
chr19:38459264:C:T	0	0	0	0	0	0	0	0
chr19:38466163:G:A	0	0	0	0	0	0	0	0
chr19:38469040:C:T	0	0	0	0	0	0	0	0
chr19:38519383:C:T	0	0	0	0	0	0	0	0
chr19:38527640:C:T	0	0	0	0	0	0	0	0
chr19:38570618:C:G	16	7	23	9	14	1.0	1.0	0.0
chr19:38601502:C:T	139	64	210	78	132	1	1	0
chr19:38706096:G:A	8	3	11	5	6	1.0	1.0	0.0
chr19:38721752:C:T	0	0	0	0	0	0	0	0
chr19:38729140:T:C	17	10	28	8	20	2	0	2
chr19:38731307:A:T	4	1	5	3	2	1.0	1.0	0.0
chr19:38733773:A:G	138	47	194	97	97	1.0	1.0	0.0
chr19:38737604:T:C	10	4	16	8	8	2.0	1.0	0.0
chr19:38742506:A:G	2	2	4	0	4	2.0	0.0	2.0
chr19:38816463:C:T	1166	638	2053	677	1376	2.0	1.0	2.0
chr19:38817285:C:T	18	9	27	9	18	1.5	0.5	1.0
chr19:38869957:C:T	210	109	330	104	226	2.0	0.0	2.0
chr19:38889215:G:A	3	0	3	3	0	1	1	0
chr19:38907776:A:G	56	23	79	33	46	1.0	1.0	0.0
chr19:38911815:C:G	1	0	1	1	0	1	1	0
chr19:38926247:C:T	48	26	74	22	52	2.0	0.0	2.0
chr19:38950278:T:C	0	0	0	0	0	0	0	0
chr19:38950326:T:C	0	0	0	0	0	0	0	0
chr19:39100315:G:A	0	0	0	0	0	0	0	0
chr19:39243580:C:A	0	0	0	0	0	0	0	0
chr19:39244466:T:C	0	0	0	0	0	0	0	0
chr19:39245004:C:G	0	0	0	0	0	0	0	0
chr19:39247226:C:G	0	0	0	0	0	0	0	0
chr19:39248489:C:G	0	0	0	0	0	0	0	0
chr19:39248713:G:C	0	0	0	0	0	0	0	0
chr19:39298475:A:G	0	0	0	0	0	0	0	0
chr19:39515516:C:T	0	0	0	0	0	0	0	0
chr19:39532668:A:G	42	17	59	25	34	1.0	1.0	0.0
chr19:39540064:C:T	2	0	2	2	0	1.0	1.0	0.0
chr19:39707284:T:C	0	0	0	0	0	0	0	0
chr19:39709274:C:G	0	0	0	0	0	0	0	0
chr19:39734346:A:G	0	0	0	0	0	0	0	0
chr19:39735006:G:A	0	0	0	0	0	0	0	0
chr19:39875722:G:C	0	0	0	0	0	0	0	0
chr19:39877755:C:T	0	0	0	0	0	0	0	0
chr19:39877880:G:C	0	0	0	0	0	0	0	0
chr19:39886243:C:G	0	0	0	0	0	0	0	0
chr19:39886257:CCCG:TCCT	0	0	0	0	0	0	0	0
chr19:39894438:T:C	0	0	0	0	0	0	0	0
chr19:39899634:CGA:TGC	0	0	0	0	0	0	0	0
chr19:40213503:C:T	0	0	0	0	0	0	0	0
chr19:40233814:G:T	61	25	88	37	51	1	1	0
chr19:40236198:T:C	6	2	8	4	4	1.0	1.0	0.0
chr19:40376579:C:G	3	1	4	2	2	1	1	0
chr19:40378253:G:A	151	75	227	78	149	2	1	0
chr19:40395589:T:C	1	1	2	0	2	2	0	2
chr19:40395697:A:G	1	1	2	0	2	2	0	2
chr19:40395707:A:G	1	1	2	0	2	2	0	2
chr19:40423456:T:C	514	277	852	270	582	2.0	1.0	2.0
chr19:40441625:C:T	557	307	951	301	650	2	0	2
chr19:40502142:A:G	0	0	0	0	0	0	0	0
chr19:40504075:C:T	0	0	0	0	0	0	0	0
chr19:40605163:G:A	3	2	7	1	6	2	0	2
chr19:40610549:C:G	5	2	7	3	4	1	1	0
chr19:40611963:A:G	8	6	14	2	12	2.0	0.0	2.0
chr19:40612150:A:G	8	6	14	2	12	2.0	0.0	2.0
chr19:40622404:C:T	30	19	49	11	38	2.0	0.0	2.0
chr19:40623937:C:T	43	28	72	16	56	2	0	2
chr19:40703572:C:T	45	29	74	16	58	2	0	2
chr19:40705151:T:C	43	16	59	27	32	1	1	0
chr19:40749595:C:G	13	3	16	10	6	1	1	0
chr19:40800457:G:A	198	102	301	99	202	2.0	0.0	2.0
chr19:40806707:G:C	4	2	6	2	4	1.5	0.5	1.0
chr19:40807297:C:A	5	4	9	1	8	2	0	2
chr19:40822291:C:T	0	0	0	0	0	0	0	0
chr19:40875742:A:C	0	0	0	0	0	0	0	0
chr19:40876702:AGGGTCG:CAGGTTA	0	0	0	0	0	0	0	0
chr19:40876740:G:A	0	0	0	0	0	0	0	0
chr19:40877312:T:C	0	0	0	0	0	0	0	0
chr19:40878770:T:C	0	0	0	0	0	0	0	0
chr19:40878797:T:C	0	0	0	0	0	0	0	0
chr19:40880128:T:C	0	0	0	0	0	0	0	0
chr19:41016810:C:T	0	0	0	0	0	0	0	0
chr19:41116284:G:A	0	0	0	0	0	0	0	0
chr19:41121963:G:A	0	0	0	0	0	0	0	0
chr19:41128072:G:A	0	0	0	0	0	0	0	0
chr19:41206519:A:G	0	0	0	0	0	0	0	0
chr19:41219366:A:G	0	0	0	0	0	0	0	0
chr19:41432317:C:T	53	23	76	30	46	1	1	0
chr19:41521154:A:T	10	2	12	8	4	1.0	1.0	0.0
chr19:41577497:A:C	24	13	37	11	26	2.0	0.0	2.0
chr19:41579520:G:A	24	12	36	12	24	1.5	0.5	1.0
chr19:41709751:G:A	0	0	0	0	0	0	0	0
chr19:41709969:A:G	0	0	0	0	0	0	0	0
chr19:41756661:G:A	0	0	0	0	0	0	0	0
chr19:41837333:G:C	0	0	0	0	0	0	0	0
chr19:42249066:G:A	28	18	49	11	38	2.0	0.0	2.0
chr19:42729152:C:A	0	0	0	0	0	0	0	0
chr19:42729897:A:T	0	0	0	0	0	0	0	0
chr19:42739065:AA:GG	0	0	0	0	0	0	0	0
chr19:42753287:G:T	0	0	0	0	0	0	0	0
chr19:42755032:T:G	0	0	0	0	0	0	0	0
chr19:42764064:T:G	0	0	0	0	0	0	0	0
chr19:42764083:A:C	0	0	0	0	0	0	0	0
chr19:43071722:T:C	0	0	0	0	0	0	0	0
chr19:43072536:C:T	0	0	0	0	0	0	0	0
chr19:43075490:A:G	0	0	0	0	0	0	0	0
chr19:43082512:C:G	0	0	0	0	0	0	0	0
chr19:43175885:T:A	0	0	0	0	0	0	0	0
chr19:43176117:G:C	0	0	0	0	0	0	0	0
chr19:43194607:G:A	0	0	0	0	0	0	0	0
chr19:43198190:C:T	0	0	0	0	0	0	0	0
chr19:43204093:G:C	0	0	0	0	0	0	0	0
chr19:43258881:T:A	0	0	0	0	0	0	0	0
chr19:43258890:G:T	0	0	0	0	0	0	0	0
chr19:43269447:T:C	0	0	0	0	0	0	0	0
chr19:43269474:G:A	0	0	0	0	0	0	0	0
chr19:43406497:G:T	0	0	0	0	0	0	0	0
chr19:43417909:A:G	0	0	0	0	0	0	0	0
chr19:43465605:A:G	1	0	1	1	0	1	1	0
chr19:43475437:G:T	23	12	35	11	24	2	0	2
chr19:43497227:T:C	60	27	88	34	54	1.0	1.0	0.0
chr19:43553422:G:A	94	53	147	41	106	2.0	0.0	2.0
chr19:43594811:C:G	3	3	6	0	6	2	0	2
chr19:43614036:A:C	7	3	10	4	6	1	1	0
chr19:43614201:G:A	6	3	9	3	6	1.5	0.5	1.0
chr19:43656716:A:G	0	0	0	0	0	0	0	0
chr19:43769364:T:C	16	8	24	8	16	1.5	0.5	1.0
chr19:43776685:G:A	10	4	14	6	8	1.0	1.0	0.0
chr19:43802330:C:T	0	0	0	0	0	0	0	0
chr19:43802424:G:T	0	0	0	0	0	0	0	0
chr19:43848536:G:A	4	0	4	4	0	1.0	1.0	0.0
chr19:43914623:C:T	3	2	5	1	4	2	0	2
chr19:44386639:C:T	4	2	6	2	4	1.5	0.5	1.0
chr19:44428346:C:T	4	0	4	4	0	1.0	1.0	0.0
chr19:44429329:G:A	4	4	8	0	8	2.0	0.0	2.0
chr19:44429531:C:T	4	4	8	0	8	2.0	0.0	2.0
chr19:44430314:A:G	4	1	5	3	2	1.0	1.0	0.0
chr19:44430478:T:C	3	2	5	1	4	2	0	2
chr19:44477308:G:A	16	6	22	10	12	1.0	1.0	0.0
chr19:44477666:G:C	17	9	26	8	18	2	0	2
chr19:44500253:G:C	10	2	12	8	4	1.0	1.0	0.0
chr19:44512058:G:A	0	0	0	0	0	0	0	0
chr19:44517149:G:A	0	0	0	0	0	0	0	0
chr19:44525175:G:A	0	0	0	0	0	0	0	0
chr19:44658921:C:A	0	0	0	0	0	0	0	0
chr19:44756178:G:C	0	0	0	0	0	0	0	0
chr19:44757714:G:T	10	4	14	6	8	1.0	1.0	0.0
chr19:44758263:C:T	12	5	17	7	10	1.0	1.0	0.0
chr19:44793575:A:G	0	0	0	0	0	0	0	0
chr19:44794222:C:T	0	0	0	0	0	0	0	0
chr19:44905910:C:G	0	0	0	0	0	0	0	0
chr19:44926993:G:A	0	0	0	0	0	0	0	0
chr19:44927023:C:G	0	0	0	0	0	0	0	0
chr19:44944779:T:C	7	4	11	3	8	2	0	2
chr19:44945208:T:G	7	4	11	3	8	2	0	2
chr19:44987312:A:G	133	62	195	71	124	1	1	0
chr19:44987378:T:C	133	71	204	62	142	2	0	2
chr19:44990377:C:G	2	1	3	1	2	1.5	0.5	1.0
chr19:45155897:G:C	0	0	0	0	0	0	0	0
chr19:45315577:A:G	0	0	0	0	0	0	0	0
chr19:45361744:C:A	0	0	0	0	0	0	0	0
chr19:45364001:C:T	19	9	28	10	18	1	1	0
chr19:45365051:T:G	18	8	26	10	16	1.0	1.0	0.0
chr19:45406676:G:A	22	11	33	11	22	1.5	0.5	1.0
chr19:45406745:G:T	0	0	0	0	0	0	0	0
chr19:45408744:A:C	60	33	93	27	66	2.0	0.0	2.0
chr19:45409085:A:G	57	31	88	26	62	2	0	2
chr19:45409148:G:A	56	30	85	26	59	2.0	0.0	2.0
chr19:45420395:A:G	298	158	485	159	326	2.0	1.0	2.0
chr19:45471335:T:C	24	12	36	12	24	1.5	0.5	1.0
chr19:45759028:C:A	0	0	0	0	0	0	0	0
chr19:45761705:C:T	0	0	0	0	0	0	0	0
chr19:45765644:C:T	1	1	2	0	2	2	0	2
chr19:45766055:G:C	1	1	2	0	2	2	0	2
chr19:45786134:G:C	4	3	7	1	6	2.0	0.0	2.0
chr19:45786245:C:T	4	3	7	1	6	2.0	0.0	2.0
chr19:45823908:G:A	6	2	8	4	4	1.0	1.0	0.0
chr19:45823927:G:C	6	2	8	4	4	1.0	1.0	0.0
chr19:45828936:C:T	2	2	4	0	4	2.0	0.0	2.0
chr19:45838566:C:T	33	19	52	14	38	2	0	2
chr19:45848864:A:G	26	15	41	11	30	2.0	0.0	2.0
chr19:45854553:C:A	4	3	7	1	6	2.0	0.0	2.0
chr19:45884086:G:A	27	16	47	11	36	2	0	2
chr19:45885121:C:G	18	7	25	11	14	1.0	1.0	0.0
chr19:46016768:A:G	11	6	17	5	12	2	0	2
chr19:46161143:A:G	1	1	2	0	2	2	0	2
chr19:46308727:A:G	0	0	0	0	0	0	0	0
chr19:46353758:C:T	49	30	79	19	60	2	0	2
chr19:46375732:G:A	48	17	65	31	34	1.0	1.0	0.0
chr19:46383942:A:G	0	0	0	0	0	0	0	0
chr19:46386990:G:C	0	0	0	0	0	0	0	0
chr19:46411290:C:G	0	0	0	0	0	0	0	0
chr19:46411670:C:T	0	0	0	0	0	0	0	0
chr19:46470724:G:A	0	0	0	0	0	0	0	0
chr19:46470746:C:T	0	0	0	0	0	0	0	0
chr19:46494979:C:T	0	0	0	0	0	0	0	0
chr19:46634202:C:T	110	22	146	96	50	1.0	1.0	0.0
chr19:46648467:A:G	0	0	0	0	0	0	0	0
chr19:46710884:G:C	5	0	5	5	0	1	1	0
chr19:46755585:C:T	1	0	1	1	0	1	1	0
chr19:46839610:A:C	27	16	44	12	32	2	0	2
chr19:47040516:G:A	4	1	5	3	2	1.0	1.0	0.0
chr19:47045420:G:A	7	2	9	5	4	1	1	0
chr19:47082260:G:C	1	0	1	1	0	1	1	0
chr19:47258286:T:C	1	1	2	0	2	2	0	2
chr19:47260760:G:A	64	31	97	35	62	1.5	1.0	0.0
chr19:47264871:G:C	21	12	34	10	24	2	0	2
chr19:47266582:A:G	220	110	342	115	227	2.0	1.0	0.5
chr19:47266758:A:C	236	118	368	124	244	2.0	1.0	1.0
chr19:47271315:C:T	34	16	51	19	32	1.5	1.0	0.0
chr19:47271515:T:C	38	18	57	21	36	1.5	1.0	0.0
chr19:47375601:C:T	4	1	5	3	2	1.0	1.0	0.0
chr19:47376356:A:G	1	0	1	1	0	1	1	0
chr19:47376617:C:T	0	0	0	0	0	0	0	0
chr19:47379829:T:G	11	4	15	7	8	1	1	0
chr19:47475414:G:A	25	18	43	7	36	2	0	2
chr19:47539719:C:T	0	0	0	0	0	0	0	0
chr19:47544564:C:T	0	0	0	0	0	0	0	0
chr19:47679265:A:G	7	2	9	5	4	1	1	0
chr19:47679530:C:T	2	1	3	1	2	1.5	0.5	1.0
chr19:47680514:C:T	1	0	1	1	0	1	1	0
chr19:47681217:C:T	3	1	4	2	2	1	1	0
chr19:47695418:A:G	4	2	6	2	4	1.5	0.5	1.0
chr19:47740937:A:G	0	0	0	0	0	0	0	0
chr19:47741312:G:A	0	0	0	0	0	0	0	0
chr19:47751135:T:C	13	4	18	10	8	1	1	0
chr19:47752547:A:G	1113	552	1902	705	1197	2	1	0
chr19:47802100:G:A	0	0	0	0	0	0	0	0
chr19:47802416:TT:TC	0	0	0	0	0	0	0	0
chr19:47871389:A:G	0	0	0	0	0	0	0	0
chr19:48022250:G:A	0	0	0	0	0	0	0	0
chr19:48030443:C:T	0	0	0	0	0	0	0	0
chr19:48030470:G:C	0	0	0	0	0	0	0	0
chr19:48040605:G:A	0	0	0	0	0	0	0	0
chr19:48040649:G:C	0	0	0	0	0	0	0	0
chr19:48194704:C:T	6	4	10	2	8	2.0	0.0	2.0
chr19:48234449:A:T	36	14	51	23	28	1.0	1.0	0.0
chr19:48297494:C:A	0	0	0	0	0	0	0	0
chr19:48297534:A:G	0	0	0	0	0	0	0	0
chr19:48297657:G:A	0	0	0	0	0	0	0	0
chr19:48302758:C:T	0	0	0	0	0	0	0	0
chr19:48360129:C:T	10	5	15	5	10	1.5	0.5	1.0
chr19:48592808:C:T	0	0	0	0	0	0	0	0
chr19:48596698:C:T	0	0	0	0	0	0	0	0
chr19:48599142:C:T	0	0	0	0	0	0	0	0
chr19:48599256:C:T	0	0	0	0	0	0	0	0
chr19:48601051:C:T	0	0	0	0	0	0	0	0
chr19:48613298:A:G	0	0	0	0	0	0	0	0
chr19:48626229:G:A	53	24	77	29	48	1	1	0
chr19:48661695:A:G	2	1	3	1	2	1.5	0.5	1.0
chr19:48663618:G:A	2	1	3	1	2	1.5	0.5	1.0
chr19:48680448:G:A	4	3	7	1	6	2.0	0.0	2.0
chr19:48703160:A:G	0	0	0	0	0	0	0	0
chr19:48703205:C:T	0	0	0	0	0	0	0	0
chr19:48703346:C:T	0	0	0	0	0	0	0	0
chr19:48703417:G:A	0	0	0	0	0	0	0	0
chr19:48703728:G:A	0	0	0	0	0	0	0	0
chr19:48703949:A:G	0	0	0	0	0	0	0	0
chr19:48703998:ATT:GTC	0	0	0	0	0	0	0	0
chr19:48728969:G:A	0	0	0	0	0	0	0	0
chr19:48740962:CG:AA	0	0	0	0	0	0	0	0
chr19:48743609:A:G	0	0	0	0	0	0	0	0
chr19:48744529:G:A	0	0	0	0	0	0	0	0
chr19:48750132:C:T	0	0	0	0	0	0	0	0
chr19:48756272:A:G	0	0	0	0	0	0	0	0
chr19:48835841:T:C	12	0	12	12	0	1.0	1.0	0.0
chr19:48865586:T:C	0	0	0	0	0	0	0	0
chr19:48874062:A:G	1035	630	1946	550	1396	2	0	2
chr19:48874167:G:A	1049	631	1956	560	1396	2	0	2
chr19:48874179:G:C	1050	626	1954	566	1388	2.0	0.0	2.0
chr19:48874616:G:A	967	574	1770	514	1256	2	0	2
chr19:48874661:G:T	974	575	1782	523	1259	2.0	0.0	2.0
chr19:48875737:A:G	1122	689	2133	600	1533	2.0	0.0	2.0
chr19:48875910:C:T	1152	701	2210	638	1572	2.0	0.0	2.0
chr19:48875925:G:C	1150	698	2204	639	1565	2.0	0.0	2.0
chr19:48896564:G:A	0	0	0	0	0	0	0	0
chr19:48904403:G:A	248	124	390	136	254	2.0	1.0	1.0
chr19:49032234:T:C	0	0	0	0	0	0	0	0
chr19:49036836:A:C	0	0	0	0	0	0	0	0
chr19:49054315:T:C	0	0	0	0	0	0	0	0
chr19:49070181:A:G	0	0	0	0	0	0	0	0
chr19:49070868:G:C	0	0	0	0	0	0	0	0
chr19:49108062:C:T	575	315	944	293	651	2	0	2
chr19:49128822:C:A	0	0	0	0	0	0	0	0
chr19:49155110:C:T	0	0	0	0	0	0	0	0
chr19:49157855:G:A	0	0	0	0	0	0	0	0
chr19:49167894:G:A	0	0	0	0	0	0	0	0
chr19:49335634:C:A	717	246	1064	556	508	1	1	0
chr19:49335758:T:C	4770	3788	28056	10810	17246	5.0	2.0	2.0
chr19:49337797:G:T	36	13	49	23	26	1.0	1.0	0.0
chr19:49364656:G:A	25	4	29	21	8	1	1	0
chr19:49390895:C:T	1	0	1	1	0	1	1	0
chr19:49395819:G:A	0	0	0	0	0	0	0	0
chr19:49398061:T:C	0	0	0	0	0	0	0	0
chr19:49417548:A:G	3	1	4	2	2	1	1	0
chr19:49556725:C:G	811	450	1377	431	946	2	0	2
chr19:49583369:T:C	0	0	0	0	0	0	0	0
chr19:49583549:C:T	0	0	0	0	0	0	0	0
chr19:49588541:G:T	1	1	2	0	2	2	0	2
chr19:49594527:T:C	18	7	26	12	14	1.0	1.0	0.0
chr19:49596165:C:T	0	0	0	0	0	0	0	0
chr19:49659652:C:G	287	139	445	157	288	1	1	0
chr19:49664469:C:G	37	24	61	13	48	2	0	2
chr19:49689906:A:G	4	2	6	2	4	1.5	0.5	1.0
chr19:49739914:C:T	0	0	0	0	0	0	0	0
chr19:49858491:G:A	9	5	14	4	10	2	0	2
chr19:49882116:G:A	130	68	202	64	138	2.0	0.0	2.0
chr19:49908960:C:G	41	23	64	18	46	2	0	2
chr19:49933114:G:A	106	64	192	45	147	2.0	0.0	2.0
chr19:49950060:C:T	0	0	0	0	0	0	0	0
chr19:50217683:T:C	0	0	0	0	0	0	0	0
chr19:50437521:C:T	36	18	54	18	36	1.5	0.5	1.0
chr19:50451907:G:T	0	0	0	0	0	0	0	0
chr19:50462015:T:C	0	0	0	0	0	0	0	0
chr19:50464429:G:A	0	0	0	0	0	0	0	0
chr19:50480673:C:T	303	146	464	167	297	1	1	0
chr19:50514578:G:A	1	1	2	0	2	2	0	2
chr19:50723454:G:A	0	0	0	0	0	0	0	0
chr19:50790698:G:A	0	0	0	0	0	0	0	0
chr19:50794568:GC:AA	2	0	2	2	0	1.0	1.0	0.0
chr19:50798138:C:T	113	59	174	56	118	2	0	2
chr19:50798199:G:A	113	59	173	55	118	2	0	2
chr19:50819976:T:C	256	145	441	127	314	2.0	0.0	2.0
chr19:50826873:C:T	0	0	0	0	0	0	0	0
chr19:50827676:G:T	0	0	0	0	0	0	0	0
chr19:50858681:G:A	0	0	0	0	0	0	0	0
chr19:50860192:A:G	0	0	0	0	0	0	0	0
chr19:50876854:T:A	53	38	91	15	76	2	0	2
chr19:50878521:C:T	119	82	208	38	170	2	0	2
chr19:50961840:C:G	0	0	0	0	0	0	0	0
chr19:50983811:T:C	0	0	0	0	0	0	0	0
chr19:51000029:C:T	0	0	0	0	0	0	0	0
chr19:51000397:T:C	0	0	0	0	0	0	0	0
chr19:51003764:T:G	0	0	0	0	0	0	0	0
chr19:51024108:G:A	0	0	0	0	0	0	0	0
chr19:51024714:C:T	0	0	0	0	0	0	0	0
chr19:51027485:C:G	0	0	0	0	0	0	0	0
chr19:51034860:T:G	0	0	0	0	0	0	0	0
chr19:51125272:A:G	0	0	0	0	0	0	0	0
chr19:51127225:C:A	0	0	0	0	0	0	0	0
chr19:51338094:C:G	18	15	33	3	30	2.0	0.0	2.0
chr19:51367941:G:A	13	7	20	6	14	2	0	2
chr19:51371696:G:A	5	2	7	3	4	1	1	0
chr19:51416253:T:C	30	15	45	15	30	1.5	0.5	1.0
chr19:51416695:G:A	172	76	255	98	157	1.0	1.0	0.0
chr19:51491559:G:T	0	0	0	0	0	0	0	0
chr19:51491597:C:G	0	0	0	0	0	0	0	0
chr19:51627535:G:A	9	0	9	9	0	1	1	0
chr19:51627577:C:A	9	0	9	9	0	1	1	0
chr19:51627672:G:A	9	0	9	9	0	1	1	0
chr19:51719299:G:A	0	0	0	0	0	0	0	0
chr19:51719868:A:G	0	0	0	0	0	0	0	0
chr19:51746694:C:G	0	0	0	0	0	0	0	0
chr19:51824531:C:T	0	0	0	0	0	0	0	0
chr19:51824880:G:A	1	0	1	1	0	1	1	0
chr19:51877428:T:A	1	1	2	0	2	2	0	2
chr19:51878363:G:A	1	1	2	0	2	2	0	2
chr19:51964950:T:A	22	17	40	6	34	2.0	0.0	2.0
chr19:51965334:G:T	20	16	37	5	32	2.0	0.0	2.0
chr19:51965745:A:G	17	13	30	4	26	2	0	2
chr19:51968560:T:C	9	8	17	1	16	2	0	2
chr19:51968619:A:G	161	88	254	76	178	2	0	2
chr19:51969042:A:G	149	84	237	67	170	2	0	2
chr19:51992896:C:T	14	5	19	9	10	1.0	1.0	0.0
chr19:51993997:G:A	7	3	10	4	6	1	1	0
chr19:52016355:C:T	9	4	13	5	8	1	1	0
chr19:52017354:C:T	16	8	24	8	16	1.5	0.5	1.0
chr19:52034323:T:G	18	12	30	6	24	2.0	0.0	2.0
chr19:52212538:G:A	27	8	37	19	18	1	1	0
chr19:52222085:T:C	3	0	3	3	0	1	1	0
chr19:52225777:C:T	453	207	685	265	420	1	1	0
chr19:52321982:A:G	9	2	11	7	4	1	1	0
chr19:52366758:G:C	7	4	11	3	8	2	0	2
chr19:52366799:C:G	7	3	10	4	6	1	1	0
chr19:52384174:A:C	60	54	114	6	108	2.0	0.0	2.0
chr19:52384184:A:C	60	54	114	6	108	2.0	0.0	2.0
chr19:52384651:T:C	59	53	112	6	106	2	0	2
chr19:52384957:T:C	17	10	27	7	20	2	0	2
chr19:52384992:A:G	18	10	28	8	20	2.0	0.0	2.0
chr19:52385367:T:G	19	13	32	6	26	2	0	2
chr19:52511093:G:A	0	0	0	0	0	0	0	0
chr19:52582560:T:C	11	3	14	8	6	1	1	0
chr19:52614278:C:T	54	31	85	23	62	2.0	0.0	2.0
chr19:52614556:C:A	52	31	83	21	62	2.0	0.0	2.0
chr19:52864085:G:A	2	0	2	2	0	1.0	1.0	0.0
chr19:52864139:A:G	2	2	4	0	4	2.0	0.0	2.0
chr19:53015374:G:C	2	0	2	2	0	1.0	1.0	0.0
chr19:53050433:G:A	0	0	0	0	0	0	0	0
chr19:53069241:G:T	11	6	17	5	12	2	0	2
chr19:53109058:T:C	5	5	10	0	10	2	0	2
chr19:53129643:G:A	6	4	10	2	8	2.0	0.0	2.0
chr19:53224391:T:C	1	0	1	1	0	1	1	0
chr19:53315311:C:T	0	0	0	0	0	0	0	0
chr19:53315350:G:A	0	0	0	0	0	0	0	0
chr19:53447222:G:T	57	38	97	19	78	2	0	2
chr19:53490669:C:T	0	0	0	0	0	0	0	0
chr19:53490734:A:T	0	0	0	0	0	0	0	0
chr19:53490924:G:A	1	1	2	0	2	2	0	2
chr19:53824059:C:A	0	0	0	0	0	0	0	0
chr19:53824186:G:A	0	0	0	0	0	0	0	0
chr19:53891711:T:C	0	0	0	0	0	0	0	0
chr19:54058538:G:A	0	0	0	0	0	0	0	0
chr19:54095339:T:G	0	0	0	0	0	0	0	0
chr19:54095964:C:T	1	1	2	0	2	2	0	2
chr19:54100903:G:C	1	1	2	0	2	2	0	2
chr19:54103097:T:C	2	1	3	1	2	1.5	0.5	1.0
chr19:54122386:C:T	1	0	1	1	0	1	1	0
chr19:54148468:C:T	39	17	57	23	34	1	1	0
chr19:54160307:C:T	11	2	14	10	4	1	1	0
chr19:54161015:C:A	9	8	17	1	16	2	0	2
chr19:54162234:T:C	1	1	2	0	2	2	0	2
chr19:54173068:T:C	0	0	0	0	0	0	0	0
chr19:54191312:C:T	75	32	107	43	64	1	1	0
chr19:54193224:T:C	136	61	202	76	126	1.0	1.0	0.0
chr19:54207390:G:T	32	13	46	20	26	1.0	1.0	0.0
chr19:54252255:G:A	0	0	0	0	0	0	0	0
chr19:54252279:C:T	0	0	0	0	0	0	0	0
chr19:54255498:T:C	0	0	0	0	0	0	0	0
chr19:54256828:C:T	0	0	0	0	0	0	0	0
chr19:54278849:G:C	36	16	54	22	32	1.0	1.0	0.0
chr19:54278855:A:G	36	16	54	22	32	1.0	1.0	0.0
chr19:54278869:G:A	36	16	54	22	32	1.0	1.0	0.0
chr19:54280068:G:A	34	20	56	14	42	2.0	0.0	2.0
chr19:54336819:T:A	19	12	37	9	28	2	0	2
chr19:54451290:A:G	55	23	60	34	26	1	1	0
chr19:54454681:A:G	43	20	66	24	42	1	1	0
chr19:54455400:G:C	41	21	65	21	44	2	0	2
chr19:54462100:G:C	0	0	0	0	0	0	0	0
chr19:54463135:C:T	0	0	0	0	0	0	0	0
chr19:54502872:C:T	0	0	0	0	0	0	0	0
chr19:54508046:C:T	0	0	0	0	0	0	0	0
chr19:54508156:C:G	0	0	0	0	0	0	0	0
chr19:54666711:A:G	139	91	270	64	206	2	0	2
chr19:54667913:G:A	144	64	246	102	144	1.0	1.0	0.0
chr19:54735264:A:C	0	0	0	0	0	0	0	0
chr19:54769863:G:T	0	0	0	0	0	0	0	0
chr19:54885488:G:A	0	0	0	0	0	0	0	0
chr19:54939864:C:T	0	0	0	0	0	0	0	0
chr19:54940429:C:T	0	0	0	0	0	0	0	0
chr19:54970030:G:A	8	8	16	0	16	2.0	0.0	2.0
chr19:54982915:C:G	6	6	12	0	12	2.0	0.0	2.0
chr19:54983283:A:G	6	6	12	0	12	2.0	0.0	2.0
chr19:54983372:T:C	6	6	12	0	12	2.0	0.0	2.0
chr19:54983513:C:G	6	6	12	0	12	2.0	0.0	2.0
chr19:55014395:A:C	13	12	25	1	24	2	0	2
chr19:55032605:C:T	3	1	4	2	2	1	1	0
chr19:55048347:G:A	56	21	77	35	42	1.0	1.0	0.0
chr19:55076454:G:A	0	0	0	0	0	0	0	0
chr19:55082049:C:T	0	0	0	0	0	0	0	0
chr19:55083628:C:G	11	7	18	4	14	2	0	2
chr19:55087356:A:G	13	7	20	6	14	2	0	2
chr19:55092548:G:C	6	4	10	2	8	2.0	0.0	2.0
chr19:55103555:T:C	11	7	18	4	14	2	0	2
chr19:55112438:C:T	0	0	0	0	0	0	0	0
chr19:55141929:A:C	0	0	0	0	0	0	0	0
chr19:55156438:T:C	0	0	0	0	0	0	0	0
chr19:55156942:C:G	0	0	0	0	0	0	0	0
chr19:55159275:G:A	0	0	0	0	0	0	0	0
chr19:55159457:T:C	0	0	0	0	0	0	0	0
chr19:55161102:T:C	0	0	0	0	0	0	0	0
chr19:55161201:G:A	0	0	0	0	0	0	0	0
chr19:55161416:A:G	0	0	0	0	0	0	0	0
chr19:55161877:G:A	0	0	0	0	0	0	0	0
chr19:55166155:C:T	0	0	0	0	0	0	0	0
chr19:55181713:G:C	0	0	0	0	0	0	0	0
chr19:55181876:T:C	0	0	0	0	0	0	0	0
chr19:55191542:C:A	0	0	0	0	0	0	0	0
chr19:55202167:G:A	0	0	0	0	0	0	0	0
chr19:55203941:C:T	0	0	0	0	0	0	0	0
chr19:55203951:C:G	0	0	0	0	0	0	0	0
chr19:55227266:T:C	12	7	21	5	16	2.0	0.0	2.0
chr19:55228147:T:C	0	0	0	0	0	0	0	0
chr19:55228321:G:A	4	2	6	2	4	1.5	0.5	1.0
chr19:55228445:G:A	3	1	4	2	2	1	1	0
chr19:55245612:A:G	26	14	40	12	28	2.0	0.0	2.0
chr19:55279723:C:T	0	0	0	0	0	0	0	0
chr19:55342945:G:A	1	0	1	1	0	1	1	0
chr19:55365887:G:T	1	0	1	1	0	1	1	0
chr19:55368504:C:T	0	0	0	0	0	0	0	0
chr19:55369017:G:T	0	0	0	0	0	0	0	0
chr19:55454977:GGC:GGT	0	0	0	0	0	0	0	0
chr19:55482873:C:T	4	1	5	3	2	1.0	1.0	0.0
chr19:55483905:G:A	9	3	12	6	6	1	1	0
chr19:55500093:C:T	0	0	0	0	0	0	0	0
chr19:55500548:G:A	0	0	0	0	0	0	0	0
chr19:55536081:A:G	0	0	0	0	0	0	0	0
chr19:55541404:C:T	0	0	0	0	0	0	0	0
chr19:55544818:A:G	0	0	0	0	0	0	0	0
chr19:55602679:C:T	135	69	208	68	140	2	0	2
chr19:55642502:G:A	608	332	1049	329	720	2.0	1.0	2.0
chr19:55858227:T:C	8	7	16	2	14	2.0	0.0	2.0
chr19:55858800:C:T	7	6	14	2	12	2	0	2
chr19:55878871:A:T	4	3	7	1	6	2.0	0.0	2.0
chr19:55881509:T:G	5	4	9	1	8	2	0	2
chr19:55881554:C:T	5	1	6	4	2	1	1	0
chr19:55902166:G:A	0	0	0	0	0	0	0	0
chr19:55907897:T:C	0	0	0	0	0	0	0	0
chr19:55912302:G:A	0	0	0	0	0	0	0	0
chr19:55912326:C:T	0	0	0	0	0	0	0	0
chr19:55913077:T:C	0	0	0	0	0	0	0	0
chr19:55948092:C:T	0	0	0	0	0	0	0	0
chr19:55954861:A:G	0	0	0	0	0	0	0	0
chr19:55955915:A:G	0	0	0	0	0	0	0	0
chr19:55962094:T:C	0	0	0	0	0	0	0	0
chr19:55979412:C:T	0	0	0	0	0	0	0	0
chr19:55987913:G:C	0	0	0	0	0	0	0	0
chr19:55987979:A:G	0	0	0	0	0	0	0	0
chr19:56041090:G:T	0	0	0	0	0	0	0	0
chr19:56053798:G:A	0	0	0	0	0	0	0	0
chr19:56058263:C:G	0	0	0	0	0	0	0	0
chr19:56183136:C:T	0	0	0	0	0	0	0	0
chr19:56205984:A:G	0	0	0	0	0	0	0	0
chr19:56207216:A:G	0	0	0	0	0	0	0	0
chr19:56208036:A:C	0	0	0	0	0	0	0	0
chr19:56244098:A:G	0	0	0	0	0	0	0	0
chr19:56244105:GCCG:CACT	0	0	0	0	0	0	0	0
chr19:56244113:A:G	0	0	0	0	0	0	0	0
chr19:56244123:T:G	0	0	0	0	0	0	0	0
chr19:56244401:G:A	0	0	0	0	0	0	0	0
chr19:56384127:C:T	3	2	5	1	4	2	0	2
chr19:56525284:G:A	1	1	2	0	2	2	0	2
chr19:56553820:T:C	6	4	10	2	8	2.0	0.0	2.0
chr19:56554644:C:T	6	2	8	4	4	1.0	1.0	0.0
chr19:56574400:G:C	18	7	26	12	14	1.0	1.0	0.0
chr19:56577682:C:T	4	1	5	3	2	1.0	1.0	0.0
chr19:56578007:A:G	4	1	5	3	2	1.0	1.0	0.0
chr19:56664116:A:G	0	0	0	0	0	0	0	0
chr19:56664830:T:G	0	0	0	0	0	0	0	0
chr19:56664936:T:G	0	0	0	0	0	0	0	0
chr19:56665114:C:T	0	0	0	0	0	0	0	0
chr19:56782026:A:G	0	0	0	0	0	0	0	0
chr19:56782167:A:G	0	0	0	0	0	0	0	0
chr19:57138532:C:T	0	0	0	0	0	0	0	0
chr19:57291438:C:T	33	17	53	17	36	2	0	2
chr19:57291456:G:A	30	14	47	17	30	1.5	1.0	0.0
chr19:57443876:A:G	0	0	0	0	0	0	0	0
chr19:57445460:T:G	1	0	1	1	0	1	1	0
chr19:57455681:G:T	29	14	46	16	30	2	1	0
chr19:57455765:G:A	1	1	2	0	2	2	0	2
chr19:57473550:A:G	0	0	0	0	0	0	0	0
chr19:57491596:G:C	64	23	89	41	48	1.0	1.0	0.0
chr19:57500053:G:T	20	5	25	15	10	1.0	1.0	0.0
chr19:57507480:A:G	19	5	25	15	10	1	1	0
chr19:57547168:A:G	9	5	14	4	10	2	0	2
chr19:57547371:T:C	8	4	12	4	8	1.5	0.5	1.0
chr19:57605855:T:A	12	5	17	7	10	1.0	1.0	0.0
chr19:57702584:C:A	38	21	61	17	44	2.0	0.0	2.0
chr19:57720439:A:G	24	13	36	11	25	1.5	0.0	1.5
chr19:57779860:A:G	30	17	46	13	33	2.0	0.0	2.0
chr19:57814633:A:G	64	27	92	38	54	1.0	1.0	0.0
chr19:57849966:G:A	26	11	37	15	22	1.0	1.0	0.0
chr19:57850003:C:T	26	11	37	15	22	1.0	1.0	0.0
chr19:57850181:A:G	13	5	18	8	10	1	1	0
chr19:57859768:G:C	24	12	36	12	24	1.5	0.5	1.0
chr19:57908794:T:C	1	0	1	1	0	1	1	0
chr19:57909331:C:A	1	0	1	1	0	1	1	0
chr19:57979561:T:C	10	3	14	8	6	1.0	1.0	0.0
chr19:57980014:G:A	12	4	16	8	8	1.0	1.0	0.0
chr19:57999782:C:T	8	5	13	3	10	2.0	0.0	2.0
chr19:58037986:C:T	0	0	0	0	0	0	0	0
chr19:58037998:C:G	0	0	0	0	0	0	0	0
chr19:58054063:C:T	0	0	0	0	0	0	0	0
chr19:58061591:G:A	69	26	98	44	54	1	1	0
chr19:58085082:C:T	55	30	86	26	60	2	0	2
chr19:58279309:T:C	8	3	11	5	6	1.0	1.0	0.0
chr19:58434595:C:T	1	1	2	0	2	2	0	2
chr19:58499226:A:G	111	45	165	69	96	1	1	0
chr19:58549990:C:T	65	30	98	36	62	1	1	0
chr19:58556256:C:T	9	5	14	4	10	2	0	2
chr19:58562246:A:G	43	22	68	22	46	2	0	2
chr19:58563062:C:T	18	9	29	9	20	1.5	0.5	1.0
chr19:58563286:T:C	15	6	23	9	14	1	1	0
chr19:58571001:C:T	11	4	15	7	8	1	1	0
chr20:96321:T:C	0	0	0	0	0	0	0	0
chr20:188087:T:A	0	0	0	0	0	0	0	0
chr20:227262:T:C	0	0	0	0	0	0	0	0
chr20:229665:C:G	0	0	0	0	0	0	0	0
chr20:259295:G:A	0	0	0	0	0	0	0	0
chr20:298162:C:T	41	24	69	17	52	2	0	2
chr20:298839:T:C	31	18	49	13	36	2	0	2
chr20:391328:T:C	41	20	61	21	40	1	1	0
chr20:396582:C:T	43	22	65	21	44	2	0	2
chr20:410526:C:T	417	211	666	230	436	2	1	2
chr20:648569:T:C	1	1	2	0	2	2	0	2
chr20:845035:T:C	10	4	14	6	8	1.0	1.0	0.0
chr20:1118880:T:G	648	341	1050	345	705	2.0	1.0	2.0
chr20:1135276:A:G	655	336	1052	354	698	2	1	2
chr20:1297046:C:T	0	0	0	0	0	0	0	0
chr20:1305289:G:A	0	0	0	0	0	0	0	0
chr20:1310432:G:C	6	6	12	0	12	2.0	0.0	2.0
chr20:1312345:C:T	6	6	12	0	12	2.0	0.0	2.0
chr20:1312364:C:T	5	5	10	0	10	2	0	2
chr20:1312402:G:A	5	0	5	5	0	1	1	0
chr20:1312603:C:T	5	0	5	5	0	1	1	0
chr20:1443658:G:A	363	168	557	211	346	1	1	0
chr20:1445748:C:T	347	155	525	207	318	1	1	0
chr20:1551949:T:C	0	0	0	0	0	0	0	0
chr20:1551956:G:A	0	0	0	0	0	0	0	0
chr20:1557603:C:T	0	0	0	0	0	0	0	0
chr20:1566265:C:G	0	0	0	0	0	0	0	0
chr20:1570839:C:T	0	0	0	0	0	0	0	0
chr20:1571784:T:C	0	0	0	0	0	0	0	0
chr20:1619878:T:C	0	0	0	0	0	0	0	0
chr20:2317144:G:A	0	0	0	0	0	0	0	0
chr20:2394616:A:G	0	0	0	0	0	0	0	0
chr20:2417371:G:A	0	0	0	0	0	0	0	0
chr20:2483313:C:A	1	1	2	0	2	2	0	2
chr20:2558741:G:A	0	0	0	0	0	0	0	0
chr20:2656425:T:C	184	113	302	73	229	2.0	0.0	2.0
chr20:2758937:T:C	1	0	1	1	0	1	1	0
chr20:2795677:G:T	0	0	0	0	0	0	0	0
chr20:2816369:G:A	0	0	0	0	0	0	0	0
chr20:3252496:C:G	5	2	7	3	4	1	1	0
chr20:3298035:G:A	11	2	13	9	4	1	1	0
chr20:3381386:T:C	84	49	133	35	98	2.0	0.0	2.0
chr20:3584025:C:T	4	4	8	0	8	2.0	0.0	2.0
chr20:3644183:G:A	0	0	0	0	0	0	0	0
chr20:3661234:C:T	0	0	0	0	0	0	0	0
chr20:3669419:C:A	0	0	0	0	0	0	0	0
chr20:3669558:G:A	0	0	0	0	0	0	0	0
chr20:3671095:C:G	0	0	0	0	0	0	0	0
chr20:3672940:C:T	0	0	0	0	0	0	0	0
chr20:3673786:C:T	0	0	0	0	0	0	0	0
chr20:3674438:C:T	0	0	0	0	0	0	0	0
chr20:3692189:G:A	0	0	0	0	0	0	0	0
chr20:3694686:G:A	0	0	0	0	0	0	0	0
chr20:3694851:T:G	0	0	0	0	0	0	0	0
chr20:3697089:T:G	0	0	0	0	0	0	0	0
chr20:3701364:G:A	0	0	0	0	0	0	0	0
chr20:3701502:G:A	0	0	0	0	0	0	0	0
chr20:3701628:A:G	0	0	0	0	0	0	0	0
chr20:3703375:A:G	0	0	0	0	0	0	0	0
chr20:3705789:C:T	0	0	0	0	0	0	0	0
chr20:3803463:C:T	140	74	218	68	150	2.0	0.0	2.0
chr20:3866196:C:T	9	7	16	2	14	2	0	2
chr20:4182331:C:T	0	0	0	0	0	0	0	0
chr20:4182595:C:T	0	0	0	0	0	0	0	0
chr20:4789629:T:G	28	14	41	14	27	1.0	0.5	0.5
chr20:5302610:C:G	0	0	0	0	0	0	0	0
chr20:5302730:G:A	0	0	0	0	0	0	0	0
chr20:5578497:G:A	95	42	142	54	88	1	1	0
chr20:5922421:T:A	0	0	0	0	0	0	0	0
chr20:5922677:G:A	0	0	0	0	0	0	0	0
chr20:5923394:G:A	0	0	0	0	0	0	0	0
chr20:5925133:C:A	0	0	0	0	0	0	0	0
chr20:6770387:A:G	0	0	0	0	0	0	0	0
chr20:6778468:A:T	0	0	0	0	0	0	0	0
chr20:8716260:T:G	0	0	0	0	0	0	0	0
chr20:8774596:T:C	0	0	0	0	0	0	0	0
chr20:8881946:A:G	0	0	0	0	0	0	0	0
chr20:9307875:G:A	0	0	0	0	0	0	0	0
chr20:9516069:C:G	0	0	0	0	0	0	0	0
chr20:10049540:T:A	4	1	5	3	2	1.0	1.0	0.0
chr20:10051765:T:G	1	0	1	1	0	1	1	0
chr20:10405365:C:A	47	33	82	14	68	2	0	2
chr20:10405411:G:A	47	33	81	14	67	2	0	2
chr20:10412981:G:A	20	12	32	8	24	2.0	0.0	2.0
chr20:10413398:G:A	21	13	34	8	26	2	0	2
chr20:10622678:A:G	23	10	33	13	20	1	1	0
chr20:10623102:G:A	23	10	33	13	20	1	1	0
chr20:10639738:A:G	3	0	3	3	0	1	1	0
chr20:11918613:G:A	0	0	0	0	0	0	0	0
chr20:13049142:C:T	0	0	0	0	0	0	0	0
chr20:13072370:T:G	0	0	0	0	0	0	0	0
chr20:13715033:C:T	17	5	22	12	10	1	1	0
chr20:13766794:A:G	42	18	59	24	35	1.0	1.0	0.0
chr20:13990589:C:T	0	0	0	0	0	0	0	0
chr20:14326250:G:A	0	0	0	0	0	0	0	0
chr20:16273174:G:A	4	2	6	2	4	1.5	0.5	1.0
chr20:16506053:G:A	15	11	26	4	22	2	0	2
chr20:16749834:C:T	0	0	0	0	0	0	0	0
chr20:16749877:T:C	0	0	0	0	0	0	0	0
chr20:17494146:G:A	0	0	0	0	0	0	0	0
chr20:17494323:T:C	0	0	0	0	0	0	0	0
chr20:17614084:G:A	40	23	63	17	46	2.0	0.0	2.0
chr20:17615510:C:A	46	33	79	13	66	2.0	0.0	2.0
chr20:17619712:G:A	43	15	58	28	30	1	1	0
chr20:18384320:A:G	7	4	11	3	8	2	0	2
chr20:18415344:C:T	0	0	0	0	0	0	0	0
chr20:19280979:G:A	0	0	0	0	0	0	0	0
chr20:19580020:G:A	0	0	0	0	0	0	0	0
chr20:19935125:C:T	0	0	0	0	0	0	0	0
chr20:19970890:T:A	0	0	0	0	0	0	0	0
chr20:19990061:C:T	0	0	0	0	0	0	0	0
chr20:19990160:G:A	0	0	0	0	0	0	0	0
chr20:19990244:G:A	0	0	0	0	0	0	0	0
chr20:20052493:T:A	0	0	0	0	0	0	0	0
chr20:20164128:G:A	0	0	0	0	0	0	0	0
chr20:20512578:G:A	2	1	3	1	2	1.5	0.5	1.0
chr20:21161882:C:G	126	65	193	61	132	2.0	0.0	2.0
chr20:21162172:T:C	126	66	194	60	134	2.0	0.0	2.0
chr20:21513546:C:T	0	0	0	0	0	0	0	0
chr20:22582036:T:C	0	0	0	0	0	0	0	0
chr20:23036380:T:C	0	0	0	0	0	0	0	0
chr20:23036445:T:C	0	0	0	0	0	0	0	0
chr20:23048087:G:A	0	0	0	0	0	0	0	0
chr20:23084572:G:A	0	0	0	0	0	0	0	0
chr20:23750775:G:A	0	0	0	0	0	0	0	0
chr20:23750789:C:T	0	0	0	0	0	0	0	0
chr20:25078745:A:T	0	0	0	0	0	0	0	0
chr20:25078910:T:C	0	0	0	0	0	0	0	0
chr20:25206577:G:A	9	4	14	6	8	2	1	0
chr20:25213313:G:A	43	23	67	21	46	2	0	2
chr20:25278370:G:T	8	5	13	3	10	2.0	0.0	2.0
chr20:25282133:G:A	4	2	6	2	4	1.5	0.5	1.0
chr20:25453503:C:T	1	0	1	1	0	1	1	0
chr20:25476386:T:C	1	0	1	1	0	1	1	0
chr20:25479128:T:G	0	0	0	0	0	0	0	0
chr20:25489208:A:G	0	0	0	0	0	0	0	0
chr20:25676943:A:G	33	17	50	16	34	2	0	2
chr20:25686006:C:T	12	7	19	5	14	2.0	0.0	2.0
chr20:31476528:A:G	1	0	1	1	0	1	1	0
chr20:31538414:G:C	15	7	23	9	14	2	1	0
chr20:31569223:A:G	257	133	400	134	266	2	1	2
chr20:31605735:A:G	40	10	51	31	20	1.0	1.0	0.0
chr20:31793955:G:C	0	0	0	0	0	0	0	0
chr20:31794512:A:G	0	0	0	0	0	0	0	0
chr20:31844984:G:A	0	0	0	0	0	0	0	0
chr20:31845323:C:T	0	0	0	0	0	0	0	0
chr20:31845549:C:T	0	0	0	0	0	0	0	0
chr20:32165467:T:C	21	14	35	7	28	2	0	2
chr20:32208016:T:C	33	16	49	17	32	1	1	0
chr20:32327658:T:C	4	0	4	4	0	1.0	1.0	0.0
chr20:32331380:A:G	5	1	6	4	2	1	1	0
chr20:32431221:C:T	7	4	11	3	8	2	0	2
chr20:32436225:G:A	21	12	33	9	24	2	0	2
chr20:32451579:G:A	0	0	0	0	0	0	0	0
chr20:32650825:C:T	0	0	0	0	0	0	0	0
chr20:32798541:T:C	0	0	0	0	0	0	0	0
chr20:32798643:T:C	0	0	0	0	0	0	0	0
chr20:32839829:C:T	216	95	322	126	196	1.0	1.0	0.0
chr20:32878728:C:T	1	1	2	0	2	2	0	2
chr20:32930492:A:G	0	0	0	0	0	0	0	0
chr20:33008666:A:T	0	0	0	0	0	0	0	0
chr20:33288875:A:G	0	0	0	0	0	0	0	0
chr20:33306960:C:T	0	0	0	0	0	0	0	0
chr20:33624884:C:T	8	4	12	4	8	1.5	0.5	1.0
chr20:33667427:T:C	3	2	7	1	6	2	0	2
chr20:33678328:C:T	0	0	0	0	0	0	0	0
chr20:33707735:C:T	38	17	55	21	34	1.0	1.0	0.0
chr20:33791457:T:C	2	2	3	0	3	1.5	0.0	1.5
chr20:34979496:G:T	1	0	1	1	0	1	1	0
chr20:35267255:G:A	0	0	0	0	0	0	0	0
chr20:35501913:G:A	5	3	8	2	6	2	0	2
chr20:35511749:G:A	16	12	28	4	24	2.0	0.0	2.0
chr20:36786365:C:T	2	1	4	2	2	2.0	1.0	1.0
chr20:36794533:G:T	2	0	2	2	0	1.0	1.0	0.0
chr20:36839310:G:A	10	3	13	7	6	1.0	1.0	0.0
chr20:36879139:G:A	2	2	4	0	4	2.0	0.0	2.0
chr20:37137934:A:G	0	0	0	0	0	0	0	0
chr20:37141189:T:C	0	0	0	0	0	0	0	0
chr20:37236651:C:T	475	251	773	251	522	2	1	2
chr20:38213354:T:C	0	0	0	0	0	0	0	0
chr20:38213512:G:A	0	0	0	0	0	0	0	0
chr20:38217336:C:T	0	0	0	0	0	0	0	0
chr20:38260619:T:G	0	0	0	0	0	0	0	0
chr20:38637784:G:A	0	0	0	0	0	0	0	0
chr20:38748496:C:T	36	18	54	18	36	1.5	0.5	1.0
chr20:38754997:T:C	33	17	51	17	34	2	0	2
chr20:38767477:A:G	21	9	31	13	18	1	1	0
chr20:41349812:C:T	0	0	0	0	0	0	0	0
chr20:43534401:C:T	0	0	0	0	0	0	0	0
chr20:43536082:T:C	0	0	0	0	0	0	0	0
chr20:43715181:C:G	67	44	115	23	92	2	0	2
chr20:44006673:G:A	36	13	49	23	26	1.0	1.0	0.0
chr20:44114814:A:G	0	0	0	0	0	0	0	0
chr20:44263294:C:T	0	0	0	0	0	0	0	0
chr20:44620950:C:T	0	0	0	0	0	0	0	0
chr20:44624274:T:C	28	13	42	16	26	1.0	1.0	0.0
chr20:44727515:C:T	0	0	0	0	0	0	0	0
chr20:44750129:A:G	0	0	0	0	0	0	0	0
chr20:44901593:A:C	1591	893	3094	1006	2088	2	1	2
chr20:44901847:G:A	12	6	18	6	12	1.5	0.5	1.0
chr20:45094986:T:C	1	1	2	0	2	2	0	2
chr20:45208503:T:C	0	0	0	0	0	0	0	0
chr20:45297933:C:T	0	0	0	0	0	0	0	0
chr20:45409934:A:G	6	3	9	3	6	1.5	0.5	1.0
chr20:45420332:A:C	114	52	118	65	53	1.0	1.0	0.0
chr20:45512691:A:G	0	0	0	0	0	0	0	0
chr20:45547503:G:T	0	0	0	0	0	0	0	0
chr20:45555736:T:C	0	0	0	0	0	0	0	0
chr20:45630910:G:A	0	0	0	0	0	0	0	0
chr20:45684762:G:A	0	0	0	0	0	0	0	0
chr20:45685970:A:G	0	0	0	0	0	0	0	0
chr20:45774331:C:T	0	0	0	0	0	0	0	0
chr20:45843524:C:T	13	8	21	5	16	2	0	2
chr20:45950035:T:A	16	10	25	6	19	2.0	0.0	2.0
chr20:45950322:A:G	11	7	18	4	14	2	0	2
chr20:45963725:C:T	3	0	3	3	0	1	1	0
chr20:45963997:C:T	3	0	3	3	0	1	1	0
chr20:46035109:C:T	0	0	0	0	0	0	0	0
chr20:46128019:C:A	20	8	28	12	16	1.0	1.0	0.0
chr20:46178004:G:A	0	0	0	0	0	0	0	0
chr20:46178088:G:A	0	0	0	0	0	0	0	0
chr20:46358679:C:G	85	46	133	41	92	2	0	2
chr20:46545387:A:C	0	0	0	0	0	0	0	0
chr20:46575627:G:A	0	0	0	0	0	0	0	0
chr20:46592416:C:G	0	0	0	0	0	0	0	0
chr20:46613630:G:C	0	0	0	0	0	0	0	0
chr20:47636144:G:C	34	16	51	19	32	1.5	1.0	0.0
chr20:47639749:A:G	50	32	86	18	68	2.0	0.0	2.0
chr20:47651174:C:T	90	34	125	57	68	1.0	1.0	0.0
chr20:47736827:A:G	1	0	1	1	0	1	1	0
chr20:48625775:G:A	54	32	86	22	64	2.0	0.0	2.0
chr20:48642225:C:T	31	13	44	18	26	1	1	0
chr20:48644479:T:C	15	7	22	8	14	1	1	0
chr20:48650942:A:G	7	3	10	4	6	1	1	0
chr20:48651402:G:A	7	3	10	4	6	1	1	0
chr20:48652695:C:G	5	2	7	3	4	1	1	0
chr20:48657188:C:T	4	1	5	3	2	1.0	1.0	0.0
chr20:49230308:C:T	295	153	469	153	316	2	1	2
chr20:49513169:G:T	0	0	0	0	0	0	0	0
chr20:49642497:A:G	1	1	2	0	2	2	0	2
chr20:49815228:C:T	84	50	137	35	102	2.0	0.0	2.0
chr20:49849629:G:A	56	27	83	29	54	1.0	1.0	0.0
chr20:49905793:G:A	25	8	33	17	16	1	1	0
chr20:49906048:G:A	23	7	30	16	14	1	1	0
chr20:49908290:A:G	20	6	26	14	12	1.0	1.0	0.0
chr20:50278335:T:C	0	0	0	0	0	0	0	0
chr20:50278382:C:T	0	0	0	0	0	0	0	0
chr20:50579747:C:T	103	62	167	43	124	2	0	2
chr20:50594774:C:T	12	8	20	4	16	2.0	0.0	2.0
chr20:50597619:A:G	3	1	4	2	2	1	1	0
chr20:50602474:C:G	3	1	4	2	2	1	1	0
chr20:50750206:G:T	1	0	1	1	0	1	1	0
chr20:51790623:T:C	0	0	0	0	0	0	0	0
chr20:51790963:A:C	0	0	0	0	0	0	0	0
chr20:52152644:G:A	33	18	52	16	36	2	0	2
chr20:52152840:C:T	32	17	49	15	34	2.0	0.0	2.0
chr20:52153010:A:G	32	18	50	14	36	2.0	0.0	2.0
chr20:53185593:T:C	0	0	0	0	0	0	0	0
chr20:53966984:T:A	0	0	0	0	0	0	0	0
chr20:53996010:C:T	0	0	0	0	0	0	0	0
chr20:54028628:C:A	0	0	0	0	0	0	0	0
chr20:56495212:A:T	1	0	1	1	0	1	1	0
chr20:56497416:A:G	5	2	7	3	4	1	1	0
chr20:56513348:A:G	559	290	912	302	610	2	1	2
chr20:56536315:G:A	6	4	10	2	8	2.0	0.0	2.0
chr20:56634201:T:C	0	0	0	0	0	0	0	0
chr20:57523677:T:C	0	0	0	0	0	0	0	0
chr20:57562005:C:T	0	0	0	0	0	0	0	0
chr20:57563565:A:G	0	0	0	0	0	0	0	0
chr20:57563783:C:T	0	0	0	0	0	0	0	0
chr20:57564347:T:C	0	0	0	0	0	0	0	0
chr20:58669437:G:A	25	12	39	13	26	1	1	0
chr20:58691857:T:C	6	3	9	3	6	1.5	0.5	1.0
chr20:58693811:C:A	39	22	61	17	44	2	0	2
chr20:58903393:A:T	148	38	192	114	78	1.0	1.0	0.0
chr20:58903752:C:T	524	168	732	384	348	1.0	1.0	0.0
chr20:59191988:G:C	1	1	2	0	2	2	0	2
chr20:59192672:T:A	1	1	2	0	2	2	0	2
chr20:59193344:T:C	1	1	2	0	2	2	0	2
chr20:59193688:C:T	1	1	2	0	2	2	0	2
chr20:59194085:G:C	1	1	2	0	2	2	0	2
chr20:60069940:T:C	0	0	0	0	0	0	0	0
chr20:61773028:C:T	0	0	0	0	0	0	0	0
chr20:61928292:A:G	0	0	0	0	0	0	0	0
chr20:61934151:C:T	0	0	0	0	0	0	0	0
chr20:62009016:T:G	1	0	1	1	0	1	1	0
chr20:62197985:G:C	3	1	4	2	2	1	1	0
chr20:62216366:C:T	0	0	0	0	0	0	0	0
chr20:62216810:G:A	0	0	0	0	0	0	0	0
chr20:62318583:G:C	8	4	12	4	8	1.5	0.5	1.0
chr20:62387999:T:C	107	52	169	59	110	2	1	0
chr20:62388438:C:T	409	132	593	315	278	1	1	0
chr20:62465397:C:G	0	0	0	0	0	0	0	0
chr20:62465895:C:T	0	0	0	0	0	0	0	0
chr20:62473493:G:A	0	0	0	0	0	0	0	0
chr20:62565060:T:C	0	0	0	0	0	0	0	0
chr20:62570676:G:A	0	0	0	0	0	0	0	0
chr20:62570727:T:C	0	0	0	0	0	0	0	0
chr20:62656686:G:A	5	2	9	3	6	1	1	0
chr20:62657003:G:T	6	2	10	4	6	1.0	1.0	0.0
chr20:62812284:G:A	121	57	180	64	116	1	1	0
chr20:62812308:G:A	121	57	180	64	116	1	1	0
chr20:62812518:C:G	121	56	179	66	113	1	1	0
chr20:62813277:A:G	131	60	192	71	121	1	1	0
chr20:62837061:C:T	94	45	141	49	92	1.0	1.0	0.0
chr20:62857433:T:C	5	1	6	4	2	1	1	0
chr20:62888636:A:G	4	2	6	2	4	1.5	0.5	1.0
chr20:62896919:C:T	2	0	2	2	0	1.0	1.0	0.0
chr20:62953231:C:A	6	3	9	3	6	1.5	0.5	1.0
chr20:62956807:A:G	14	5	19	9	10	1.0	1.0	0.0
chr20:62964284:C:T	16	8	24	8	16	1.5	0.5	1.0
chr20:62967547:A:G	19	9	28	10	18	1	1	0
chr20:63203343:G:A	8	2	10	6	4	1.0	1.0	0.0
chr20:63349642:G:A	0	0	0	0	0	0	0	0
chr20:63407025:A:T	0	0	0	0	0	0	0	0
chr20:63494832:A:G	0	0	0	0	0	0	0	0
chr20:63540866:G:A	1	1	2	0	2	2	0	2
chr20:63542209:G:T	1	1	2	0	2	2	0	2
chr20:63543371:G:A	1	0	1	1	0	1	1	0
chr20:63555834:T:C	4	2	7	3	4	2.0	0.5	1.0
chr20:63559968:A:G	8	3	11	5	6	1.0	1.0	0.0
chr20:63560584:G:A	4	1	5	3	2	1.0	1.0	0.0
chr20:63562677:G:C	1	0	1	1	0	1	1	0
chr20:63562750:A:G	1	0	1	1	0	1	1	0
chr20:63562775:G:A	1	0	1	1	0	1	1	0
chr20:63563360:A:C	0	0	0	0	0	0	0	0
chr20:63563734:A:G	0	0	0	0	0	0	0	0
chr20:63563867:C:T	0	0	0	0	0	0	0	0
chr20:63564319:C:T	0	0	0	0	0	0	0	0
chr20:63564667:C:T	0	0	0	0	0	0	0	0
chr20:63564680:C:T	0	0	0	0	0	0	0	0
chr20:63564829:G:C	0	0	0	0	0	0	0	0
chr20:63564900:C:A	0	0	0	0	0	0	0	0
chr20:63566883:G:A	0	0	0	0	0	0	0	0
chr20:63570948:A:G	17	8	25	9	16	1	1	0
chr20:63572395:G:A	23	8	31	15	16	1	1	0
chr20:63590011:G:A	3	1	5	3	2	2	1	0
chr20:63590036:C:T	3	2	7	1	6	2	0	2
chr20:63590413:C:T	3	1	5	3	2	2	1	0
chr20:63678201:C:T	0	0	0	0	0	0	0	0
chr20:63678287:G:A	0	0	0	0	0	0	0	0
chr20:63689615:T:C	0	0	0	0	0	0	0	0
chr20:63690302:G:A	1	1	2	0	2	2	0	2
chr20:63690935:T:C	2	2	4	0	4	2.0	0.0	2.0
chr20:63694757:A:C	5	4	9	1	8	2	0	2
chr20:63696914:C:T	1	0	1	1	0	1	1	0
chr20:63697100:T:C	2	0	2	2	0	1.0	1.0	0.0
chr20:63697127:C:T	3	2	5	1	4	2	0	2
chr20:63697389:C:T	3	1	4	2	2	1	1	0
chr20:63700637:T:G	203	115	325	93	232	2	0	2
chr20:63701763:G:A	3	2	5	1	4	2	0	2
chr20:63734514:C:T	11	7	18	4	14	2	0	2
chr20:63735126:A:G	3	1	4	2	2	1	1	0
chr20:63741353:G:A	13	6	19	7	12	1	1	0
chr20:63747065:C:T	0	0	0	0	0	0	0	0
chr20:63960107:G:A	4	1	5	3	2	1.0	1.0	0.0
chr20:63964194:C:T	1	0	1	1	0	1	1	0
chr20:63964637:T:C	1	0	1	1	0	1	1	0
chr20:63966313:C:T	1	0	1	1	0	1	1	0
chr20:63967462:C:T	1	0	1	1	0	1	1	0
chr20:63981221:C:T	358	163	541	207	334	1.0	1.0	0.0
chr20:64092900:C:T	1	1	2	0	2	2	0	2
chr20:64106614:G:A	0	0	0	0	0	0	0	0
chr20:64232227:C:T	0	0	0	0	0	0	0	0
chr21:10413594:T:C	0	0	0	0	0	0	0	0
chr21:10602146:A:C	0	0	0	0	0	0	0	0
chr21:13384473:G:A	0	0	0	0	0	0	0	0
chr21:13384652:T:A	0	0	0	0	0	0	0	0
chr21:13526245:T:G	0	0	0	0	0	0	0	0
chr21:17796838:G:C	36	20	56	16	40	2.0	0.0	2.0
chr21:18279040:A:G	0	0	0	0	0	0	0	0
chr21:18341504:C:T	0	0	0	0	0	0	0	0
chr21:18857850:G:A	4	0	4	4	0	1.0	1.0	0.0
chr21:21508930:A:G	1	0	1	1	0	1	1	0
chr21:25724742:G:T	0	0	0	0	0	0	0	0
chr21:26840441:G:A	0	0	0	0	0	0	0	0
chr21:26844276:C:G	0	0	0	0	0	0	0	0
chr21:26844355:G:C	0	0	0	0	0	0	0	0
chr21:26844373:G:T	0	0	0	0	0	0	0	0
chr21:26844859:T:G	0	0	0	0	0	0	0	0
chr21:26845001:C:G	0	0	0	0	0	0	0	0
chr21:26924070:A:G	0	0	0	0	0	0	0	0
chr21:26966262:G:T	0	0	0	0	0	0	0	0
chr21:28945812:A:G	8	3	11	5	6	1.0	1.0	0.0
chr21:28945885:T:C	8	5	13	3	10	2.0	0.0	2.0
chr21:28969569:A:G	72	36	109	37	72	1.5	1.0	1.0
chr21:28984842:G:T	106	49	156	58	98	1.0	1.0	0.0
chr21:29061315:C:A	1152	437	1916	968	948	1.0	1.0	0.0
chr21:29073627:G:A	1134	785	2286	492	1794	2.0	0.0	2.0
chr21:29073640:G:A	609	322	1013	331	682	2	1	2
chr21:29109050:G:T	20	20	40	0	40	2.0	0.0	2.0
chr21:29342455:T:C	16	8	24	8	16	1.5	0.5	1.0
chr21:30166374:C:T	0	0	0	0	0	0	0	0
chr21:30215475:A:G	0	0	0	0	0	0	0	0
chr21:30215541:T:C	0	0	0	0	0	0	0	0
chr21:30289373:A:G	0	0	0	0	0	0	0	0
chr21:30320059:A:C	0	0	0	0	0	0	0	0
chr21:30337373:G:A	0	0	0	0	0	0	0	0
chr21:30371809:A:T	0	0	0	0	0	0	0	0
chr21:30371992:G:C	0	0	0	0	0	0	0	0
chr21:30829504:G:T	0	0	0	0	0	0	0	0
chr21:30829517:A:C	0	0	0	0	0	0	0	0
chr21:30829548:A:G	0	0	0	0	0	0	0	0
chr21:30829633:A:G	0	0	0	0	0	0	0	0
chr21:30880918:G:A	0	0	0	0	0	0	0	0
chr21:30881194:A:T	0	0	0	0	0	0	0	0
chr21:30881310:C:T	0	0	0	0	0	0	0	0
chr21:31038300:A:G	0	0	0	0	0	0	0	0
chr21:31995875:T:C	0	0	0	0	0	0	0	0
chr21:31998587:T:C	0	0	0	0	0	0	0	0
chr21:31998810:C:T	0	0	0	0	0	0	0	0
chr21:31999227:T:G	0	0	0	0	0	0	0	0
chr21:32321914:C:G	1	1	2	0	2	2	0	2
chr21:32347386:C:T	0	0	0	0	0	0	0	0
chr21:32383454:G:A	8	4	12	4	8	1.5	0.5	1.0
chr21:32467858:T:G	2	1	3	1	2	1.5	0.5	1.0
chr21:32467900:A:G	2	1	3	1	2	1.5	0.5	1.0
chr21:32514821:G:A	9	6	15	3	12	2	0	2
chr21:32576749:G:A	1	1	2	0	2	2	0	2
chr21:32578758:T:C	1	1	2	0	2	2	0	2
chr21:32584269:T:C	0	0	0	0	0	0	0	0
chr21:33324959:T:C	20	4	24	16	8	1.0	1.0	0.0
chr21:33465316:C:A	12	6	18	6	12	1.5	0.5	1.0
chr21:33511311:T:C	26	10	36	16	20	1.0	1.0	0.0
chr21:33520589:C:T	2	1	3	1	2	1.5	0.5	1.0
chr21:33551937:T:C	9	6	15	3	12	2	0	2
chr21:33553383:G:A	59	27	88	32	56	1	1	0
chr21:33867258:A:G	0	0	0	0	0	0	0	0
chr21:33888177:T:C	0	0	0	0	0	0	0	0
chr21:34517934:G:A	14	6	20	8	12	1.0	1.0	0.0
chr21:34521344:A:G	4	2	6	2	4	1.5	0.5	1.0
chr21:34523734:A:G	1	0	1	1	0	1	1	0
chr21:34821574:T:C	5	1	6	4	2	1	1	0
chr21:36050668:C:T	0	0	0	0	0	0	0	0
chr21:36130652:G:T	0	0	0	0	0	0	0	0
chr21:36135203:G:A	7	3	10	4	6	1	1	0
chr21:36135471:C:T	7	3	10	5	5	1	1	0
chr21:36146408:G:A	5	3	8	2	6	2	0	2
chr21:36230898:C:T	2	0	2	2	0	1.0	1.0	0.0
chr21:36245332:T:G	8	3	11	5	6	1.0	1.0	0.0
chr21:36745007:C:A	0	0	0	0	0	0	0	0
chr21:37072590:A:G	39	24	66	16	50	2	0	2
chr21:37072695:A:G	38	23	62	16	46	2.0	0.0	2.0
chr21:37088188:T:A	8	5	13	3	10	2.0	0.0	2.0
chr21:37096658:A:G	11	2	13	9	4	1	1	0
chr21:37153056:T:C	68	29	105	41	64	1.0	1.0	0.0
chr21:37195708:G:C	18	6	25	13	12	1.0	1.0	0.0
chr21:37196007:C:T	24	10	35	15	20	1.0	1.0	0.0
chr21:39348568:C:T	1981	1140	4024	1325	2699	2	1	2
chr21:39428445:C:T	4	2	6	2	4	1.5	0.5	1.0
chr21:39451976:C:G	0	0	0	0	0	0	0	0
chr21:39661135:G:A	0	0	0	0	0	0	0	0
chr21:39771005:C:T	0	0	0	0	0	0	0	0
chr21:39793535:C:A	0	0	0	0	0	0	0	0
chr21:40044139:C:T	0	0	0	0	0	0	0	0
chr21:40075131:G:C	0	0	0	0	0	0	0	0
chr21:40083927:G:A	0	0	0	0	0	0	0	0
chr21:40312163:C:T	0	0	0	0	0	0	0	0
chr21:41250859:C:T	197	119	334	86	248	2	0	2
chr21:41275569:G:A	232	98	346	144	202	1.0	1.0	0.0
chr21:41345735:T:C	0	0	0	0	0	0	0	0
chr21:41473456:A:G	0	0	0	0	0	0	0	0
chr21:41740862:C:T	0	0	0	0	0	0	0	0
chr21:41741645:G:A	0	0	0	0	0	0	0	0
chr21:41741717:C:T	0	0	0	0	0	0	0	0
chr21:41741990:G:A	0	0	0	0	0	0	0	0
chr21:41744072:C:A	0	0	0	0	0	0	0	0
chr21:41801666:T:C	3	3	6	0	6	2	0	2
chr21:41810915:A:G	3	2	7	1	6	2	0	2
chr21:41810940:A:T	3	1	5	3	2	2	1	0
chr21:41815820:G:A	1	1	2	0	2	2	0	2
chr21:41907684:C:T	1	1	2	0	2	2	0	2
chr21:41907747:A:G	1	0	1	1	0	1	1	0
chr21:42084118:T:C	0	0	0	0	0	0	0	0
chr21:42090327:A:C	0	0	0	0	0	0	0	0
chr21:42102239:T:C	0	0	0	0	0	0	0	0
chr21:42111154:C:G	0	0	0	0	0	0	0	0
chr21:42111443:A:C	0	0	0	0	0	0	0	0
chr21:42111698:A:C	0	0	0	0	0	0	0	0
chr21:42127763:G:A	0	0	0	0	0	0	0	0
chr21:42137449:T:A	0	0	0	0	0	0	0	0
chr21:42137588:A:C	0	0	0	0	0	0	0	0
chr21:42137626:G:A	0	0	0	0	0	0	0	0
chr21:42219956:C:G	582	307	1047	341	706	2.0	1.0	2.0
chr21:42346451:G:A	0	0	0	0	0	0	0	0
chr21:42388518:C:T	0	0	0	0	0	0	0	0
chr21:42432123:C:T	0	0	0	0	0	0	0	0
chr21:42434875:A:C	0	0	0	0	0	0	0	0
chr21:42476033:C:T	0	0	0	0	0	0	0	0
chr21:42485777:C:T	0	0	0	0	0	0	0	0
chr21:42496229:G:A	0	0	0	0	0	0	0	0
chr21:43755690:C:A	0	0	0	0	0	0	0	0
chr21:43756077:T:C	52	26	79	27	52	2.0	0.5	1.0
chr21:43774109:T:C	1696	975	3531	1195	2336	2.0	1.0	2.0
chr21:44259644:G:A	0	0	0	0	0	0	0	0
chr21:44288394:C:T	0	0	0	0	0	0	0	0
chr21:44289685:C:T	0	0	0	0	0	0	0	0
chr21:44293094:T:C	0	0	0	0	0	0	0	0
chr21:44312233:C:T	131	57	190	76	114	1	1	0
chr21:44314028:G:A	1	0	1	1	0	1	1	0
chr21:44325098:TC:TG	3	0	3	3	0	1	1	0
chr21:44330463:C:A	28	4	32	24	8	1.0	1.0	0.0
chr21:44400313:C:T	0	0	0	0	0	0	0	0
chr21:44441907:T:C	0	0	0	0	0	0	0	0
chr21:44539214:A:C	0	0	0	0	0	0	0	0
chr21:44539312:G:A	0	0	0	0	0	0	0	0
chr21:44539429:C:T	0	0	0	0	0	0	0	0
chr21:44539503:G:A	0	0	0	0	0	0	0	0
chr21:44539674:ATC:TGA	0	0	0	0	0	0	0	0
chr21:44539850:C:T	0	0	0	0	0	0	0	0
chr21:44540035:G:A	0	0	0	0	0	0	0	0
chr21:44558708:G:A	0	0	0	0	0	0	0	0
chr21:44574966:G:C	0	0	0	0	0	0	0	0
chr21:44580521:C:T	0	0	0	0	0	0	0	0
chr21:44681773:C:T	0	0	0	0	0	0	0	0
chr21:44851537:C:T	44	27	71	17	54	2.0	0.0	2.0
chr21:44973175:C:T	1	1	2	0	2	2	0	2
chr21:45285706:G:A	39	15	54	24	30	1	1	0
chr21:45478329:C:G	14	6	20	8	12	1.0	1.0	0.0
chr21:45509553:G:A	14	9	23	5	18	2.0	0.0	2.0
chr21:45512414:G:A	23	15	42	8	34	2	0	2
chr21:45512469:G:A	24	15	43	9	34	2.0	0.0	2.0
chr21:45514947:A:C	0	0	0	0	0	0	0	0
chr21:45531642:A:G	1	1	2	0	2	2	0	2
chr21:45537880:T:C	1	1	2	0	2	2	0	2
chr21:45538002:G:A	1	1	2	0	2	2	0	2
chr21:45914381:TGG:CGA	0	0	0	0	0	0	0	0
chr21:45914500:C:T	0	0	0	0	0	0	0	0
chr21:45984388:G:A	0	0	0	0	0	0	0	0
chr21:46000812:C:G	0	0	0	0	0	0	0	0
chr21:46000847:G:A	0	0	0	0	0	0	0	0
chr21:46000855:A:G	0	0	0	0	0	0	0	0
chr21:46002498:C:T	0	0	0	0	0	0	0	0
chr21:46003662:C:T	0	0	0	0	0	0	0	0
chr21:46119046:G:A	0	0	0	0	0	0	0	0
chr21:46132216:A:G	0	0	0	0	0	0	0	0
chr21:46132471:C:T	0	0	0	0	0	0	0	0
chr21:46136879:C:T	0	0	0	0	0	0	0	0
chr21:46136895:C:T	0	0	0	0	0	0	0	0
chr21:46138559:G:C	0	0	0	0	0	0	0	0
chr21:46138638:G:A	0	0	0	0	0	0	0	0
chr21:46151931:C:T	0	0	0	0	0	0	0	0
chr21:46152330:G:A	0	0	0	0	0	0	0	0
chr21:46182805:G:A	1	1	2	0	2	2	0	2
chr21:46314928:ACG:GCA	1	1	2	0	2	2	0	2
chr21:46318299:G:A	0	0	0	0	0	0	0	0
chr21:46355510:C:T	6	3	9	3	6	1.5	0.5	1.0
chr21:46443844:A:C	8	4	11	4	7	1.0	0.5	0.5
chr21:46490610:A:G	73	32	109	41	68	1	1	0
chr21:46498749:C:G	71	40	113	33	80	2	0	2
chr21:46550668:G:A	6	0	6	6	0	1.0	1.0	0.0
chr21:46554669:A:G	23	17	41	7	34	2	0	2
chr21:46565742:C:T	14	6	20	8	12	1.0	1.0	0.0
chr21:46567634:C:T	17	8	25	9	16	1	1	0
chr21:46599324:CCG:GCA	0	0	0	0	0	0	0	0
chr21:46602317:C:G	0	0	0	0	0	0	0	0
chr21:46658699:G:A	3	2	5	1	4	2	0	2
chr22:16390407:A:G	0	0	0	0	0	0	0	0
chr22:16390737:A:G	0	0	0	0	0	0	0	0
chr22:16390780:C:T	0	0	0	0	0	0	0	0
chr22:16433453:AGAT:GGAC	0	0	0	0	0	0	0	0
chr22:16574568:G:A	0	0	0	0	0	0	0	0
chr22:16595383:G:A	0	0	0	0	0	0	0	0
chr22:16694664:G:A	0	0	0	0	0	0	0	0
chr22:16695047:G:T	0	0	0	0	0	0	0	0
chr22:16696856:A:G	0	0	0	0	0	0	0	0
chr22:16697294:T:C	0	0	0	0	0	0	0	0
chr22:16697314:G:A	0	0	0	0	0	0	0	0
chr22:16697323:A:G	0	0	0	0	0	0	0	0
chr22:16697442:G:T	0	0	0	0	0	0	0	0
chr22:16697589:C:A	0	0	0	0	0	0	0	0
chr22:16697696:G:A	0	0	0	0	0	0	0	0
chr22:16784014:A:G	0	0	0	0	0	0	0	0
chr22:16784304:G:A	0	0	0	0	0	0	0	0
chr22:17145025:G:A	89	44	134	46	88	2	1	0
chr22:17149596:C:A	76	31	108	46	62	1.0	1.0	0.0
chr22:17188416:T:C	46	6	52	40	12	1.0	1.0	0.0
chr22:17199629:A:C	0	0	0	0	0	0	0	0
chr22:17209519:G:A	32	15	47	17	30	1.0	1.0	0.0
chr22:17541915:C:T	0	0	0	0	0	0	0	0
chr22:17628665:T:C	361	206	586	168	418	2	0	2
chr22:17696093:C:T	1	1	2	0	2	2	0	2
chr22:17726952:C:T	15	7	22	8	14	1	1	0
chr22:17727154:C:T	14	7	21	7	14	1.5	0.5	1.0
chr22:17738065:A:G	67	37	109	33	76	2	0	2
chr22:17739497:A:G	2	1	3	1	2	1.5	0.5	1.0
chr22:17790697:G:A	0	0	0	0	0	0	0	0
chr22:17817474:T:C	0	0	0	0	0	0	0	0
chr22:17817828:G:A	0	0	0	0	0	0	0	0
chr22:17818113:G:A	0	0	0	0	0	0	0	0
chr22:17818927:T:C	9	2	11	7	4	1	1	0
chr22:17872000:C:T	2	1	3	1	2	1.5	0.5	1.0
chr22:18167915:C:T	16	9	25	7	18	2.0	0.0	2.0
chr22:19039100:A:G	15	4	22	12	10	1	1	0
chr22:19132032:C:T	0	0	0	0	0	0	0	0
chr22:19132173:C:T	0	0	0	0	0	0	0	0
chr22:19132238:C:T	0	0	0	0	0	0	0	0
chr22:19132425:G:A	0	0	0	0	0	0	0	0
chr22:19135152:C:T	21	11	32	10	22	2	0	2
chr22:19763250:T:C	0	0	0	0	0	0	0	0
chr22:19764306:C:T	0	0	0	0	0	0	0	0
chr22:19779259:C:T	0	0	0	0	0	0	0	0
chr22:19802018:A:C	103	59	162	44	118	2	0	2
chr22:19821246:C:T	82	39	121	43	78	1.0	1.0	0.0
chr22:19880248:C:T	39	12	52	29	23	1	1	0
chr22:19883574:C:G	1	0	1	1	0	1	1	0
chr22:19895107:G:A	15	4	19	11	8	1	1	0
chr22:19895461:T:G	49	16	67	35	32	1	1	0
chr22:19911314:A:G	6	3	9	3	6	1.5	0.5	1.0
chr22:19918988:G:A	87	32	120	56	64	1	1	0
chr22:19919595:G:A	87	32	120	56	64	1	1	0
chr22:20115014:C:T	50	24	74	26	48	1.0	1.0	0.0
chr22:20574999:C:G	6	2	8	4	4	1.0	1.0	0.0
chr22:20584488:T:C	1	0	1	1	0	1	1	0
chr22:20584836:G:A	1	0	1	1	0	1	1	0
chr22:20973300:C:T	0	0	0	0	0	0	0	0
chr22:20983036:G:A	27	12	41	15	26	1	1	0
chr22:21023012:C:A	0	0	0	0	0	0	0	0
chr22:21031696:C:T	0	0	0	0	0	0	0	0
chr22:21628603:C:T	299	160	479	151	328	2	0	2
chr22:21629916:A:G	372	201	604	190	414	2.0	0.0	2.0
chr22:21634235:C:T	0	0	0	0	0	0	0	0
chr22:21634313:C:T	0	0	0	0	0	0	0	0
chr22:21636783:T:C	0	0	0	0	0	0	0	0
chr22:21684910:C:T	78	30	108	48	60	1.0	1.0	0.0
chr22:21695080:G:T	3	2	5	1	4	2	0	2
chr22:21701105:A:G	79	38	122	44	78	2	1	0
chr22:21963982:T:C	31	14	45	17	28	1	1	0
chr22:22117491:C:T	119	67	189	53	136	2	0	2
chr22:22117592:G:A	122	68	193	55	138	2.0	0.0	2.0
chr22:22117636:C:T	121	67	191	55	136	2	0	2
chr22:22117666:G:A	122	68	193	55	138	2.0	0.0	2.0
chr22:22117706:A:G	121	68	191	54	137	2	0	2
chr22:22117798:C:T	121	67	192	56	136	2	0	2
chr22:22117820:G:A	121	67	191	56	135	2	0	2
chr22:22901187:T:C	67	27	118	60	58	1	1	0
chr22:22906669:T:A	10	5	17	7	10	1.5	1.0	1.0
chr22:23160983:A:G	0	0	0	0	0	0	0	0
chr22:23161569:G:A	0	0	0	0	0	0	0	0
chr22:23283894:G:A	0	0	0	0	0	0	0	0
chr22:23289614:T:C	0	0	0	0	0	0	0	0
chr22:23290326:A:G	0	0	0	0	0	0	0	0
chr22:23290434:G:C	0	0	0	0	0	0	0	0
chr22:23290449:C:A	0	0	0	0	0	0	0	0
chr22:23692101:A:G	1	0	1	1	0	1	1	0
chr22:23695119:T:G	5	3	8	2	6	2	0	2
chr22:23743920:A:G	2	1	3	1	2	1.5	0.5	1.0
chr22:23765614:T:C	4	1	5	3	2	1.0	1.0	0.0
chr22:23779191:C:T	11	2	14	10	4	1	1	0
chr22:23803208:A:G	3	1	4	2	2	1	1	0
chr22:23803488:G:C	5	2	7	3	4	1	1	0
chr22:23816712:C:A	4	2	6	2	4	1.5	0.5	1.0
chr22:23837735:G:C	38	23	64	16	48	2.0	0.0	2.0
chr22:24248136:T:C	0	0	0	0	0	0	0	0
chr22:24248603:C:T	0	0	0	0	0	0	0	0
chr22:24249332:T:C	0	0	0	0	0	0	0	0
chr22:24260742:A:G	0	0	0	0	0	0	0	0
chr22:24321550:G:A	21	10	31	11	20	1	1	0
chr22:24441333:T:C	88	43	131	45	86	1.0	1.0	0.0
chr22:24495324:C:G	0	0	0	0	0	0	0	0
chr22:24502342:C:T	1	1	2	0	2	2	0	2
chr22:24749504:A:G	0	0	0	0	0	0	0	0
chr22:24762359:A:G	0	0	0	0	0	0	0	0
chr22:24855060:T:C	68	30	98	38	60	1.0	1.0	0.0
chr22:24886605:C:T	14	11	25	3	22	2.0	0.0	2.0
chr22:25029315:A:G	0	0	0	0	0	0	0	0
chr22:25039583:C:T	0	0	0	0	0	0	0	0
chr22:25040937:T:C	0	0	0	0	0	0	0	0
chr22:25049438:G:T	0	0	0	0	0	0	0	0
chr22:25181721:G:A	0	0	0	0	0	0	0	0
chr22:25181766:T:C	0	0	0	0	0	0	0	0
chr22:25205229:C:G	0	0	0	0	0	0	0	0
chr22:25319956:G:A	0	0	0	0	0	0	0	0
chr22:25357264:G:A	14	6	20	8	12	1.0	1.0	0.0
chr22:25357354:G:A	13	8	21	5	16	2	0	2
chr22:25843883:C:A	0	0	0	0	0	0	0	0
chr22:25851489:G:A	0	0	0	0	0	0	0	0
chr22:25876277:C:T	0	0	0	0	0	0	0	0
chr22:25898546:A:G	0	0	0	0	0	0	0	0
chr22:26540931:G:A	204	121	339	89	250	2.0	0.0	2.0
chr22:26541454:G:A	196	118	326	84	242	2.0	0.0	2.0
chr22:26625493:T:C	1	1	2	0	2	2	0	2
chr22:29060711:A:G	0	0	0	0	0	0	0	0
chr22:29137511:G:A	0	0	0	0	0	0	0	0
chr22:29137584:C:G	0	0	0	0	0	0	0	0
chr22:29225139:C:G	0	0	0	0	0	0	0	0
chr22:29234348:G:A	0	0	0	0	0	0	0	0
chr22:29260400:G:T	22	13	37	9	28	2.0	0.0	2.0
chr22:29311966:A:T	0	0	0	0	0	0	0	0
chr22:29340785:G:A	23	10	33	13	20	1	1	0
chr22:29359899:T:C	79	47	128	32	96	2	0	2
chr22:30287296:C:G	0	0	0	0	0	0	0	0
chr22:30292670:C:T	83	53	139	31	108	2	0	2
chr22:30304618:T:G	71	45	116	26	90	2	0	2
chr22:30337122:C:A	47	23	72	24	48	1	1	0
chr22:30342748:G:A	11	7	18	4	14	2	0	2
chr22:30365951:G:C	1	0	1	1	0	1	1	0
chr22:30366046:A:G	5	2	7	3	4	1	1	0
chr22:30366151:G:A	5	3	8	2	6	2	0	2
chr22:30369513:G:A	2	0	2	2	0	1.0	1.0	0.0
chr22:30371740:A:G	0	0	0	0	0	0	0	0
chr22:30371792:C:T	0	0	0	0	0	0	0	0
chr22:30373912:G:C	3	1	4	2	2	1	1	0
chr22:30373917:T:C	3	1	4	2	2	1	1	0
chr22:30374168:T:C	1	0	1	1	0	1	1	0
chr22:30375469:T:C	5	2	7	3	4	1	1	0
chr22:30379686:G:A	2	2	4	0	4	2.0	0.0	2.0
chr22:30380106:C:T	1	1	2	0	2	2	0	2
chr22:30416560:C:G	0	0	0	0	0	0	0	0
chr22:30489993:G:A	0	0	0	0	0	0	0	0
chr22:30491459:T:C	0	0	0	0	0	0	0	0
chr22:30492507:C:T	0	0	0	0	0	0	0	0
chr22:30495263:T:C	0	0	0	0	0	0	0	0
chr22:30495307:G:C	0	0	0	0	0	0	0	0
chr22:30505605:T:C	0	0	0	0	0	0	0	0
chr22:30525384:T:C	0	0	0	0	0	0	0	0
chr22:30531988:C:T	0	0	0	0	0	0	0	0
chr22:30538900:G:A	0	0	0	0	0	0	0	0
chr22:30557308:C:T	1	0	1	1	0	1	1	0
chr22:30591874:G:C	39	22	61	17	44	2	0	2
chr22:30615623:G:C	2	0	2	2	0	1.0	1.0	0.0
chr22:30617562:G:A	0	0	0	0	0	0	0	0
chr22:30636933:A:G	11	5	16	6	10	1	1	0
chr22:31083085:C:T	0	0	0	0	0	0	0	0
chr22:31087948:T:C	0	0	0	0	0	0	0	0
chr22:31088202:G:T	0	0	0	0	0	0	0	0
chr22:31090008:G:T	9	7	16	2	14	2	0	2
chr22:31091715:C:T	11	7	18	4	14	2	0	2
chr22:31095346:C:T	12	7	19	5	14	2.0	0.0	2.0
chr22:31101124:G:T	2	0	2	2	0	1.0	1.0	0.0
chr22:31105802:T:C	58	31	91	29	62	2.0	0.5	2.0
chr22:31105995:G:A	39	19	59	21	38	2	1	0
chr22:31136974:C:T	0	0	0	0	0	0	0	0
chr22:32193103:C:T	0	0	0	0	0	0	0	0
chr22:32399654:C:T	169	79	251	93	158	1	1	0
chr22:32399764:A:G	15	8	23	7	16	2	0	2
chr22:32447248:T:C	0	0	0	0	0	0	0	0
chr22:32475240:C:T	202	94	303	113	190	1.0	1.0	0.0
chr22:32475396:T:G	258	118	391	149	242	1.0	1.0	0.0
chr22:32479203:G:A	390	179	600	232	368	1.0	1.0	0.0
chr22:32491011:T:C	4	3	7	1	6	2.0	0.0	2.0
chr22:33626300:G:A	0	0	0	0	0	0	0	0
chr22:35067256:C:T	0	0	0	0	0	0	0	0
chr22:35082536:G:A	0	0	0	0	0	0	0	0
chr22:35085500:C:T	0	0	0	0	0	0	0	0
chr22:35410763:G:A	264	129	409	147	262	2.0	1.0	0.0
chr22:35551538:C:A	0	0	0	0	0	0	0	0
chr22:35552073:G:A	0	0	0	0	0	0	0	0
chr22:35726883:C:T	0	0	0	0	0	0	0	0
chr22:35728813:C:G	0	0	0	0	0	0	0	0
chr22:36141452:A:T	34	18	53	17	36	2.0	0.5	2.0
chr22:36141623:T:G	34	18	53	17	36	2.0	0.5	2.0
chr22:36149089:A:T	28	16	44	12	32	2.0	0.0	2.0
chr22:36160775:G:T	60	34	97	27	70	2.0	0.0	2.0
chr22:36160916:C:T	0	0	0	0	0	0	0	0
chr22:36191154:G:A	4	0	4	4	0	1.0	1.0	0.0
chr22:36191231:A:G	4	0	4	4	0	1.0	1.0	0.0
chr22:36191438:A:G	4	0	4	4	0	1.0	1.0	0.0
chr22:36191463:C:T	4	0	4	4	0	1.0	1.0	0.0
chr22:36191634:C:T	4	4	8	0	8	2.0	0.0	2.0
chr22:36191906:C:T	4	0	4	4	0	1.0	1.0	0.0
chr22:36195334:A:G	3	0	3	3	0	1	1	0
chr22:36201831:GTGCG:ATGCT	3	1	4	2	2	1	1	0
chr22:36254910:G:A	0	0	0	0	0	0	0	0
chr22:36937615:C:A	1	0	1	1	0	1	1	0
chr22:37011068:G:C	5	1	6	4	2	1	1	0
chr22:37084229:A:G	1	1	2	0	2	2	0	2
chr22:37128579:G:T	10	6	16	4	12	2.0	0.0	2.0
chr22:37135396:G:A	22	15	37	7	30	2.0	0.0	2.0
chr22:37182174:T:C	11	7	18	4	14	2	0	2
chr22:37182539:C:T	9	5	14	4	10	2	0	2
chr22:37182767:G:A	0	0	0	0	0	0	0	0
chr22:37182812:C:T	0	0	0	0	0	0	0	0
chr22:37185382:G:C	10	5	15	5	10	1.5	0.5	1.0
chr22:37303336:T:C	32	16	49	17	32	1.5	1.0	1.0
chr22:37311031:C:T	25	15	40	10	30	2	0	2
chr22:37311941:G:A	12	6	18	6	12	1.5	0.5	1.0
chr22:37374026:G:T	0	0	0	0	0	0	0	0
chr22:37374317:A:G	0	0	0	0	0	0	0	0
chr22:37374590:G:A	0	0	0	0	0	0	0	0
chr22:37375118:G:A	0	0	0	0	0	0	0	0
chr22:37504269:A:G	0	0	0	0	0	0	0	0
chr22:37504755:G:A	0	0	0	0	0	0	0	0
chr22:37566576:G:A	0	0	0	0	0	0	0	0
chr22:37568292:C:G	0	0	0	0	0	0	0	0
chr22:37848209:C:T	15	7	23	9	14	2	1	0
chr22:37927500:G:T	3	1	4	2	2	1	1	0
chr22:37945127:T:C	2	1	3	1	2	1.5	0.5	1.0
chr22:37973969:A:G	0	0	0	0	0	0	0	0
chr22:38067645:T:G	3	3	6	0	6	2	0	2
chr22:38071777:G:C	0	0	0	0	0	0	0	0
chr22:38078689:A:G	0	0	0	0	0	0	0	0
chr22:38081923:G:A	0	0	0	0	0	0	0	0
chr22:38139939:G:A	1	0	1	1	0	1	1	0
chr22:38143034:T:C	0	0	0	0	0	0	0	0
chr22:38231333:G:A	21	11	32	10	22	2	0	2
chr22:38751230:A:C	6	5	11	1	10	2.0	0.0	2.0
chr22:38985821:A:G	28	14	42	14	28	1.5	0.5	1.0
chr22:38985994:T:C	33	15	50	18	32	1	1	0
chr22:38991553:C:T	34	15	51	19	32	1.0	1.0	0.0
chr22:39032391:C:G	53	30	85	23	62	2	0	2
chr22:39044144:C:T	18	3	23	17	6	1.0	1.0	0.0
chr22:39045091:G:T	22	14	38	8	30	2.0	0.0	2.0
chr22:39045198:C:T	21	13	34	8	26	2	0	2
chr22:39049549:G:A	15	10	25	5	20	2	0	2
chr22:39052706:C:A	28	16	44	12	32	2.0	0.0	2.0
chr22:39052745:T:C	30	18	48	12	36	2.0	0.0	2.0
chr22:39081118:T:C	1030	644	2030	538	1492	2.0	0.0	2.0
chr22:39100331:G:T	80	50	133	31	102	2.0	0.0	2.0
chr22:39100407:G:C	80	50	134	32	102	2.0	0.0	2.0
chr22:39102033:G:C	78	45	126	34	92	2.0	0.0	2.0
chr22:39134127:C:A	0	0	0	0	0	0	0	0
chr22:39313004:G:A	9	5	14	4	10	2	0	2
chr22:39313771:T:C	11	8	19	3	16	2	0	2
chr22:39314239:G:A	7	4	11	3	8	2	0	2
chr22:39318485:C:T	3588	2398	11527	4058	7469	3.0	1.0	2.0
chr22:39319603:C:T	3495	2241	10766	4017	6749	2	1	2
chr22:39570851:C:T	0	0	0	0	0	0	0	0
chr22:39658943:T:C	0	0	0	0	0	0	0	0
chr22:39661268:T:C	0	0	0	0	0	0	0	0
chr22:39875610:C:G	0	0	0	0	0	0	0	0
chr22:39887423:A:G	0	0	0	0	0	0	0	0
chr22:40301373:A:G	6	3	9	3	6	1.5	0.5	1.0
chr22:40926388:C:G	20	16	36	4	32	2.0	0.0	2.0
chr22:41330049:G:A	59	30	89	29	60	2	0	2
chr22:41356743:G:A	1	1	2	0	2	2	0	2
chr22:41387655:C:T	2	0	2	2	0	1.0	1.0	0.0
chr22:41394175:G:A	2	2	4	0	4	2.0	0.0	2.0
chr22:41437112:C:T	40	17	57	23	34	1.0	1.0	0.0
chr22:41468146:G:A	479	232	766	272	494	1	1	0
chr22:41507809:A:C	264	125	397	147	250	1.0	1.0	0.0
chr22:41663764:G:T	797	418	1330	440	890	2	1	2
chr22:41693619:T:C	19	10	28	9	19	1	0	1
chr22:41694065:A:C	20	10	30	10	20	1.5	0.5	1.0
chr22:41763225:G:T	7	0	7	7	0	1	1	0
chr22:41781449:G:C	298	163	474	140	334	2.0	0.0	2.0
chr22:41794305:A:G	67	26	96	42	54	1	1	0
chr22:41799406:T:C	311	172	500	146	354	2	0	2
chr22:41825842:C:T	4	3	7	1	6	2.0	0.0	2.0
chr22:41880738:G:C	12	5	17	7	10	1.0	1.0	0.0
chr22:41905708:T:C	14	5	19	9	10	1.0	1.0	0.0
chr22:41945304:A:G	9	5	18	4	14	2	0	2
chr22:41947087:G:A	7	4	15	3	12	2	0	2
chr22:41996807:G:A	0	0	0	0	0	0	0	0
chr22:42027106:G:C	0	0	0	0	0	0	0	0
chr22:42067810:C:T	21	11	34	10	24	2	0	2
chr22:42077599:C:T	12	3	15	9	6	1.0	1.0	0.0
chr22:42078134:C:G	14	10	24	4	20	2.0	0.0	2.0
chr22:42079699:T:G	231	82	325	161	164	1	1	0
chr22:42090719:G:A	840	448	1431	488	943	2.0	1.0	2.0
chr22:42141587:G:A	3	1	4	2	2	1	1	0
chr22:42142019:G:A	2	2	4	0	4	2.0	0.0	2.0
chr22:42214093:T:C	0	0	0	0	0	0	0	0
chr22:42387064:G:A	0	0	0	0	0	0	0	0
chr22:42397867:A:G	3	3	6	0	6	2	0	2
chr22:42512970:G:A	203	100	315	110	205	1	1	0
chr22:42693049:G:C	0	0	0	0	0	0	0	0
chr22:42799141:A:G	95	52	148	44	104	2	0	2
chr22:42807131:C:T	95	52	148	44	104	2	0	2
chr22:42810944:A:C	81	50	132	32	100	2	0	2
chr22:42817755:G:A	107	55	164	54	110	2	1	2
chr22:42882214:C:T	37	23	60	14	46	2	0	2
chr22:42893467:G:A	44	27	71	17	54	2.0	0.0	2.0
chr22:43059525:C:T	55	33	89	23	66	2	0	2
chr22:43063840:G:A	58	36	95	23	72	2.0	0.0	2.0
chr22:43133023:C:T	30	15	45	15	30	1.5	0.5	1.0
chr22:43133308:G:C	30	15	45	15	30	1.5	0.5	1.0
chr22:43162920:A:G	1814	900	3655	1511	2144	2.0	1.0	0.0
chr22:43176348:C:T	7	2	9	5	4	1	1	0
chr22:43180874:C:A	8	2	10	6	4	1.0	1.0	0.0
chr22:43180898:G:A	8	6	14	2	12	2.0	0.0	2.0
chr22:43183043:T:C	7	3	10	4	6	1	1	0
chr22:43203911:T:C	0	0	0	0	0	0	0	0
chr22:43203985:C:T	0	0	0	0	0	0	0	0
chr22:43210137:C:T	0	0	0	0	0	0	0	0
chr22:43435076:C:T	0	0	0	0	0	0	0	0
chr22:43435136:C:T	0	0	0	0	0	0	0	0
chr22:43635162:T:C	0	0	0	0	0	0	0	0
chr22:43886396:A:G	0	0	0	0	0	0	0	0
chr22:43927090:G:T	0	0	0	0	0	0	0	0
chr22:43946445:C:T	0	0	0	0	0	0	0	0
chr22:43976752:C:T	291	144	444	154	290	1	1	0
chr22:44094016:T:C	176	85	280	106	174	2.0	1.0	0.0
chr22:44679858:T:C	0	0	0	0	0	0	0	0
chr22:44732352:T:C	15	9	24	6	18	2	0	2
chr22:44736824:T:C	17	8	25	9	16	1	1	0
chr22:44736905:T:C	19	10	29	9	20	2	0	2
chr22:44802129:A:G	0	0	0	0	0	0	0	0
chr22:44859700:G:C	0	0	0	0	0	0	0	0
chr22:44859757:G:C	0	0	0	0	0	0	0	0
chr22:44862577:A:G	0	0	0	0	0	0	0	0
chr22:45171699:C:A	31	19	50	12	38	2	0	2
chr22:45181350:T:C	24	19	43	5	38	2.0	0.0	2.0
chr22:45197993:C:T	0	0	0	0	0	0	0	0
chr22:45287365:C:T	3	2	5	1	4	2	0	2
chr22:45289121:A:G	2	0	2	2	0	1.0	1.0	0.0
chr22:45295713:A:G	17	3	20	14	6	1	1	0
chr22:45322160:A:G	2	2	4	0	4	2.0	0.0	2.0
chr22:45327926:G:C	43	31	78	12	66	2	0	2
chr22:45327961:G:A	43	31	78	12	66	2	0	2
chr22:45327973:C:G	44	12	58	34	24	1.0	1.0	0.0
chr22:45328017:G:A	24	17	43	7	36	2.0	0.0	2.0
chr22:45332489:G:A	28	11	39	17	22	1.0	1.0	0.0
chr22:45335301:C:T	1	0	1	1	0	1	1	0
chr22:45340553:C:G	23	8	31	15	16	1	1	0
chr22:45352459:A:G	0	0	0	0	0	0	0	0
chr22:45354103:G:T	1	0	1	1	0	1	1	0
chr22:45387023:T:C	0	0	0	0	0	0	0	0
chr22:45600418:A:G	0	0	0	0	0	0	0	0
chr22:46257062:A:G	0	0	0	0	0	0	0	0
chr22:46259362:T:C	0	0	0	0	0	0	0	0
chr22:46326503:T:C	0	0	0	0	0	0	0	0
chr22:46346453:A:G	79	48	127	31	96	2	0	2
chr22:46372914:G:A	3	2	5	1	4	2	0	2
chr22:46534210:C:T	0	0	0	0	0	0	0	0
chr22:46687113:TGT:CGA	12	5	17	7	10	1.0	1.0	0.0
chr22:49624397:G:A	1	0	1	1	0	1	1	0
chr22:49624421:A:G	1	1	2	0	2	2	0	2
chr22:49624663:C:G	3	3	8	0	8	2	0	2
chr22:49924413:G:C	101	51	156	52	104	2	1	2
chr22:49962907:T:C	16	6	22	10	12	1.0	1.0	0.0
chr22:49963045:T:C	198	81	292	129	163	1.0	1.0	0.0
chr22:49963202:C:T	205	84	305	135	170	1	1	0
chr22:49997051:A:G	0	0	0	0	0	0	0	0
chr22:50000765:C:T	0	0	0	0	0	0	0	0
chr22:50030478:C:G	0	0	0	0	0	0	0	0
chr22:50061535:T:C	0	0	0	0	0	0	0	0
chr22:50117257:A:C	0	0	0	0	0	0	0	0
chr22:50147099:G:A	0	0	0	0	0	0	0	0
chr22:50149550:T:G	0	0	0	0	0	0	0	0
chr22:50150767:C:A	0	0	0	0	0	0	0	0
chr22:50217999:G:A	90	34	126	58	68	1.0	1.0	0.0
chr22:50219553:C:T	19	11	30	8	22	2	0	2
chr22:50220072:A:G	8	5	13	3	10	2.0	0.0	2.0
chr22:50220846:C:T	36	18	54	18	36	1.5	0.5	1.0
chr22:50220951:G:A	36	20	56	16	40	2.0	0.0	2.0
chr22:50245883:G:A	14	5	19	9	10	1.0	1.0	0.0
chr22:50281547:C:T	0	0	0	0	0	0	0	0
chr22:50281752:C:G	0	0	0	0	0	0	0	0
chr22:50282193:C:T	0	0	0	0	0	0	0	0
chr22:50283705:T:C	0	0	0	0	0	0	0	0
chr22:50289633:T:C	0	0	0	0	0	0	0	0
chr22:50439767:G:A	39	21	62	20	42	2	0	2
chr22:50441018:T:G	47	24	71	23	48	2	0	2
chr22:50456591:C:T	6	3	9	3	6	1.5	0.5	1.0
chr22:50489911:G:C	0	0	0	0	0	0	0	0
chr22:50503692:C:T	176	98	278	80	198	2.0	0.0	2.0
chr22:50504803:G:A	157	88	249	71	178	2	0	2
chr22:50505699:G:A	145	65	214	82	132	1	1	0
chr22:50505734:G:A	144	65	213	81	132	1.0	1.0	0.0
chr22:50506827:A:G	133	75	211	61	150	2	0	2
chr22:50523357:C:T	92	44	136	48	88	1.0	1.0	0.0
chr22:50523425:T:C	95	45	140	50	90	1	1	0
chr22:50523779:T:G	151	73	238	84	154	2	1	0
chr22:50524353:C:G	138	62	211	83	128	1.0	1.0	0.0
chr22:50528485:T:C	148	87	245	65	180	2.0	0.0	2.0
chr22:50531639:C:T	286	154	469	151	318	2.0	0.0	2.0
chr22:50546279:C:G	3	1	4	2	2	1	1	0
chr22:50546594:C:A	2	1	3	1	2	1.5	0.5	1.0
chr22:50548858:A:G	34	14	48	20	28	1.0	1.0	0.0
chr22:50549764:A:G	34	15	49	19	30	1.0	1.0	0.0
chr22:50625611:G:C	86	47	137	41	96	2.0	0.0	2.0
chr22:50679152:T:C	0	0	0	0	0	0	0	0
chr22:50744589:C:T	0	0	0	0	0	0	0	0
chr22:50754799:T:G	0	0	0	0	0	0	0	0
chrX:284193:T:C	8	5	13	3	10	2.0	0.0	2.0
chrX:290784:C:T	0	0	0	0	0	0	0	0
chrX:299277:G:T	6	4	10	2	8	2.0	0.0	2.0
chrX:305038:G:A	108	46	159	64	95	1.0	1.0	0.0
chrX:312875:G:A	79	42	123	39	84	2	0	2
chrX:315276:T:C	107	51	162	58	104	1	1	0
chrX:334334:A:G	23	7	30	16	14	1	1	0
chrX:334362:C:T	23	7	30	16	14	1	1	0
chrX:334397:T:C	23	7	30	16	14	1	1	0
chrX:334496:A:G	23	7	30	16	14	1	1	0
chrX:338421:G:A	0	0	0	0	0	0	0	0
chrX:338766:C:T	0	0	0	0	0	0	0	0
chrX:341424:G:A	0	0	0	0	0	0	0	0
chrX:341798:A:G	0	0	0	0	0	0	0	0
chrX:342008:G:A	0	0	0	0	0	0	0	0
chrX:346676:G:A	0	0	0	0	0	0	0	0
chrX:361426:A:G	9	2	11	7	4	1	1	0
chrX:361522:G:A	8	2	11	7	4	1.0	1.0	0.0
chrX:1196887:C:A	0	0	0	0	0	0	0	0
chrX:1348511:A:C	4	2	6	2	4	1.5	0.5	1.0
chrX:1389431:G:A	2951	1893	7917	2685	5232	2	1	2
chrX:1412872:C:G	15	5	20	10	10	1	1	0
chrX:1412877:T:C	15	5	20	10	10	1	1	0
chrX:1412945:A:G	13	4	17	9	8	1	1	0
chrX:1418109:C:G	112	60	173	53	120	2.0	0.0	2.0
chrX:1418988:C:T	108	58	167	51	116	2.0	0.0	2.0
chrX:1427899:G:A	129	61	190	70	120	1	1	0
chrX:1427983:A:G	129	61	192	70	122	1	1	0
chrX:1466186:C:T	18	11	29	7	22	2.0	0.0	2.0
chrX:1594128:C:T	510	242	814	308	506	2.0	1.0	0.0
chrX:1599467:G:A	19	7	26	12	14	1	1	0
chrX:1601004:C:G	143	56	203	89	114	1	1	0
chrX:2490396:G:A	10	5	15	5	10	1.5	0.5	1.0
chrX:2691502:G:A	16	11	27	5	22	2.0	0.0	2.0
chrX:2733525:C:T	33	18	51	15	36	2	0	2
chrX:2917996:G:C	10	10	20	0	20	2.0	0.0	2.0
chrX:3010084:C:T	0	0	0	0	0	0	0	0
chrX:3024068:T:C	0	0	0	0	0	0	0	0
chrX:3033393:C:G	0	0	0	0	0	0	0	0
chrX:3084646:A:G	0	0	0	0	0	0	0	0
chrX:3310370:G:A	0	0	0	0	0	0	0	0
chrX:3310850:A:G	0	0	0	0	0	0	0	0
chrX:3317683:C:T	0	0	0	0	0	0	0	0
chrX:3320126:T:G	0	0	0	0	0	0	0	0
chrX:3320692:G:A	0	0	0	0	0	0	0	0
chrX:3321504:C:T	0	0	0	0	0	0	0	0
chrX:3322302:G:A	0	0	0	0	0	0	0	0
chrX:3323009:G:A	0	0	0	0	0	0	0	0
chrX:3323215:T:C	0	0	0	0	0	0	0	0
chrX:3323243:A:G	0	0	0	0	0	0	0	0
chrX:3323276:T:C	0	0	0	0	0	0	0	0
chrX:3674684:G:A	89	61	156	28	128	2	0	2
chrX:7077376:C:T	47	28	75	19	56	2	0	2
chrX:7077397:C:T	47	28	75	19	56	2	0	2
chrX:7105637:G:A	95	67	164	30	134	2	0	2
chrX:7257254:C:T	0	0	0	0	0	0	0	0
chrX:10117634:T:C	5	5	9	0	9	2	0	2
chrX:12919394:C:T	0	0	0	0	0	0	0	0
chrX:12919685:C:T	0	0	0	0	0	0	0	0
chrX:12920993:G:C	0	0	0	0	0	0	0	0
chrX:12921293:C:A	0	0	0	0	0	0	0	0
chrX:13318940:C:T	0	0	0	0	0	0	0	0
chrX:13617818:C:T	0	0	0	0	0	0	0	0
chrX:13816977:T:C	0	0	0	0	0	0	0	0
chrX:15688707:C:A	84	50	135	35	100	2.0	0.0	2.0
chrX:15782628:G:A	12	9	20	3	17	2.0	0.0	2.0
chrX:16150344:T:C	1	0	1	1	0	1	1	0
chrX:16150554:T:C	1	0	1	1	0	1	1	0
chrX:16869532:C:T	61	0	62	62	0	1	1	0
chrX:21843316:A:G	27	27	54	0	54	2	0	2
chrX:22032973:C:T	10	0	10	10	0	1.0	1.0	0.0
chrX:22273489:C:A	8	8	16	0	16	2.0	0.0	2.0
chrX:22273615:C:T	8	8	16	0	16	2.0	0.0	2.0
chrX:24619076:A:C	0	0	0	0	0	0	0	0
chrX:25646046:T:C	0	0	0	0	0	0	0	0
chrX:26139103:C:T	0	0	0	0	0	0	0	0
chrX:26139675:C:T	0	0	0	0	0	0	0	0
chrX:26161415:A:G	0	0	0	0	0	0	0	0
chrX:26195102:T:C	0	0	0	0	0	0	0	0
chrX:27461222:A:G	0	0	0	0	0	0	0	0
chrX:27747928:A:G	0	0	0	0	0	0	0	0
chrX:30236259:T:C	0	0	0	0	0	0	0	0
chrX:30242885:A:G	0	0	0	0	0	0	0	0
chrX:30243041:G:C	0	0	0	0	0	0	0	0
chrX:30308866:C:T	0	0	0	0	0	0	0	0
chrX:30309250:G:A	0	0	0	0	0	0	0	0
chrX:31679519:A:G	201	4	212	204	8	1	1	0
chrX:34944792:A:C	0	0	0	0	0	0	0	0
chrX:35802148:C:T	0	0	0	0	0	0	0	0
chrX:35802308:C:T	0	0	0	0	0	0	0	0
chrX:35802579:G:A	0	0	0	0	0	0	0	0
chrX:35803185:C:G	0	0	0	0	0	0	0	0
chrX:35803191:C:T	0	0	0	0	0	0	0	0
chrX:36985853:C:T	0	0	0	0	0	0	0	0
chrX:37010054:A:G	0	0	0	0	0	0	0	0
chrX:37010555:CG:CC	0	0	0	0	0	0	0	0
chrX:37011181:A:C	0	0	0	0	0	0	0	0
chrX:37043094:A:C	0	0	0	0	0	0	0	0
chrX:37043316:C:T	0	0	0	0	0	0	0	0
chrX:37043343:C:T	0	0	0	0	0	0	0	0
chrX:37043415:A:G	0	0	0	0	0	0	0	0
chrX:37659553:C:T	0	0	0	0	0	0	0	0
chrX:37841795:G:A	238	237	491	1	490	2.0	0.0	2.0
chrX:38073633:A:G	0	0	0	0	0	0	0	0
chrX:38089579:A:G	0	0	0	0	0	0	0	0
chrX:38149868:G:A	0	0	0	0	0	0	0	0
chrX:38299037:C:T	16	16	32	0	32	2.0	0.0	2.0
chrX:41184691:T:C	2	2	3	0	3	1.5	0.0	1.5
chrX:41341424:C:T	8	4	12	4	8	1.5	0.5	1.0
chrX:44542049:T:G	248	92	348	162	186	1.0	1.0	0.0
chrX:48058816:A:G	4	0	4	4	0	1.0	1.0	0.0
chrX:48261787:T:G	0	0	0	0	0	0	0	0
chrX:48894188:G:A	706	705	1538	1	1537	2.0	0.0	2.0
chrX:48903516:C:T	2	0	2	2	0	1.0	1.0	0.0
chrX:48991085:T:C	89	89	182	0	182	2	0	2
chrX:49224829:A:G	1	0	1	1	0	1	1	0
chrX:49237061:C:T	5	0	5	5	0	1	1	0
chrX:49246763:A:G	68	0	68	68	0	1.0	1.0	0.0
chrX:51491598:C:T	1	1	2	0	2	2	0	2
chrX:51901652:C:A	117	115	240	2	238	2	0	2
chrX:52650379:A:G	0	0	0	0	0	0	0	0
chrX:52796506:G:C	0	0	0	0	0	0	0	0
chrX:53076708:G:A	0	0	0	0	0	0	0	0
chrX:53077683:C:T	0	0	0	0	0	0	0	0
chrX:53085145:T:C	77	0	77	77	0	1	1	0
chrX:53085173:G:A	77	77	154	0	154	2	0	2
chrX:53422619:G:A	132	37	172	98	74	1.0	1.0	0.0
chrX:53430674:C:T	2	1	3	1	2	1.5	0.5	1.0
chrX:55001565:C:T	64	64	128	0	128	2.0	0.0	2.0
chrX:55160988:G:A	22	0	22	22	0	1.0	1.0	0.0
chrX:67546682:G:A	0	0	0	0	0	0	0	0
chrX:68717433:C:T	0	0	0	0	0	0	0	0
chrX:69161421:C:A	47	47	94	0	94	2	0	2
chrX:69161944:C:T	39	39	77	0	77	2	0	2
chrX:69162069:G:A	39	0	39	39	0	1	1	0
chrX:69162993:G:A	43	43	86	0	86	2	0	2
chrX:70258571:G:T	0	0	0	0	0	0	0	0
chrX:70258886:T:C	0	0	0	0	0	0	0	0
chrX:70259092:T:G	0	0	0	0	0	0	0	0
chrX:70452612:G:C	0	0	0	0	0	0	0	0
chrX:70926548:A:G	0	0	0	0	0	0	0	0
chrX:72305429:G:A	0	0	0	0	0	0	0	0
chrX:72572611:A:C	38	0	39	39	0	1.0	1.0	0.0
chrX:77682471:C:G	186	0	194	194	0	1.0	1.0	0.0
chrX:78013005:G:C	1	1	2	0	2	2	0	2
chrX:78272820:G:A	30	0	31	31	0	1.0	1.0	0.0
chrX:80443094:C:G	0	0	0	0	0	0	0	0
chrX:80573490:C:T	0	0	0	0	0	0	0	0
chrX:84468533:A:G	1	1	2	0	2	2	0	2
chrX:85108134:A:G	0	0	0	0	0	0	0	0
chrX:100594020:G:A	0	0	0	0	0	0	0	0
chrX:101010563:T:A	47	47	94	0	94	2	0	2
chrX:101488839:A:G	1	1	2	0	2	2	0	2
chrX:101490838:T:C	0	0	0	0	0	0	0	0
chrX:101492268:G:A	0	0	0	0	0	0	0	0
chrX:101494598:C:T	2	2	4	0	4	2.0	0.0	2.0
chrX:101656080:T:C	48	0	48	48	0	1.0	1.0	0.0
chrX:102127033:G:C	1	1	2	0	2	2	0	2
chrX:102182662:A:G	0	0	0	0	0	0	0	0
chrX:103707253:A:G	0	0	0	0	0	0	0	0
chrX:103718987:G:A	0	0	0	0	0	0	0	0
chrX:103723878:G:C	0	0	0	0	0	0	0	0
chrX:104013669:G:A	0	0	0	0	0	0	0	0
chrX:104040193:C:T	0	0	0	0	0	0	0	0
chrX:105748970:T:C	0	0	0	0	0	0	0	0
chrX:107560379:G:A	0	0	0	0	0	0	0	0
chrX:107715833:C:T	310	0	322	322	0	1.0	1.0	0.0
chrX:107794199:G:T	0	0	0	0	0	0	0	0
chrX:107794565:C:A	0	0	0	0	0	0	0	0
chrX:108174500:G:A	0	0	0	0	0	0	0	0
chrX:108190458:A:G	0	0	0	0	0	0	0	0
chrX:108736282:CGCC:TGCT	0	0	0	0	0	0	0	0
chrX:109465287:C:T	0	0	0	0	0	0	0	0
chrX:110175937:G:A	2	0	2	2	0	1.0	1.0	0.0
chrX:110451457:T:A	0	0	0	0	0	0	0	0
chrX:110688628:T:C	0	0	0	0	0	0	0	0
chrX:111251049:A:G	0	0	0	0	0	0	0	0
chrX:111519033:G:A	0	0	0	0	0	0	0	0
chrX:112454808:T:C	0	0	0	0	0	0	0	0
chrX:112455212:G:T	0	0	0	0	0	0	0	0
chrX:115189585:G:A	0	0	0	0	0	0	0	0
chrX:115189875:C:G	0	0	0	0	0	0	0	0
chrX:115189942:G:A	0	0	0	0	0	0	0	0
chrX:115190378:G:A	0	0	0	0	0	0	0	0
chrX:115190633:G:A	0	0	0	0	0	0	0	0
chrX:115190675:G:A	0	0	0	0	0	0	0	0
chrX:115190837:G:A	0	0	0	0	0	0	0	0
chrX:115191360:C:A	0	0	0	0	0	0	0	0
chrX:115191822:G:A	0	0	0	0	0	0	0	0
chrX:115192354:C:T	0	0	0	0	0	0	0	0
chrX:117973462:C:A	0	0	0	0	0	0	0	0
chrX:119453040:C:T	37	0	38	38	0	1	1	0
chrX:119565357:A:G	66	66	132	0	132	2.0	0.0	2.0
chrX:119758925:G:C	8	0	8	8	0	1.0	1.0	0.0
chrX:119759091:C:A	11	0	11	11	0	1	1	0
chrX:119759174:T:C	11	0	11	11	0	1	1	0
chrX:119759450:T:C	12	0	12	12	0	1.0	1.0	0.0
chrX:119791487:A:G	13	0	13	13	0	1	1	0
chrX:123403426:T:C	0	0	0	0	0	0	0	0
chrX:124392181:T:C	0	0	0	0	0	0	0	0
chrX:124406465:G:T	0	0	0	0	0	0	0	0
chrX:126164707:G:A	0	0	0	0	0	0	0	0
chrX:126165205:T:G	0	0	0	0	0	0	0	0
chrX:126165484:G:T	0	0	0	0	0	0	0	0
chrX:126821445:G:A	0	0	0	0	0	0	0	0
chrX:128051014:C:G	0	0	0	0	0	0	0	0
chrX:129746638:T:C	0	0	0	0	0	0	0	0
chrX:129793914:T:C	90	90	180	0	180	2.0	0.0	2.0
chrX:130013397:G:A	1	1	2	0	2	2	0	2
chrX:130067204:C:T	6	0	6	6	0	1.0	1.0	0.0
chrX:130364862:T:A	7	0	7	7	0	1	1	0
chrX:131276991:A:G	0	0	0	0	0	0	0	0
chrX:131281844:T:C	0	0	0	0	0	0	0	0
chrX:131544493:A:G	0	0	0	0	0	0	0	0
chrX:131544622:C:G	0	0	0	0	0	0	0	0
chrX:131544870:A:C	0	0	0	0	0	0	0	0
chrX:132078484:A:G	0	0	0	0	0	0	0	0
chrX:132078614:C:T	0	0	0	0	0	0	0	0
chrX:133414985:G:A	0	0	0	0	0	0	0	0
chrX:135579930:G:A	21	0	22	22	0	1	1	0
chrX:135883135:G:A	0	0	0	0	0	0	0	0
chrX:135896266:G:A	0	0	0	0	0	0	0	0
chrX:135904541:T:C	0	0	0	0	0	0	0	0
chrX:135907841:C:T	0	0	0	0	0	0	0	0
chrX:135908919:A:G	0	0	0	0	0	0	0	0
chrX:135911846:T:C	0	0	0	0	0	0	0	0
chrX:136228626:T:C	15	0	15	15	0	1	1	0
chrX:136230875:T:G	19	0	19	19	0	1	1	0
chrX:136344534:A:G	0	0	0	0	0	0	0	0
chrX:136344809:C:A	0	0	0	0	0	0	0	0
chrX:136347344:C:A	0	0	0	0	0	0	0	0
chrX:136347885:T:C	0	0	0	0	0	0	0	0
chrX:136348324:T:C	0	0	0	0	0	0	0	0
chrX:136349077:T:C	0	0	0	0	0	0	0	0
chrX:136349199:C:T	0	0	0	0	0	0	0	0
chrX:136397967:T:C	0	0	0	0	0	0	0	0
chrX:136414239:G:A	0	0	0	0	0	0	0	0
chrX:137030548:A:G	0	0	0	0	0	0	0	0
chrX:137031305:C:A	0	0	0	0	0	0	0	0
chrX:139551121:A:G	0	0	0	0	0	0	0	0
chrX:141895317:C:T	0	0	0	0	0	0	0	0
chrX:141905478:G:A	0	0	0	0	0	0	0	0
chrX:141906078:T:C	0	0	0	0	0	0	0	0
chrX:141906091:C:A	0	0	0	0	0	0	0	0
chrX:141906119:C:T	0	0	0	0	0	0	0	0
chrX:141906621:C:G	0	0	0	0	0	0	0	0
chrX:141908578:G:A	0	0	0	0	0	0	0	0
chrX:141908886:C:T	0	0	0	0	0	0	0	0
chrX:143034272:T:G	0	0	0	0	0	0	0	0
chrX:145822734:G:A	0	0	0	0	0	0	0	0
chrX:148006729:C:T	0	0	0	0	0	0	0	0
chrX:150512442:C:T	0	0	0	0	0	0	0	0
chrX:150762633:C:T	3	3	6	0	6	2	0	2
chrX:151181399:A:G	0	0	0	0	0	0	0	0
chrX:151648622:C:G	0	0	0	0	0	0	0	0
chrX:151672444:C:T	0	0	0	0	0	0	0	0
chrX:151672753:A:G	0	0	0	0	0	0	0	0
chrX:151923983:C:A	0	0	0	0	0	0	0	0
chrX:152652814:A:T	0	0	0	0	0	0	0	0
chrX:152727697:A:G	0	0	0	0	0	0	0	0
chrX:152727721:C:G	0	0	0	0	0	0	0	0
chrX:152727846:C:T	0	0	0	0	0	0	0	0
chrX:152737049:A:G	0	0	0	0	0	0	0	0
chrX:152740627:T:C	0	0	0	0	0	0	0	0
chrX:152740688:A:G	0	0	0	0	0	0	0	0
chrX:152990435:T:C	0	0	0	0	0	0	0	0
chrX:153504772:G:A	0	0	0	0	0	0	0	0
chrX:153506051:C:T	0	0	0	0	0	0	0	0
chrX:153558127:G:A	0	0	0	0	0	0	0	0
chrX:153672091:C:T	0	0	0	0	0	0	0	0
chrX:153770343:G:A	0	0	0	0	0	0	0	0
chrX:153774047:G:C	0	0	0	0	0	0	0	0
chrX:153776089:T:C	0	0	0	0	0	0	0	0
chrX:153776964:G:A	0	0	0	0	0	0	0	0
chrX:153784080:A:G	0	0	0	0	0	0	0	0
chrX:153785529:G:A	0	0	0	0	0	0	0	0
chrX:153807864:G:A	0	0	0	0	0	0	0	0
chrX:153906539:A:G	0	0	0	0	0	0	0	0
chrX:154351080:A:G	23	23	46	0	46	2	0	2
chrX:154412069:T:C	61	61	122	0	122	2	0	2
chrX:154465991:G:C	0	0	0	0	0	0	0	0
chrX:154467565:T:G	0	0	0	0	0	0	0	0
chrX:154467904:C:G	0	0	0	0	0	0	0	0
chrX:154469313:A:T	0	0	0	0	0	0	0	0
chrX:154477925:C:G	461	461	983	0	983	2	0	2
chrX:154485448:T:C	26	0	26	26	0	1.0	1.0	0.0
chrX:154532439:A:G	174	0	179	179	0	1.0	1.0	0.0
chrX:154652556:C:A	0	0	0	0	0	0	0	0
chrX:154762824:C:G	155	155	324	0	324	2	0	2
chrX:154823616:G:A	0	0	0	0	0	0	0	0
chrX:154930010:G:C	0	0	0	0	0	0	0	0
chrX:155277884:G:T	1	0	1	1	0	1	1	0
