Variant	Num_Cells	Num_Alt_Cells	Total_Coverage	Ref_Count	Alt_Count	Median_Coverage	Median_Ref	Median_Alt
chr1:187485:G:A	101	0	103	103	0	1	1	0
chr1:973858:G:C	8	7	15	1	14	2.0	0.0	2.0
chr1:974039:C:T	8	1	9	7	2	1.0	1.0	0.0
chr1:978953:C:G	0	0	0	0	0	0	0	0
chr1:981169:A:G	0	0	0	0	0	0	0	0
chr1:1014228:G:A	2916	2080	13234	4471	8763	3.0	1.0	2.0
chr1:1044368:A:T	0	0	0	0	0	0	0	0
chr1:1054900:C:T	1	1	2	0	2	2	0	2
chr1:1055000:C:T	1	0	1	1	0	1	1	0
chr1:1055037:T:C	1	0	1	1	0	1	1	0
chr1:1179830:GGTG:AGTT	0	0	0	0	0	0	0	0
chr1:1223251:A:G	368	184	587	203	384	2.0	1.0	1.0
chr1:1334508:C:A	3	1	4	2	2	1	1	0
chr1:1426175:T:C	0	0	0	0	0	0	0	0
chr1:1426261:C:T	0	0	0	0	0	0	0	0
chr1:1455469:C:T	0	0	0	0	0	0	0	0
chr1:1517088:C:T	1	0	1	1	0	1	1	0
chr1:1534218:CG:GC	66	32	100	34	66	1.0	1.0	0.0
chr1:1534226:C:T	67	34	103	33	70	2	0	2
chr1:1543953:A:G	1631	926	3181	1085	2096	2	1	2
chr1:1616547:T:C	282	152	470	146	324	2.0	0.0	2.0
chr1:1624086:G:A	1	1	2	0	2	2	0	2
chr1:1627057:C:G	1	0	1	1	0	1	1	0
chr1:1627515:C:T	6	3	10	4	6	1.5	1.0	1.0
chr1:1628409:C:A	3	1	4	2	2	1	1	0
chr1:1668373:C:T	14	12	28	2	26	2.0	0.0	2.0
chr1:1703565:T:C	65	32	100	34	66	2	1	0
chr1:1704180:T:C	2	1	3	1	2	1.5	0.5	1.0
chr1:1704310:C:A	28	10	40	18	22	1.0	1.0	0.0
chr1:1704605:G:A	18	7	27	11	16	1.0	1.0	0.0
chr1:1704835:C:T	5	2	7	3	4	1	1	0
chr1:1734736:C:T	31	0	35	35	0	1	1	0
chr1:1915326:G:A	0	0	0	0	0	0	0	0
chr1:1916417:G:T	0	0	0	0	0	0	0	0
chr1:1916670:G:C	0	0	0	0	0	0	0	0
chr1:1918090:A:G	1	1	2	0	2	2	0	2
chr1:1918989:A:G	1	1	2	0	2	2	0	2
chr1:1922670:A:G	0	0	0	0	0	0	0	0
chr1:1926870:T:C	0	0	0	0	0	0	0	0
chr1:1927692:C:T	0	0	0	0	0	0	0	0
chr1:1930143:C:T	0	0	0	0	0	0	0	0
chr1:1942086:T:C	0	0	0	0	0	0	0	0
chr1:1944419:CA:GG	0	0	0	0	0	0	0	0
chr1:1955806:G:A	0	0	0	0	0	0	0	0
chr1:1956754:C:A	0	0	0	0	0	0	0	0
chr1:1960038:A:G	0	0	0	0	0	0	0	0
chr1:2025598:T:C	0	0	0	0	0	0	0	0
chr1:2056554:T:C	112	52	169	63	106	1.0	1.0	0.0
chr1:2321320:A:G	18	8	26	10	16	1.0	1.0	0.0
chr1:2391602:T:C	11	1	13	11	2	1	1	0
chr1:2479806:G:A	5	3	8	2	6	2	0	2
chr1:2487186:C:T	3	2	5	1	4	2	0	2
chr1:2499178:C:T	0	0	0	0	0	0	0	0
chr1:2502461:C:T	0	0	0	0	0	0	0	0
chr1:2521130:T:C	7	3	12	4	8	1	1	0
chr1:2556714:A:G	1151	666	2177	660	1517	2	1	2
chr1:2559766:C:T	10	5	15	5	10	1.5	0.5	1.0
chr1:2563346:G:A	1249	717	2389	752	1637	2	1	2
chr1:2588863:T:C	0	0	0	0	0	0	0	0
chr1:2592766:C:T	1	0	1	1	0	1	1	0
chr1:2595307:A:G	0	0	0	0	0	0	0	0
chr1:2604174:C:A	0	0	0	0	0	0	0	0
chr1:2609830:A:G	0	0	0	0	0	0	0	0
chr1:2629443:G:A	0	0	0	0	0	0	0	0
chr1:2629464:T:G	0	0	0	0	0	0	0	0
chr1:2641760:A:G	3	1	4	2	2	1	1	0
chr1:3022217:C:T	0	0	0	0	0	0	0	0
chr1:3385157:C:T	0	0	0	0	0	0	0	0
chr1:3412095:C:T	0	0	0	0	0	0	0	0
chr1:3425545:G:T	0	0	0	0	0	0	0	0
chr1:3425564:G:A	0	0	0	0	0	0	0	0
chr1:3463493:G:A	0	0	0	0	0	0	0	0
chr1:3467101:G:A	0	0	0	0	0	0	0	0
chr1:3595370:A:G	0	0	0	0	0	0	0	0
chr1:3595444:G:T	0	0	0	0	0	0	0	0
chr1:3631572:T:C	149	79	235	75	160	2	0	2
chr1:3632268:G:C	148	78	235	77	158	2.0	0.0	2.0
chr1:3682336:G:A	34	12	49	25	24	1.0	1.0	0.0
chr1:3682346:C:T	34	12	49	25	24	1.0	1.0	0.0
chr1:3752637:ATCTC:GTCTG	0	0	0	0	0	0	0	0
chr1:3755592:C:A	0	0	0	0	0	0	0	0
chr1:3756932:T:G	1	0	1	1	0	1	1	0
chr1:3761369:T:C	0	0	0	0	0	0	0	0
chr1:3763211:C:T	0	0	0	0	0	0	0	0
chr1:3831074:G:A	46	18	67	29	38	1.0	1.0	0.0
chr1:4711993:T:C	0	0	0	0	0	0	0	0
chr1:5877108:G:A	1	1	2	0	2	2	0	2
chr1:5877353:A:C	0	0	0	0	0	0	0	0
chr1:6085305:A:G	2	2	4	0	4	2.0	0.0	2.0
chr1:6149303:T:C	0	0	0	0	0	0	0	0
chr1:6151123:G:A	0	0	0	0	0	0	0	0
chr1:6155676:C:G	0	0	0	0	0	0	0	0
chr1:6197796:G:A	33	18	51	15	36	2	0	2
chr1:6208961:C:T	0	0	0	0	0	0	0	0
chr1:6209280:A:G	0	0	0	0	0	0	0	0
chr1:6211065:A:G	0	0	0	0	0	0	0	0
chr1:6211118:C:T	0	0	0	0	0	0	0	0
chr1:6212018:G:A	0	0	0	0	0	0	0	0
chr1:6212753:C:T	0	0	0	0	0	0	0	0
chr1:6218354:A:G	0	0	0	0	0	0	0	0
chr1:6264553:C:T	55	22	86	34	52	1	1	0
chr1:6295005:G:C	0	0	0	0	0	0	0	0
chr1:6445611:G:A	0	0	0	0	0	0	0	0
chr1:6464441:T:C	6	1	7	5	2	1.0	1.0	0.0
chr1:6467536:A:G	6	6	12	0	12	2.0	0.0	2.0
chr1:6468408:C:T	1	0	1	1	0	1	1	0
chr1:6469383:A:G	1	0	1	1	0	1	1	0
chr1:6471064:T:C	0	0	0	0	0	0	0	0
chr1:6471590:C:T	0	0	0	0	0	0	0	0
chr1:6473333:G:C	0	0	0	0	0	0	0	0
chr1:6474988:A:G	0	0	0	0	0	0	0	0
chr1:6485330:A:T	0	0	0	0	0	0	0	0
chr1:6519547:C:T	1	1	2	0	2	2	0	2
chr1:6519593:G:C	1	0	1	1	0	1	1	0
chr1:6549499:C:A	55	35	93	21	72	2	0	2
chr1:6554170:G:A	474	244	829	285	544	2.0	1.0	2.0
chr1:6554475:G:A	427	228	719	231	488	2	1	2
chr1:6585807:G:A	12	6	19	7	12	2.0	0.5	1.0
chr1:6599445:G:A	11	8	21	3	18	2	0	2
chr1:6621684:C:T	10	5	18	6	12	2.0	0.5	1.0
chr1:6633037:A:G	122	54	179	72	107	1.0	1.0	0.0
chr1:6634147:A:G	1	0	1	1	0	1	1	0
chr1:6644575:A:G	41	16	60	26	34	1	1	0
chr1:6887657:C:T	178	88	286	98	188	2.0	1.0	0.0
chr1:7809988:T:C	7	4	11	3	8	2	0	2
chr1:7827188:G:A	2	0	2	2	0	1.0	1.0	0.0
chr1:7827433:T:C	2	0	2	2	0	1.0	1.0	0.0
chr1:7829881:C:T	3	1	5	3	2	2	1	0
chr1:8335500:G:T	0	0	0	0	0	0	0	0
chr1:8358584:C:A	24	7	32	18	14	1.0	1.0	0.0
chr1:8358590:T:C	22	6	29	17	12	1.0	1.0	0.0
chr1:8361143:T:C	18	8	26	10	16	1.0	1.0	0.0
chr1:8365840:T:C	66	38	105	29	76	2.0	0.0	2.0
chr1:8365860:C:T	68	30	100	40	60	1.0	1.0	0.0
chr1:8949347:C:T	0	0	0	0	0	0	0	0
chr1:8949385:A:C	0	0	0	0	0	0	0	0
chr1:8974362:G:A	0	0	0	0	0	0	0	0
chr1:9264512:T:C	3	1	4	2	2	1	1	0
chr1:9264611:A:G	3	1	4	2	2	1	1	0
chr1:9356092:G:A	1	1	2	0	2	2	0	2
chr1:9356287:C:T	1	0	1	1	0	1	1	0
chr1:9610776:C:T	2	1	3	1	2	1.5	0.5	1.0
chr1:10178712:A:G	20	8	28	12	16	1.0	1.0	0.0
chr1:10361820:A:G	11	3	14	8	6	1	1	0
chr1:10419578:C:G	2	1	3	1	2	1.5	0.5	1.0
chr1:10430465:C:T	31	15	48	16	32	1	1	0
chr1:10451487:C:T	20	14	36	6	30	2.0	0.0	2.0
chr1:10461592:C:T	139	74	222	70	152	2	0	2
chr1:10648085:A:G	14	7	22	8	14	2.0	0.5	1.0
chr1:10649210:C:T	1	0	1	1	0	1	1	0
chr1:10649252:C:G	1	0	1	1	0	1	1	0
chr1:10649384:C:T	2	1	3	1	2	1.5	0.5	1.0
chr1:10665441:G:A	43	15	61	29	32	1	1	0
chr1:11650504:T:G	107	67	178	42	136	2	0	2
chr1:11668837:G:A	317	145	506	190	316	1	1	0
chr1:11675784:C:A	17	3	20	14	6	1	1	0
chr1:11676994:G:C	9	3	12	6	6	1	1	0
chr1:11719705:C:T	2	0	2	2	0	1.0	1.0	0.0
chr1:11833999:T:C	2	0	2	2	0	1.0	1.0	0.0
chr1:12022277:A:T	376	167	583	235	348	1.0	1.0	0.0
chr1:12029944:T:C	34	16	52	18	34	1.0	1.0	0.0
chr1:12126001:A:G	3	2	7	1	6	2	0	2
chr1:12138240:T:C	0	0	0	0	0	0	0	0
chr1:12188885:A:G	69	35	108	34	74	2	0	2
chr1:12191751:T:G	3	2	5	1	4	2	0	2
chr1:12256314:G:T	11	5	16	6	10	1	1	0
chr1:12276090:T:C	11	4	15	7	8	1	1	0
chr1:12279562:A:T	9	8	17	1	16	2	0	2
chr1:12283407:G:T	9	4	13	5	8	1	1	0
chr1:12329896:T:C	4	2	6	2	4	1.5	0.5	1.0
chr1:12578936:C:T	1	1	2	0	2	2	0	2
chr1:12578990:T:C	0	0	0	0	0	0	0	0
chr1:12838849:C:T	0	0	0	0	0	0	0	0
chr1:12838930:G:A	0	0	0	0	0	0	0	0
chr1:12893339:G:A	0	0	0	0	0	0	0	0
chr1:12938780:C:A	0	0	0	0	0	0	0	0
chr1:13116324:A:G	0	0	0	0	0	0	0	0
chr1:13390382:G:A	0	0	0	0	0	0	0	0
chr1:13390395:T:C	0	0	0	0	0	0	0	0
chr1:13390803:C:T	0	0	0	0	0	0	0	0
chr1:13475905:G:A	0	0	0	0	0	0	0	0
chr1:13475969:G:A	0	0	0	0	0	0	0	0
chr1:13778644:T:A	507	206	805	364	441	1	1	0
chr1:13778803:G:A	331	137	521	223	298	1	1	0
chr1:13780865:T:A	217	86	328	145	183	1	1	0
chr1:13782619:A:G	136	66	205	73	132	1.5	1.0	0.0
chr1:15112494:G:A	0	0	0	0	0	0	0	0
chr1:15289643:G:A	0	0	0	0	0	0	0	0
chr1:15324566:A:G	0	0	0	0	0	0	0	0
chr1:15327067:C:T	0	0	0	0	0	0	0	0
chr1:15341780:G:A	0	0	0	0	0	0	0	0
chr1:15397347:G:A	0	0	0	0	0	0	0	0
chr1:15465931:C:G	1	1	2	0	2	2	0	2
chr1:15467418:G:A	2	2	4	0	4	2.0	0.0	2.0
chr1:15506048:T:C	41	22	64	20	44	2	0	2
chr1:15507802:G:A	0	0	0	0	0	0	0	0
chr1:15518120:A:G	55	30	86	26	60	2	0	2
chr1:15564107:C:G	29	11	43	21	22	1	1	0
chr1:15565920:A:C	36	22	66	14	52	2.0	0.0	2.0
chr1:15577823:C:T	85	52	143	33	110	2	0	2
chr1:15583249:C:T	79	49	134	30	104	2	0	2
chr1:15633482:C:T	50	29	83	23	60	2.0	0.0	2.0
chr1:15660052:T:C	9	7	16	2	14	2	0	2
chr1:15716271:T:C	10	8	17	2	15	2.0	0.0	2.0
chr1:15717906:G:A	18	7	26	12	14	1.0	1.0	0.0
chr1:15729869:G:A	47	22	70	26	44	1	1	0
chr1:15737916:T:C	0	0	0	0	0	0	0	0
chr1:15743149:C:T	0	0	0	0	0	0	0	0
chr1:15744376:C:T	0	0	0	0	0	0	0	0
chr1:15744417:T:C	0	0	0	0	0	0	0	0
chr1:15768536:G:A	0	0	0	0	0	0	0	0
chr1:15774722:C:T	0	0	0	0	0	0	0	0
chr1:15929512:T:C	69	35	104	34	70	2	0	2
chr1:15932261:T:A	47	21	75	31	44	2	1	0
chr1:15933318:A:G	20	5	25	15	10	1.0	1.0	0.0
chr1:15944765:G:A	4	2	6	2	4	1.5	0.5	1.0
chr1:15945755:A:G	23	12	39	11	28	2	0	2
chr1:16015742:A:G	0	0	0	0	0	0	0	0
chr1:16017865:A:G	0	0	0	0	0	0	0	0
chr1:16017907:G:A	0	0	0	0	0	0	0	0
chr1:16024780:A:G	0	0	0	0	0	0	0	0
chr1:16030006:G:A	0	0	0	0	0	0	0	0
chr1:16050993:G:A	0	0	0	0	0	0	0	0
chr1:16053748:A:G	0	0	0	0	0	0	0	0
chr1:16056953:A:C	0	0	0	0	0	0	0	0
chr1:16058680:G:A	1	1	2	0	2	2	0	2
chr1:16059921:G:A	0	0	0	0	0	0	0	0
chr1:16059952:G:C	0	0	0	0	0	0	0	0
chr1:16062151:T:C	1	1	2	0	2	2	0	2
chr1:16198561:G:T	59	28	87	31	56	1	1	0
chr1:16206003:G:A	46	24	70	22	48	2.0	0.0	2.0
chr1:16206308:G:A	44	19	63	25	38	1.0	1.0	0.0
chr1:16206353:A:G	2	1	3	1	2	1.5	0.5	1.0
chr1:16207760:C:G	0	0	0	0	0	0	0	0
chr1:16208151:C:G	0	0	0	0	0	0	0	0
chr1:16251299:C:T	55	27	84	28	56	1	1	0
chr1:16409637:T:C	1	1	2	0	2	2	0	2
chr1:16451770:G:T	1	0	1	1	0	1	1	0
chr1:16486571:C:T	33	17	52	16	36	2	0	2
chr1:16648142:T:C	0	0	0	0	0	0	0	0
chr1:16648374:G:C	0	0	0	0	0	0	0	0
chr1:16648477:C:T	0	0	0	0	0	0	0	0
chr1:16648507:C:T	0	0	0	0	0	0	0	0
chr1:16649698:C:T	1	1	2	0	2	2	0	2
chr1:16939065:C:T	8	0	8	8	0	1.0	1.0	0.0
chr1:16969184:T:C	20	10	31	11	20	2.0	0.5	1.0
chr1:16970794:C:T	0	0	0	0	0	0	0	0
chr1:16977094:C:T	0	0	0	0	0	0	0	0
chr1:16986180:A:G	121	58	186	66	120	1	1	0
chr1:16992516:G:A	3	2	5	1	4	2	0	2
chr1:17054002:G:T	919	491	1582	534	1048	2	1	2
chr1:17068985:G:A	0	0	0	0	0	0	0	0
chr1:17069026:G:A	0	0	0	0	0	0	0	0
chr1:17070208:T:C	0	0	0	0	0	0	0	0
chr1:17075621:G:T	0	0	0	0	0	0	0	0
chr1:17075640:T:C	0	0	0	0	0	0	0	0
chr1:17075664:G:A	0	0	0	0	0	0	0	0
chr1:17075760:C:T	0	0	0	0	0	0	0	0
chr1:17079314:G:A	0	0	0	0	0	0	0	0
chr1:17229013:G:T	0	0	0	0	0	0	0	0
chr1:17239874:G:A	0	0	0	0	0	0	0	0
chr1:17271160:C:T	0	0	0	0	0	0	0	0
chr1:17274670:C:T	0	0	0	0	0	0	0	0
chr1:17282953:G:T	0	0	0	0	0	0	0	0
chr1:17339727:C:A	0	0	0	0	0	0	0	0
chr1:17342068:G:A	0	0	0	0	0	0	0	0
chr1:17348042:C:A	1	1	2	0	2	2	0	2
chr1:17823015:G:T	0	0	0	0	0	0	0	0
chr1:17823071:C:A	0	0	0	0	0	0	0	0
chr1:18481042:G:T	0	0	0	0	0	0	0	0
chr1:18481126:G:C	0	0	0	0	0	0	0	0
chr1:18481261:G:A	0	0	0	0	0	0	0	0
chr1:18481287:C:T	0	0	0	0	0	0	0	0
chr1:18481459:C:A	0	0	0	0	0	0	0	0
chr1:18849352:T:C	0	0	0	0	0	0	0	0
chr1:18854899:T:C	0	0	0	0	0	0	0	0
chr1:18857583:A:G	0	0	0	0	0	0	0	0
chr1:18875462:A:G	4	3	7	1	6	2.0	0.0	2.0
chr1:18877503:C:G	0	0	0	0	0	0	0	0
chr1:19084635:A:G	118	46	171	73	98	1.0	1.0	0.0
chr1:19086767:T:A	41	20	65	21	44	1	1	0
chr1:19088810:C:T	24	12	40	12	28	1.5	0.5	1.0
chr1:19106955:A:G	23	13	36	10	26	2	0	2
chr1:19110691:G:T	0	0	0	0	0	0	0	0
chr1:19121349:C:G	124	70	215	61	154	2.0	0.0	2.0
chr1:19173066:T:C	30	15	47	15	32	1.5	0.5	1.0
chr1:19219399:G:A	39	22	61	17	44	2	0	2
chr1:19240387:C:T	87	41	143	53	90	2	1	0
chr1:19251910:G:A	33	24	59	9	50	2	0	2
chr1:19257510:G:A	331	173	567	185	382	2	1	2
chr1:19267254:A:C	3	2	5	1	4	2	0	2
chr1:19268643:C:T	1	0	1	1	0	1	1	0
chr1:19273892:C:T	3	2	5	1	4	2	0	2
chr1:19274044:C:T	4	3	7	1	6	2.0	0.0	2.0
chr1:19308517:C:T	877	434	1477	543	934	2	1	0
chr1:19325569:G:A	36	16	55	23	32	1.5	1.0	0.0
chr1:19326380:G:A	35	21	62	16	46	2	0	2
chr1:19448881:G:A	34	14	50	22	28	1.0	1.0	0.0
chr1:19700911:G:A	2	2	4	0	4	2.0	0.0	2.0
chr1:19700930:T:G	2	2	4	0	4	2.0	0.0	2.0
chr1:19771448:G:T	173	74	256	102	154	1	1	0
chr1:19815035:C:T	0	0	0	0	0	0	0	0
chr1:20164025:T:C	0	0	0	0	0	0	0	0
chr1:20500614:C:T	30	18	48	12	36	2.0	0.0	2.0
chr1:20500723:C:T	29	12	41	17	24	1	1	0
chr1:20650507:A:C	128	66	207	65	142	2.0	0.0	2.0
chr1:20666326:G:C	0	0	0	0	0	0	0	0
chr1:20717433:T:C	0	0	0	0	0	0	0	0
chr1:20724465:C:T	0	0	0	0	0	0	0	0
chr1:21247229:G:A	15	8	23	7	16	2	0	2
chr1:21577638:T:C	0	0	0	0	0	0	0	0
chr1:21814713:A:C	43	3	47	41	6	1	1	0
chr1:21823442:T:C	5	1	5	4	1	1	1	0
chr1:21823764:C:T	5	1	6	4	2	1	1	0
chr1:21874945:C:T	0	0	0	0	0	0	0	0
chr1:21887553:C:T	0	0	0	0	0	0	0	0
chr1:22005918:A:G	0	0	0	0	0	0	0	0
chr1:22509184:A:G	13	7	20	6	14	2	0	2
chr1:22576609:C:T	0	0	0	0	0	0	0	0
chr1:22589260:T:C	0	0	0	0	0	0	0	0
chr1:22589398:A:T	0	0	0	0	0	0	0	0
chr1:23091660:C:T	1	1	2	0	2	2	0	2
chr1:23092768:G:A	15	11	27	5	22	2	0	2
chr1:23092881:G:T	12	8	21	5	16	2.0	0.0	2.0
chr1:23092890:C:T	12	8	21	5	16	2.0	0.0	2.0
chr1:23093362:T:C	185	135	333	53	280	2	0	2
chr1:23193140:A:G	0	0	0	0	0	0	0	0
chr1:23431121:C:T	0	0	0	0	0	0	0	0
chr1:23433101:C:T	0	0	0	0	0	0	0	0
chr1:23559044:G:A	581	326	1253	405	848	2	1	2
chr1:23639214:A:C	4	3	9	1	8	2.0	0.0	2.0
chr1:23750961:C:T	249	125	390	135	255	2	1	1
chr1:24057329:T:C	0	0	0	0	0	0	0	0
chr1:24064227:G:A	0	0	0	0	0	0	0	0
chr1:24090929:T:C	0	0	0	0	0	0	0	0
chr1:24092278:T:C	0	0	0	0	0	0	0	0
chr1:24093006:A:G	0	0	0	0	0	0	0	0
chr1:24094984:G:A	0	0	0	0	0	0	0	0
chr1:24095460:C:G	0	0	0	0	0	0	0	0
chr1:24342967:C:T	0	0	0	0	0	0	0	0
chr1:25246493:T:G	2216	1370	5289	1787	3502	2.0	1.0	2.0
chr1:25563141:T:C	29	14	44	17	27	2	1	0
chr1:25563698:A:G	27	13	42	16	26	2	1	0
chr1:25805163:G:A	5	4	9	1	8	2	0	2
chr1:25811771:T:C	11	6	19	5	14	2	0	2
chr1:25814082:C:A	6	2	8	4	4	1.0	1.0	0.0
chr1:25823532:C:T	11	3	14	8	6	1	1	0
chr1:25826267:A:G	4	1	5	3	2	1.0	1.0	0.0
chr1:26066333:C:A	0	0	0	0	0	0	0	0
chr1:26161449:A:G	0	0	0	0	0	0	0	0
chr1:26169964:C:T	755	338	1317	548	769	2	1	0
chr1:26193801:G:T	0	0	0	0	0	0	0	0
chr1:26201393:G:A	0	0	0	0	0	0	0	0
chr1:26201460:G:A	0	0	0	0	0	0	0	0
chr1:26255600:G:A	16	8	24	8	16	1.5	0.5	1.0
chr1:26343953:G:T	0	0	0	0	0	0	0	0
chr1:26344118:C:T	0	0	0	0	0	0	0	0
chr1:26344261:C:T	0	0	0	0	0	0	0	0
chr1:26344593:G:T	0	0	0	0	0	0	0	0
chr1:26344757:A:G	0	0	0	0	0	0	0	0
chr1:26346585:G:A	0	0	0	0	0	0	0	0
chr1:26346617:C:T	0	0	0	0	0	0	0	0
chr1:26364683:C:A	0	0	0	0	0	0	0	0
chr1:26367754:T:C	0	0	0	0	0	0	0	0
chr1:26543119:G:A	7	5	12	2	10	2	0	2
chr1:26557020:A:C	11	4	15	7	8	1	1	0
chr1:26574244:C:G	70	35	106	36	70	2.0	0.5	1.0
chr1:26863833:C:T	0	0	0	0	0	0	0	0
chr1:26884230:T:C	98	51	156	50	106	2.0	0.0	2.0
chr1:26890178:G:A	200	101	321	111	210	2.0	1.0	2.0
chr1:26913429:C:G	0	0	0	0	0	0	0	0
chr1:26921792:C:G	1469	822	2813	915	1898	2	1	2
chr1:26952030:G:A	14	9	23	5	18	2.0	0.0	2.0
chr1:26952062:G:A	14	9	23	5	18	2.0	0.0	2.0
chr1:26952082:T:C	14	5	19	9	10	1.0	1.0	0.0
chr1:27005974:GT:AC	0	0	0	0	0	0	0	0
chr1:27012614:C:T	0	0	0	0	0	0	0	0
chr1:27154266:A:G	11	5	16	6	10	1	1	0
chr1:27357905:G:A	0	0	0	0	0	0	0	0
chr1:27362142:G:A	0	0	0	0	0	0	0	0
chr1:28096336:C:T	6	6	12	0	12	2.0	0.0	2.0
chr1:28561348:G:A	415	225	691	213	478	2	0	2
chr1:28593917:A:T	0	0	0	0	0	0	0	0
chr1:28863085:C:T	0	0	0	0	0	0	0	0
chr1:29121187:G:A	0	0	0	0	0	0	0	0
chr1:29149136:T:G	384	188	626	224	402	2.0	1.0	0.0
chr1:29203187:T:C	107	42	151	67	84	1	1	0
chr1:29216125:A:G	110	44	156	68	88	1.0	1.0	0.0
chr1:30715242:C:T	3	0	4	4	0	1	1	0
chr1:30716054:A:G	6	4	10	2	8	2.0	0.0	2.0
chr1:30733790:C:T	3824	2988	19347	6768	12579	4.0	1.0	2.0
chr1:30735195:C:T	3670	2693	16150	6018	10132	4.0	1.0	2.0
chr1:30742517:T:C	3280	2216	11775	4425	7350	3.0	1.0	2.0
chr1:31281520:T:C	17	9	26	8	18	2	0	2
chr1:31364242:T:C	163	87	262	82	180	2	0	2
chr1:31413986:T:C	0	0	0	0	0	0	0	0
chr1:31619303:C:T	1	1	2	0	2	2	0	2
chr1:31626924:A:G	1	1	2	0	2	2	0	2
chr1:31630664:A:G	505	289	858	252	606	2	0	2
chr1:31662352:G:A	0	0	0	0	0	0	0	0
chr1:31665562:C:G	1	0	1	1	0	1	1	0
chr1:31692773:T:C	0	0	0	0	0	0	0	0
chr1:31698605:T:G	0	0	0	0	0	0	0	0
chr1:31699894:G:T	0	0	0	0	0	0	0	0
chr1:31728046:T:C	0	0	0	0	0	0	0	0
chr1:31815009:T:C	0	0	0	0	0	0	0	0
chr1:33165468:C:A	32	11	44	22	22	1.0	1.0	0.0
chr1:33181349:A:G	29	18	49	11	38	2	0	2
chr1:33276497:G:A	13	5	18	8	10	1	1	0
chr1:33354432:C:T	1	1	2	0	2	2	0	2
chr1:33367332:G:A	0	0	0	0	0	0	0	0
chr1:33494462:A:G	1	1	2	0	2	2	0	2
chr1:33559328:T:C	0	0	0	0	0	0	0	0
chr1:33559430:A:G	0	0	0	0	0	0	0	0
chr1:33572614:T:C	0	0	0	0	0	0	0	0
chr1:33605925:C:T	0	0	0	0	0	0	0	0
chr1:34197579:G:A	0	0	0	0	0	0	0	0
chr1:34197607:C:G	0	0	0	0	0	0	0	0
chr1:34197810:C:G	0	0	0	0	0	0	0	0
chr1:34761761:C:G	0	0	0	0	0	0	0	0
chr1:34988170:T:G	19	10	32	10	22	2	0	2
chr1:36341880:C:T	21	11	38	14	24	2	1	2
chr1:36420516:C:T	2	1	3	1	2	1.5	0.5	1.0
chr1:36423404:G:A	1	0	1	1	0	1	1	0
chr1:36432466:T:C	2	2	4	0	4	2.0	0.0	2.0
chr1:36458042:G:C	3	1	4	2	2	1	1	0
chr1:36471458:A:G	0	0	0	0	0	0	0	0
chr1:36475383:C:T	1	1	2	0	2	2	0	2
chr1:36859876:A:C	0	0	0	0	0	0	0	0
chr1:37493849:T:C	1009	565	1797	578	1219	2	1	2
chr1:37493869:C:G	1005	564	1792	572	1220	2	1	2
chr1:37540758:A:G	31	19	50	12	38	2	0	2
chr1:37554146:C:T	976	505	1679	603	1076	2.0	1.0	2.0
chr1:37565095:T:C	12	0	12	12	0	1.0	1.0	0.0
chr1:37612628:A:G	1	0	1	1	0	1	1	0
chr1:37689593:G:C	8	2	10	6	4	1.0	1.0	0.0
chr1:37690518:C:G	81	34	120	52	68	1	1	0
chr1:37719975:G:A	5	4	9	1	8	2	0	2
chr1:37720051:C:T	5	4	9	1	8	2	0	2
chr1:37720534:C:G	4	3	7	1	6	2.0	0.0	2.0
chr1:37721775:A:G	1	1	2	0	2	2	0	2
chr1:37721781:G:A	1	1	2	0	2	2	0	2
chr1:37806988:G:A	17	8	25	9	16	1	1	0
chr1:37823711:T:C	8	4	12	4	8	1.5	0.5	1.0
chr1:37862310:G:T	14	3	18	12	6	1.0	1.0	0.0
chr1:37873123:A:G	9	2	11	7	4	1	1	0
chr1:37931697:C:T	61	29	93	33	60	1	1	0
chr1:37979077:T:C	7	2	9	5	4	1	1	0
chr1:37997832:C:T	28	13	46	18	28	1.5	1.0	0.0
chr1:38874610:C:T	3	2	5	1	4	2	0	2
chr1:38886599:G:T	5	4	9	1	8	2	0	2
chr1:39284212:G:T	24	15	40	10	30	2.0	0.0	2.0
chr1:39350874:G:A	8	6	14	2	12	2.0	0.0	2.0
chr1:39683970:G:T	0	0	0	0	0	0	0	0
chr1:39684484:G:A	1	0	1	1	0	1	1	0
chr1:39741497:T:G	1	1	2	0	2	2	0	2
chr1:39753393:C:T	355	155	549	223	326	1	1	0
chr1:39760374:G:A	2	1	3	1	2	1.5	0.5	1.0
chr1:39763696:A:G	201	97	316	118	198	2	1	0
chr1:39883459:G:A	145	79	229	71	158	2	0	2
chr1:40251472:C:G	5	2	7	3	4	1	1	0
chr1:40819881:T:C	1	0	1	1	0	1	1	0
chr1:40831156:T:G	1	1	2	0	2	2	0	2
chr1:41020573:C:T	0	0	0	0	0	0	0	0
chr1:41513485:A:G	5	4	9	1	8	2	0	2
chr1:41524790:G:A	5	1	6	4	2	1	1	0
chr1:41580076:T:C	29	14	43	15	28	1	1	0
chr1:41581537:C:G	11	3	14	8	6	1	1	0
chr1:42227926:A:G	33	18	51	15	36	2	0	2
chr1:42433172:A:G	3	0	3	3	0	1	1	0
chr1:42435411:A:C	0	0	0	0	0	0	0	0
chr1:42536676:A:G	0	0	0	0	0	0	0	0
chr1:42536687:A:G	0	0	0	0	0	0	0	0
chr1:42642517:G:A	2	1	3	1	2	1.5	0.5	1.0
chr1:42658549:G:A	5	4	9	1	8	2	0	2
chr1:42659188:C:T	4	1	5	3	2	1.0	1.0	0.0
chr1:42665982:G:A	671	348	1127	391	736	2	1	2
chr1:42735184:G:A	0	0	0	0	0	0	0	0
chr1:42830447:G:A	6	2	9	5	4	1.5	1.0	0.0
chr1:42834992:T:C	8	5	13	3	10	2.0	0.0	2.0
chr1:43152925:G:A	0	0	0	0	0	0	0	0
chr1:43166865:C:T	595	315	1043	341	702	2	1	2
chr1:43170813:C:G	582	306	1011	329	682	2.0	1.0	2.0
chr1:43171878:A:G	8	4	12	4	8	1.5	0.5	1.0
chr1:43172261:T:C	544	284	907	300	607	2.0	1.0	2.0
chr1:43272669:A:C	28	15	45	13	32	2.0	0.0	2.0
chr1:43313893:T:C	0	0	0	0	0	0	0	0
chr1:43319285:A:G	0	0	0	0	0	0	0	0
chr1:43359973:T:C	1	1	2	0	2	2	0	2
chr1:43389907:G:C	172	81	267	95	172	1.0	1.0	0.0
chr1:43420823:C:T	6	5	11	1	10	2.0	0.0	2.0
chr1:43432382:T:G	4	4	8	0	8	2.0	0.0	2.0
chr1:43437918:G:T	1	0	1	1	0	1	1	0
chr1:43441225:A:G	3	2	5	1	4	2	0	2
chr1:43446919:A:G	1	0	1	1	0	1	1	0
chr1:43451738:T:C	1	1	4	0	4	4	0	4
chr1:43591203:G:C	0	0	0	0	0	0	0	0
chr1:43666403:G:A	2	2	4	0	4	2.0	0.0	2.0
chr1:43824858:A:G	12	5	17	7	10	1.0	1.0	0.0
chr1:43930114:C:T	0	0	0	0	0	0	0	0
chr1:43949743:C:T	8	5	13	3	10	2.0	0.0	2.0
chr1:43976849:A:C	9	4	13	5	8	1	1	0
chr1:43977258:A:G	12	3	16	10	6	1.0	1.0	0.0
chr1:43996150:C:T	58	28	87	31	56	1.5	1.0	0.0
chr1:43997532:C:T	2	0	2	2	0	1.0	1.0	0.0
chr1:44129375:T:A	0	0	0	0	0	0	0	0
chr1:44129738:A:G	0	0	0	0	0	0	0	0
chr1:44129754:G:A	0	0	0	0	0	0	0	0
chr1:44701045:G:C	4	3	7	1	6	2.0	0.0	2.0
chr1:44775915:G:A	161	79	250	88	162	2	1	0
chr1:45010209:T:C	28	16	46	14	32	2.0	0.0	2.0
chr1:45039048:G:C	2	2	4	0	4	2.0	0.0	2.0
chr1:46189973:C:T	72	35	114	38	76	1.5	1.0	0.0
chr1:46203604:A:C	8	6	18	2	16	2.0	0.0	2.0
chr1:46340808:C:T	676	389	1262	366	896	2.0	0.0	2.0
chr1:46340878:C:T	731	428	1377	393	984	2	0	2
chr1:46344858:A:G	269	122	410	158	252	1	1	0
chr1:46344998:T:C	273	158	448	124	324	2	0	2
chr1:46345170:C:T	237	137	388	108	280	2	0	2
chr1:46361813:C:T	85	36	123	49	74	1	1	0
chr1:46652517:G:T	30	6	39	25	14	1.0	1.0	0.0
chr1:46665201:A:G	6	3	9	3	6	1.5	0.5	1.0
chr1:46673147:T:G	9	3	12	6	6	1	1	0
chr1:46815187:G:A	0	0	0	0	0	0	0	0
chr1:46815212:C:T	0	0	0	0	0	0	0	0
chr1:46817100:C:T	0	0	0	0	0	0	0	0
chr1:46817216:C:T	0	0	0	0	0	0	0	0
chr1:46935541:C:T	0	0	0	0	0	0	0	0
chr1:47994235:C:T	0	0	0	0	0	0	0	0
chr1:48232079:C:T	0	0	0	0	0	0	0	0
chr1:48298747:C:T	0	0	0	0	0	0	0	0
chr1:48436880:G:A	0	0	0	0	0	0	0	0
chr1:48472019:A:T	0	0	0	0	0	0	0	0
chr1:51288050:G:A	1	1	2	0	2	2	0	2
chr1:51408207:A:C	67	36	106	32	74	2	0	2
chr1:51798392:A:G	116	59	183	59	124	2.0	0.0	2.0
chr1:51825312:T:G	104	56	167	49	118	2.0	0.0	2.0
chr1:51878742:A:C	562	257	923	364	559	2.0	1.0	0.0
chr1:52356220:G:A	25	16	41	9	32	2	0	2
chr1:52525966:C:T	685	356	1183	394	789	2	1	2
chr1:52687760:T:C	63	30	100	40	60	1	1	0
chr1:52784978:G:A	8	4	12	4	8	1.5	0.5	1.0
chr1:52921543:G:A	54	37	95	17	78	2.0	0.0	2.0
chr1:53069827:C:T	0	0	0	0	0	0	0	0
chr1:53090953:C:T	0	0	0	0	0	0	0	0
chr1:53142461:C:A	0	0	0	0	0	0	0	0
chr1:53289479:T:C	0	0	0	0	0	0	0	0
chr1:53529842:G:A	0	0	0	0	0	0	0	0
chr1:53888985:T:G	191	76	282	124	158	1	1	0
chr1:54216247:G:C	306	151	520	176	344	2.0	1.0	0.0
chr1:54218183:C:G	291	147	478	177	301	2	1	2
chr1:54218252:G:A	292	148	484	176	308	2.0	1.0	2.0
chr1:54225281:T:C	69	42	116	28	88	2	0	2
chr1:54594689:G:A	0	0	0	0	0	0	0	0
chr1:54607957:C:T	0	0	0	0	0	0	0	0
chr1:54609167:T:A	0	0	0	0	0	0	0	0
chr1:54610135:T:C	0	0	0	0	0	0	0	0
chr1:54653471:A:G	0	0	0	0	0	0	0	0
chr1:54653616:G:C	0	0	0	0	0	0	0	0
chr1:54653842:T:G	0	0	0	0	0	0	0	0
chr1:54670856:T:C	0	0	0	0	0	0	0	0
chr1:54674068:A:G	0	0	0	0	0	0	0	0
chr1:54700269:G:A	0	0	0	0	0	0	0	0
chr1:54701169:C:T	0	0	0	0	0	0	0	0
chr1:54716627:T:A	179	95	290	90	200	2	0	2
chr1:54758458:T:C	0	0	0	0	0	0	0	0
chr1:54759078:C:A	1	0	1	1	0	1	1	0
chr1:54801124:G:C	10	4	14	6	8	1.0	1.0	0.0
chr1:54841828:A:G	0	0	0	0	0	0	0	0
chr1:54841967:C:T	0	0	0	0	0	0	0	0
chr1:54852435:C:T	0	0	0	0	0	0	0	0
chr1:54853335:T:C	0	0	0	0	0	0	0	0
chr1:54854229:A:G	0	0	0	0	0	0	0	0
chr1:54999117:C:G	0	0	0	0	0	0	0	0
chr1:55052188:C:G	0	0	0	0	0	0	0	0
chr1:55052210:C:G	0	0	0	0	0	0	0	0
chr1:56512147:G:A	1	1	2	0	2	2	0	2
chr1:56949637:G:A	0	0	0	0	0	0	0	0
chr1:56956838:C:T	0	0	0	0	0	0	0	0
chr1:58533979:T:G	144	62	217	87	130	1.0	1.0	0.0
chr1:58576137:C:T	0	0	0	0	0	0	0	0
chr1:58576639:T:G	0	0	0	0	0	0	0	0
chr1:58682254:T:C	172	87	270	92	178	2.0	1.0	2.0
chr1:58682464:T:C	190	94	300	108	192	2.0	1.0	0.0
chr1:58783141:G:C	2677	1855	10239	3248	6991	3	1	2
chr1:59321678:T:G	97	58	161	45	116	2	0	2
chr1:59378799:G:A	144	67	215	81	134	1.0	1.0	0.0
chr1:59872826:C:T	15	10	25	5	20	2	0	2
chr1:59926599:G:A	4	2	7	3	4	2.0	0.5	1.0
chr1:60040111:G:C	0	0	0	0	0	0	0	0
chr1:60041072:G:A	0	0	0	0	0	0	0	0
chr1:61404111:G:A	0	0	0	0	0	0	0	0
chr1:61766458:T:C	36	35	71	1	70	2.0	0.0	2.0
chr1:61914598:C:T	15	1	16	14	2	1	1	0
chr1:62051011:G:C	3	0	3	3	0	1	1	0
chr1:62273526:G:A	0	0	0	0	0	0	0	0
chr1:62274393:A:G	0	0	0	0	0	0	0	0
chr1:62494430:A:G	4	2	6	2	4	1.5	0.5	1.0
chr1:62625187:C:T	23	10	35	15	20	1	1	0
chr1:63631761:C:T	37	19	56	18	38	2	0	2
chr1:63648630:T:C	48	26	75	23	52	2.0	0.0	2.0
chr1:63659697:C:T	90	42	133	49	84	1.0	1.0	0.0
chr1:64049707:C:T	552	281	928	326	602	2.0	1.0	2.0
chr1:64837964:G:A	109	61	183	51	132	2	0	2
chr1:64844806:T:C	160	90	269	79	190	2.0	0.0	2.0
chr1:65592830:A:G	4	3	7	1	6	2.0	0.0	2.0
chr1:66365687:G:A	145	83	245	70	175	2	0	2
chr1:66643652:A:G	0	0	0	0	0	0	0	0
chr1:66682344:G:A	0	0	0	0	0	0	0	0
chr1:66777341:C:A	1	1	4	2	2	4	2	2
chr1:66801073:T:A	0	0	0	0	0	0	0	0
chr1:66822362:C:T	0	0	0	0	0	0	0	0
chr1:66837620:A:G	0	0	0	0	0	0	0	0
chr1:67052851:C:T	56	40	107	17	90	2.0	0.0	2.0
chr1:67093056:C:T	0	0	0	0	0	0	0	0
chr1:67095273:C:T	0	0	0	0	0	0	0	0
chr1:67386652:G:A	2	2	4	0	4	2.0	0.0	2.0
chr1:67395837:C:A	1	0	1	1	0	1	1	0
chr1:67686297:T:G	6	6	12	0	12	2.0	0.0	2.0
chr1:68046758:A:G	0	0	0	0	0	0	0	0
chr1:68159195:C:T	0	0	0	0	0	0	0	0
chr1:68162260:C:T	0	0	0	0	0	0	0	0
chr1:68162277:C:T	0	0	0	0	0	0	0	0
chr1:68162515:A:G	0	0	0	0	0	0	0	0
chr1:68162518:C:T	0	0	0	0	0	0	0	0
chr1:70953059:A:G	0	0	0	0	0	0	0	0
chr1:72274951:G:A	0	0	0	0	0	0	0	0
chr1:74041846:C:A	1	1	2	0	2	2	0	2
chr1:74198130:C:G	51	13	67	39	28	1	1	0
chr1:74199809:G:A	66	29	98	40	58	1.0	1.0	0.0
chr1:74205835:A:G	2	1	3	1	2	1.5	0.5	1.0
chr1:74710202:T:C	134	57	196	80	116	1.0	1.0	0.0
chr1:75744357:A:G	19	11	31	9	22	2	0	2
chr1:75932287:C:T	0	0	0	0	0	0	0	0
chr1:77219357:T:C	193	107	309	91	218	2	0	2
chr1:77293893:A:G	0	0	0	0	0	0	0	0
chr1:77811682:C:T	19	0	19	19	0	1	1	0
chr1:78119402:T:C	0	0	0	0	0	0	0	0
chr1:78492806:C:T	0	0	0	0	0	0	0	0
chr1:78629841:G:A	1024	505	1871	738	1133	2.0	1.0	0.0
chr1:78629896:T:C	1039	632	2082	581	1501	2	0	2
chr1:78655318:T:G	42	19	63	25	38	1.5	1.0	0.0
chr1:81502835:A:G	0	0	0	0	0	0	0	0
chr1:84349785:T:C	0	0	0	0	0	0	0	0
chr1:84479306:A:G	547	279	919	312	607	2	1	2
chr1:85200644:T:C	0	0	0	0	0	0	0	0
chr1:85276329:G:C	913	513	1684	542	1142	2	1	2
chr1:85582226:G:A	0	0	0	0	0	0	0	0
chr1:86443899:G:A	0	0	0	0	0	0	0	0
chr1:86455221:A:G	0	0	0	0	0	0	0	0
chr1:86482292:A:T	0	0	0	0	0	0	0	0
chr1:86743270:T:A	516	288	879	272	607	2.0	0.0	2.0
chr1:88805891:T:C	23	14	31	9	22	1	0	1
chr1:88983289:T:C	95	40	138	58	80	1	1	0
chr1:89009135:A:G	17	5	23	13	10	1	1	0
chr1:89009452:C:T	16	5	21	11	10	1.0	1.0	0.0
chr1:89114258:T:C	439	268	803	213	590	2	0	2
chr1:89117007:G:C	445	277	821	205	616	2	0	2
chr1:89171895:G:A	0	0	0	0	0	0	0	0
chr1:89384098:C:T	0	0	0	0	0	0	0	0
chr1:89582573:T:C	5	2	7	3	4	1	1	0
chr1:89583481:A:G	11	5	16	6	10	1	1	0
chr1:91708703:A:G	71	38	113	35	78	2	0	2
chr1:91720100:C:T	10	6	16	4	12	2.0	0.0	2.0
chr1:91734880:T:C	82	40	128	45	83	1.5	1.0	0.0
chr1:92513797:A:G	6	2	9	5	4	1.5	1.0	0.0
chr1:92695345:T:C	128	63	202	70	132	2.0	1.0	0.0
chr1:93877677:T:C	809	431	1387	469	918	2	1	2
chr1:93879024:C:A	104	56	166	52	114	2.0	0.0	2.0
chr1:94177975:T:C	0	0	0	0	0	0	0	0
chr1:94827449:A:G	0	0	0	0	0	0	0	0
chr1:96806900:A:G	26	15	41	11	30	2.0	0.0	2.0
chr1:97699535:T:C	113	42	158	72	86	1	1	0
chr1:98892986:C:T	0	0	0	0	0	0	0	0
chr1:98953091:G:C	0	0	0	0	0	0	0	0
chr1:99264544:C:T	0	0	0	0	0	0	0	0
chr1:99861627:T:C	257	132	414	134	280	2	1	2
chr1:99892547:C:T	28	13	41	15	26	1.0	1.0	0.0
chr1:99912417:T:C	44	22	72	24	48	2.0	0.5	1.0
chr1:100132883:G:C	160	74	260	98	162	2.0	1.0	0.0
chr1:100133310:GC:AT	594	294	977	349	628	2.0	1.0	0.0
chr1:100249909:G:C	0	0	0	0	0	0	0	0
chr1:100270665:C:T	213	99	325	121	204	1	1	0
chr1:101238940:T:C	5	5	16	0	16	4	0	4
chr1:108628124:C:T	0	0	0	0	0	0	0	0
chr1:108725951:T:C	0	0	0	0	0	0	0	0
chr1:108746731:C:G	655	336	1088	361	727	2	1	2
chr1:108834448:C:A	0	0	0	0	0	0	0	0
chr1:108852483:C:T	0	0	0	0	0	0	0	0
chr1:108897593:G:A	14	6	20	8	12	1.0	1.0	0.0
chr1:108924236:G:A	40	16	58	24	34	1.0	1.0	0.0
chr1:109258499:C:T	0	0	0	0	0	0	0	0
chr1:109263691:T:C	0	0	0	0	0	0	0	0
chr1:109264212:C:T	0	0	0	0	0	0	0	0
chr1:109264477:G:A	0	0	0	0	0	0	0	0
chr1:109270398:G:A	0	0	0	0	0	0	0	0
chr1:109271497:C:G	1	0	1	1	0	1	1	0
chr1:109272630:A:G	0	0	0	0	0	0	0	0
chr1:109412038:T:G	2	1	3	1	2	1.5	0.5	1.0
chr1:109543829:G:A	0	0	0	0	0	0	0	0
chr1:109606352:C:T	5	1	6	4	2	1	1	0
chr1:109608773:G:T	2	1	3	1	2	1.5	0.5	1.0
chr1:109610399:A:G	1	1	2	0	2	2	0	2
chr1:109713453:A:G	0	0	0	0	0	0	0	0
chr1:109713598:A:C	0	0	0	0	0	0	0	0
chr1:109715209:TAAACT:CAAATC	1	0	1	1	0	1	1	0
chr1:109715325:A:C	0	0	0	0	0	0	0	0
chr1:109740350:G:T	0	0	0	0	0	0	0	0
chr1:110167112:G:A	0	0	0	0	0	0	0	0
chr1:110198464:C:T	0	0	0	0	0	0	0	0
chr1:110223832:G:A	3	2	5	1	4	2	0	2
chr1:110340947:A:T	20	10	30	10	20	1.5	0.5	1.0
chr1:110381731:G:A	33	30	63	3	60	2	0	2
chr1:110407655:G:A	2167	1303	4730	1617	3113	2	1	2
chr1:110407817:C:T	44	18	68	26	42	1.0	1.0	0.0
chr1:110456232:G:A	0	0	0	0	0	0	0	0
chr1:110518047:T:C	0	0	0	0	0	0	0	0
chr1:110518389:C:A	0	0	0	0	0	0	0	0
chr1:110518440:T:C	0	0	0	0	0	0	0	0
chr1:110951572:C:T	12	6	18	6	12	1.5	0.5	1.0
chr1:111230946:G:C	0	0	0	0	0	0	0	0
chr1:111235703:C:T	70	50	131	22	109	2.0	0.0	2.0
chr1:111415066:T:C	10	7	20	4	16	2.0	0.0	2.0
chr1:111415071:A:G	10	7	20	4	16	2.0	0.0	2.0
chr1:111419634:G:T	4	3	7	1	6	2.0	0.0	2.0
chr1:111449146:G:A	160	78	264	96	168	2.0	1.0	0.0
chr1:111449223:C:A	143	68	234	88	146	1	1	0
chr1:111449473:C:T	642	292	1039	411	628	1.5	1.0	0.0
chr1:111500165:T:G	0	0	0	0	0	0	0	0
chr1:111563955:G:A	0	0	0	0	0	0	0	0
chr1:111755960:A:G	75	35	112	42	70	1	1	0
chr1:111766017:G:A	10	6	16	4	12	2.0	0.0	2.0
chr1:111766331:T:C	9	7	16	2	14	2	0	2
chr1:111982463:G:A	0	0	0	0	0	0	0	0
chr1:111990898:T:G	0	0	0	0	0	0	0	0
chr1:111991106:G:A	0	0	0	0	0	0	0	0
chr1:111991124:C:T	0	0	0	0	0	0	0	0
chr1:112526100:G:C	28	15	46	14	32	2.0	0.0	2.0
chr1:112654581:A:G	537	283	888	286	602	2	1	2
chr1:112703607:T:A	3	2	5	1	4	2	0	2
chr1:112913924:A:T	7	4	11	3	8	2	0	2
chr1:113653873:A:G	1	1	2	0	2	2	0	2
chr1:113881031:C:T	5	4	9	1	8	2	0	2
chr1:113896329:A:G	35	15	50	20	30	1	1	0
chr1:113900413:C:G	12	9	21	3	18	2.0	0.0	2.0
chr1:113907040:T:C	1	1	2	0	2	2	0	2
chr1:113973095:G:A	54	33	88	22	66	2.0	0.0	2.0
chr1:114137918:C:T	0	0	0	0	0	0	0	0
chr1:114568062:A:C	900	487	1630	546	1084	2.0	1.0	2.0
chr1:114625979:A:T	3	0	3	3	0	1	1	0
chr1:115286692:G:A	0	0	0	0	0	0	0	0
chr1:115663802:G:A	0	0	0	0	0	0	0	0
chr1:116944770:C:T	0	0	0	0	0	0	0	0
chr1:116945088:AT:GA	0	0	0	0	0	0	0	0
chr1:116986836:G:A	0	0	0	0	0	0	0	0
chr1:117011799:A:G	0	0	0	0	0	0	0	0
chr1:117113466:A:G	2	1	3	1	2	1.5	0.5	1.0
chr1:117118132:C:T	0	0	0	0	0	0	0	0
chr1:117121291:C:T	2	1	3	1	2	1.5	0.5	1.0
chr1:117623069:C:T	144	65	216	84	132	1.0	1.0	0.0
chr1:118101901:T:A	0	0	0	0	0	0	0	0
chr1:119381101:T:C	1	1	2	0	2	2	0	2
chr1:119514535:C:T	0	0	0	0	0	0	0	0
chr1:119514623:C:A	0	0	0	0	0	0	0	0
chr1:119624058:G:A	0	0	0	0	0	0	0	0
chr1:119742923:G:A	0	0	0	0	0	0	0	0
chr1:119836055:C:T	0	0	0	0	0	0	0	0
chr1:120069392:G:C	25	9	35	17	18	1	1	0
chr1:121096208:G:A	0	0	0	0	0	0	0	0
chr1:121118494:C:T	0	0	0	0	0	0	0	0
chr1:121374827:A:G	5	1	6	4	2	1	1	0
chr1:145846532:A:G	76	38	118	40	78	2.0	1.0	1.0
chr1:145872994:T:C	0	0	0	0	0	0	0	0
chr1:145901901:A:G	0	0	0	0	0	0	0	0
chr1:145927267:T:A	227	100	349	139	210	1	1	0
chr1:146853411:G:A	0	0	0	0	0	0	0	0
chr1:146882537:A:C	1	1	2	0	2	2	0	2
chr1:147620166:C:T	0	0	0	0	0	0	0	0
chr1:147647455:T:A	68	24	96	48	48	1.0	1.0	0.0
chr1:147647471:G:A	68	45	118	24	94	2.0	0.0	2.0
chr1:147652507:T:G	48	34	84	14	70	2.0	0.0	2.0
chr1:148965491:G:A	41	23	66	18	48	2	0	2
chr1:149030158:A:C	0	0	0	0	0	0	0	0
chr1:149055583:C:G	4	4	8	0	8	2.0	0.0	2.0
chr1:149055595:A:T	5	5	10	0	10	2	0	2
chr1:149487339:C:G	5	5	10	0	10	2	0	2
chr1:149554661:T:G	2	1	3	1	2	1.5	0.5	1.0
chr1:149935366:G:A	0	0	0	0	0	0	0	0
chr1:149936215:A:G	0	0	0	0	0	0	0	0
chr1:150286988:A:C	0	0	0	0	0	0	0	0
chr1:150328268:C:T	2	1	4	2	2	2.0	1.0	1.0
chr1:150473343:A:G	196	100	308	98	210	2.0	0.0	2.0
chr1:150510879:C:T	1	1	2	0	2	2	0	2
chr1:150511364:C:T	0	0	0	0	0	0	0	0
chr1:150512511:G:A	3	2	5	1	4	2	0	2
chr1:150553568:G:C	0	0	0	0	0	0	0	0
chr1:150553930:C:T	0	0	0	0	0	0	0	0
chr1:150706557:G:A	5	4	11	1	10	2	0	2
chr1:150755063:G:A	2814	1807	8051	2904	5147	2.0	1.0	2.0
chr1:150813335:G:A	38	18	57	21	36	1.5	1.0	0.0
chr1:150836413:C:G	59	24	83	35	48	1	1	0
chr1:150966095:G:A	172	93	269	82	187	2.0	0.0	2.0
chr1:150968149:T:G	69	39	111	31	80	2	0	2
chr1:150986360:A:G	9	4	13	5	8	1	1	0
chr1:151238313:C:T	15	10	27	5	22	2	0	2
chr1:151242535:A:G	13	2	15	11	4	1	1	0
chr1:151266575:T:C	1620	892	3156	1122	2034	2.0	1.0	2.0
chr1:151315696:G:A	19	8	27	11	16	1	1	0
chr1:151365312:A:G	0	0	0	0	0	0	0	0
chr1:151368248:G:A	0	0	0	0	0	0	0	0
chr1:151399662:G:A	1455	823	3054	1052	2002	2	1	2
chr1:151401549:T:C	1527	903	3421	1126	2295	2	1	2
chr1:151407080:T:C	3	2	5	1	4	2	0	2
chr1:151429569:A:G	15	9	25	7	18	2	0	2
chr1:151524726:G:A	0	0	0	0	0	0	0	0
chr1:151524763:G:A	0	0	0	0	0	0	0	0
chr1:151662327:G:A	1	1	2	0	2	2	0	2
chr1:151707487:C:T	0	0	0	0	0	0	0	0
chr1:151728869:A:G	0	0	0	0	0	0	0	0
chr1:151770322:T:C	0	0	0	0	0	0	0	0
chr1:151775494:A:G	7	6	15	1	14	2	0	2
chr1:152085716:G:A	0	0	0	0	0	0	0	0
chr1:152155645:G:A	0	0	0	0	0	0	0	0
chr1:152156611:T:C	0	0	0	0	0	0	0	0
chr1:152156618:A:G	0	0	0	0	0	0	0	0
chr1:152156929:A:T	0	0	0	0	0	0	0	0
chr1:152213024:C:G	0	0	0	0	0	0	0	0
chr1:152219233:C:G	0	0	0	0	0	0	0	0
chr1:152219403:G:A	0	0	0	0	0	0	0	0
chr1:152219638:C:T	0	0	0	0	0	0	0	0
chr1:152219817:C:T	0	0	0	0	0	0	0	0
chr1:152219919:G:A	0	0	0	0	0	0	0	0
chr1:152220079:T:C	0	0	0	0	0	0	0	0
chr1:152220155:C:T	0	0	0	0	0	0	0	0
chr1:152220349:C:T	0	0	0	0	0	0	0	0
chr1:152220645:G:T	0	0	0	0	0	0	0	0
chr1:152220810:G:T	0	0	0	0	0	0	0	0
chr1:152220815:G:T	0	0	0	0	0	0	0	0
chr1:152221375:C:T	0	0	0	0	0	0	0	0
chr1:152302977:G:A	0	0	0	0	0	0	0	0
chr1:152303673:C:T	0	0	0	0	0	0	0	0
chr1:152304296:C:A	0	0	0	0	0	0	0	0
chr1:152304395:A:G	0	0	0	0	0	0	0	0
chr1:152304413:A:G	0	0	0	0	0	0	0	0
chr1:152304500:G:A	0	0	0	0	0	0	0	0
chr1:152304579:C:G	0	0	0	0	0	0	0	0
chr1:152304692:A:G	0	0	0	0	0	0	0	0
chr1:152304869:C:T	0	0	0	0	0	0	0	0
chr1:152304920:T:C	0	0	0	0	0	0	0	0
chr1:152306213:C:A	0	0	0	0	0	0	0	0
chr1:152307253:C:T	0	0	0	0	0	0	0	0
chr1:152307365:G:C	0	0	0	0	0	0	0	0
chr1:152307444:A:G	0	0	0	0	0	0	0	0
chr1:152307556:T:C	0	0	0	0	0	0	0	0
chr1:152308284:T:C	0	0	0	0	0	0	0	0
chr1:152308306:A:G	0	0	0	0	0	0	0	0
chr1:152309214:C:T	0	0	0	0	0	0	0	0
chr1:152309472:G:A	0	0	0	0	0	0	0	0
chr1:152309835:C:T	0	0	0	0	0	0	0	0
chr1:152310441:G:T	0	0	0	0	0	0	0	0
chr1:152310760:T:C	0	0	0	0	0	0	0	0
chr1:152310807:C:T	0	0	0	0	0	0	0	0
chr1:152311386:G:C	0	0	0	0	0	0	0	0
chr1:152311499:A:G	0	0	0	0	0	0	0	0
chr1:152312378:A:G	0	0	0	0	0	0	0	0
chr1:152312623:C:T	0	0	0	0	0	0	0	0
chr1:152313454:G:A	0	0	0	0	0	0	0	0
chr1:152313526:T:C	0	0	0	0	0	0	0	0
chr1:152313556:C:T	0	0	0	0	0	0	0	0
chr1:152313650:A:G	0	0	0	0	0	0	0	0
chr1:152313891:C:A	0	0	0	0	0	0	0	0
chr1:152350656:G:T	0	0	0	0	0	0	0	0
chr1:152353256:G:A	0	0	0	0	0	0	0	0
chr1:152354367:C:T	0	0	0	0	0	0	0	0
chr1:152354993:C:T	0	0	0	0	0	0	0	0
chr1:152355935:A:G	0	0	0	0	0	0	0	0
chr1:152409586:C:T	0	0	0	0	0	0	0	0
chr1:152409644:C:T	0	0	0	0	0	0	0	0
chr1:152565882:G:C	0	0	0	0	0	0	0	0
chr1:152759630:A:T	0	0	0	0	0	0	0	0
chr1:152759698:T:C	0	0	0	0	0	0	0	0
chr1:152759960:G:C	0	0	0	0	0	0	0	0
chr1:152760091:G:A	0	0	0	0	0	0	0	0
chr1:152760825:T:A	0	0	0	0	0	0	0	0
chr1:152760900:C:G	0	0	0	0	0	0	0	0
chr1:152776615:C:T	0	0	0	0	0	0	0	0
chr1:152787474:A:G	0	0	0	0	0	0	0	0
chr1:152798045:G:A	0	0	0	0	0	0	0	0
chr1:152798057:G:A	0	0	0	0	0	0	0	0
chr1:152805098:G:A	0	0	0	0	0	0	0	0
chr1:152805432:C:T	0	0	0	0	0	0	0	0
chr1:153297886:C:G	0	0	0	0	0	0	0	0
chr1:153304947:C:T	0	0	0	0	0	0	0	0
chr1:153330776:G:A	0	0	0	0	0	0	0	0
chr1:153341677:C:A	0	0	0	0	0	0	0	0
chr1:153343103:A:G	0	0	0	0	0	0	0	0
chr1:153347896:T:G	0	0	0	0	0	0	0	0
chr1:154272666:T:G	1650	971	3325	1065	2260	2.0	1.0	2.0
chr1:154429203:G:A	9	5	14	4	10	2	0	2
chr1:154465420:T:C	5	3	8	2	6	2	0	2
chr1:154501655:C:G	0	0	0	0	0	0	0	0
chr1:154544102:G:A	0	0	0	0	0	0	0	0
chr1:154551996:C:T	2	0	2	2	0	1.0	1.0	0.0
chr1:154772331:C:G	2	0	3	3	0	1.5	1.5	0.0
chr1:154859814:C:T	2	1	3	1	2	1.5	0.5	1.0
chr1:154859828:T:C	2	1	4	2	2	2.0	1.0	1.0
chr1:154946604:C:T	845	452	1578	547	1031	2	1	2
chr1:154965738:C:G	26	14	40	12	28	2.0	0.0	2.0
chr1:155015050:C:T	6	6	12	0	12	2.0	0.0	2.0
chr1:155033615:A:G	0	0	0	0	0	0	0	0
chr1:155034523:C:T	3	2	5	1	4	2	0	2
chr1:155034817:C:T	1	1	2	0	2	2	0	2
chr1:155034826:C:A	1	1	2	0	2	2	0	2
chr1:155047234:A:C	1	1	2	0	2	2	0	2
chr1:155054429:T:G	29	17	46	12	34	2	0	2
chr1:155056046:G:A	2	1	3	1	2	1.5	0.5	1.0
chr1:155058081:A:C	4	2	6	2	4	1.5	0.5	1.0
chr1:155061442:C:T	11	6	17	5	12	2	0	2
chr1:155133969:C:T	1	1	2	0	2	2	0	2
chr1:155134074:A:G	1	1	2	0	2	2	0	2
chr1:155177242:G:A	4	2	6	2	4	1.5	0.5	1.0
chr1:155202934:T:C	1	1	2	0	2	2	0	2
chr1:155247682:T:C	24	11	36	14	22	1.5	1.0	0.0
chr1:155321259:C:T	1	1	2	0	2	2	0	2
chr1:155688294:T:C	137	74	218	68	150	2	0	2
chr1:155688550:T:C	118	65	188	58	130	2.0	0.0	2.0
chr1:155859720:C:T	311	168	538	176	362	2	0	2
chr1:155933617:C:T	290	128	443	175	268	1.0	1.0	0.0
chr1:156036834:C:T	30	13	43	17	26	1.0	1.0	0.0
chr1:156176427:C:T	18	15	35	5	30	2.0	0.0	2.0
chr1:156199819:A:G	1	1	2	0	2	2	0	2
chr1:156232382:A:G	1087	611	1979	616	1363	2	1	2
chr1:156236364:C:T	1131	624	2058	671	1387	2	1	2
chr1:156244130:C:T	13	8	22	6	16	2	0	2
chr1:156246108:G:A	3	3	6	0	6	2	0	2
chr1:156377340:G:A	0	0	0	0	0	0	0	0
chr1:156477111:T:C	21	14	37	7	30	2	0	2
chr1:156480927:G:A	32	16	51	17	34	2.0	0.5	1.0
chr1:156480948:G:A	32	16	52	18	34	2.0	0.5	1.0
chr1:156596319:T:C	19	13	32	6	26	2	0	2
chr1:156652460:G:A	0	0	0	0	0	0	0	0
chr1:156669961:G:A	0	0	0	0	0	0	0	0
chr1:156670364:G:A	0	0	0	0	0	0	0	0
chr1:156670886:G:A	0	0	0	0	0	0	0	0
chr1:156671745:C:T	0	0	0	0	0	0	0	0
chr1:156735672:G:A	0	0	0	0	0	0	0	0
chr1:156752069:G:A	13	7	20	6	14	2	0	2
chr1:156800530:G:A	204	106	324	108	216	2.0	1.0	2.0
chr1:156815190:T:C	1	1	2	0	2	2	0	2
chr1:156815825:G:A	0	0	0	0	0	0	0	0
chr1:156844235:G:A	0	0	0	0	0	0	0	0
chr1:156914792:C:T	0	0	0	0	0	0	0	0
chr1:156920880:T:C	0	0	0	0	0	0	0	0
chr1:156937323:T:C	0	0	0	0	0	0	0	0
chr1:156939511:T:A	0	0	0	0	0	0	0	0
chr1:156939903:G:A	0	0	0	0	0	0	0	0
chr1:156945246:C:T	0	0	0	0	0	0	0	0
chr1:157092783:T:C	0	0	0	0	0	0	0	0
chr1:157092947:C:G	0	0	0	0	0	0	0	0
chr1:157544307:A:G	45	24	71	21	50	2	0	2
chr1:157769983:G:A	231	134	420	120	300	2	0	2
chr1:157802090:C:T	227	130	380	110	270	2	0	2
chr1:158087843:C:G	0	0	0	0	0	0	0	0
chr1:158177156:T:C	0	0	0	0	0	0	0	0
chr1:158547352:C:T	0	0	0	0	0	0	0	0
chr1:158562615:T:G	0	0	0	0	0	0	0	0
chr1:158563350:A:G	0	0	0	0	0	0	0	0
chr1:158563434:A:G	0	0	0	0	0	0	0	0
chr1:158579474:G:A	0	0	0	0	0	0	0	0
chr1:158579630:C:T	0	0	0	0	0	0	0	0
chr1:158612856:T:C	0	0	0	0	0	0	0	0
chr1:158619315:T:C	0	0	0	0	0	0	0	0
chr1:158638145:T:G	1	1	2	0	2	2	0	2
chr1:158639682:T:A	0	0	0	0	0	0	0	0
chr1:158642446:A:G	0	0	0	0	0	0	0	0
chr1:158667938:T:C	0	0	0	0	0	0	0	0
chr1:158677732:A:G	0	0	0	0	0	0	0	0
chr1:158717373:G:A	0	0	0	0	0	0	0	0
chr1:158717434:G:A	0	0	0	0	0	0	0	0
chr1:158755290:C:T	0	0	0	0	0	0	0	0
chr1:158766425:G:A	0	0	0	0	0	0	0	0
chr1:158844029:A:G	117	4	130	122	8	1	1	0
chr1:158939096:C:T	324	231	588	110	478	2.0	0.0	2.0
chr1:158973693:G:A	46	30	80	16	64	2.0	0.0	2.0
chr1:159032587:C:A	327	163	531	195	336	2	1	0
chr1:159032599:T:A	330	164	536	198	338	2.0	1.0	0.0
chr1:159199851:T:C	4	1	5	3	2	1.0	1.0	0.0
chr1:159200859:G:A	4	1	5	3	2	1.0	1.0	0.0
chr1:159205564:G:A	0	0	0	0	0	0	0	0
chr1:159440067:A:G	0	0	0	0	0	0	0	0
chr1:159440550:T:A	0	0	0	0	0	0	0	0
chr1:159535507:C:T	0	0	0	0	0	0	0	0
chr1:159809193:T:C	0	0	0	0	0	0	0	0
chr1:159855271:G:C	1	0	1	1	0	1	1	0
chr1:160135577:C:T	0	0	0	0	0	0	0	0
chr1:160139998:C:T	0	0	0	0	0	0	0	0
chr1:160140045:G:A	0	0	0	0	0	0	0	0
chr1:160152109:A:G	0	0	0	0	0	0	0	0
chr1:160155085:G:A	0	0	0	0	0	0	0	0
chr1:160164266:G:A	0	0	0	0	0	0	0	0
chr1:160164415:C:T	0	0	0	0	0	0	0	0
chr1:160166560:G:A	0	0	0	0	0	0	0	0
chr1:160339874:T:G	1100	600	2013	686	1327	2.0	1.0	2.0
chr1:160424115:A:G	0	0	0	0	0	0	0	0
chr1:161041419:G:A	6	2	8	4	4	1.0	1.0	0.0
chr1:161043331:C:T	234	120	373	131	242	2.0	1.0	2.0
chr1:161047766:C:T	198	115	323	91	232	2.0	0.0	2.0
chr1:161047971:C:T	112	57	173	57	116	2.0	1.0	2.0
chr1:161049250:G:C	221	118	377	119	258	2	1	2
chr1:161052849:C:G	5	3	8	2	6	2	0	2
chr1:161079719:G:T	0	0	0	0	0	0	0	0
chr1:161099046:A:C	64	37	101	27	74	2.0	0.0	2.0
chr1:161157185:C:G	90	45	139	49	90	2.0	0.5	1.0
chr1:161193247:T:C	0	0	0	0	0	0	0	0
chr1:161198399:C:T	0	0	0	0	0	0	0	0
chr1:161212418:C:G	766	403	1359	465	894	2.0	1.0	2.0
chr1:161232815:G:A	1	1	2	0	2	2	0	2
chr1:161284456:A:G	1	1	2	0	2	2	0	2
chr1:161997891:A:G	0	0	0	0	0	0	0	0
chr1:162343945:C:T	3	2	5	1	4	2	0	2
chr1:162378847:C:T	0	0	0	0	0	0	0	0
chr1:162412043:C:G	0	0	0	0	0	0	0	0
chr1:162854763:G:A	0	0	0	0	0	0	0	0
chr1:162855667:C:A	0	0	0	0	0	0	0	0
chr1:165563768:C:A	0	0	0	0	0	0	0	0
chr1:165665188:C:G	7	0	7	7	0	1	1	0
chr1:165683036:A:G	104	66	172	40	132	2.0	0.0	2.0
chr1:165698275:T:C	37	19	56	18	38	2	0	2
chr1:165698311:G:C	38	19	57	19	38	1.5	0.5	1.0
chr1:166849329:A:G	47	21	69	27	42	1	1	0
chr1:166857536:C:T	28	17	47	11	36	2.0	0.0	2.0
chr1:166989364:T:C	0	0	0	0	0	0	0	0
chr1:166989473:T:G	1	0	2	2	0	2	2	0
chr1:167073525:C:T	0	0	0	0	0	0	0	0
chr1:167127694:A:C	0	0	0	0	0	0	0	0
chr1:167128330:G:A	0	0	0	0	0	0	0	0
chr1:167128502:C:A	0	0	0	0	0	0	0	0
chr1:167439433:C:T	0	0	0	0	0	0	0	0
chr1:167880176:A:G	0	0	0	0	0	0	0	0
chr1:168137478:T:C	0	0	0	0	0	0	0	0
chr1:168313023:T:A	12	5	17	7	10	1.0	1.0	0.0
chr1:168540884:T:A	0	0	0	0	0	0	0	0
chr1:168581297:A:G	2	2	4	0	4	2.0	0.0	2.0
chr1:168728935:C:T	0	0	0	0	0	0	0	0
chr1:169541142:G:A	1	0	1	1	0	1	1	0
chr1:169542317:T:C	6	3	10	4	6	2.0	0.5	1.0
chr1:169542496:T:C	7	4	12	4	8	2	0	2
chr1:169542517:T:C	7	4	12	4	8	2	0	2
chr1:169542640:T:G	7	3	12	4	8	1	1	0
chr1:169546488:C:T	0	0	0	0	0	0	0	0
chr1:169550656:G:A	1	0	1	1	0	1	1	0
chr1:169597075:C:T	6	4	10	2	8	2.0	0.0	2.0
chr1:169611647:C:T	7	1	8	6	2	1	1	0
chr1:169613079:C:T	13	3	16	10	6	1	1	0
chr1:169703202:C:T	204	85	322	136	186	1.0	1.0	0.0
chr1:169704697:G:A	774	429	1446	466	980	2.0	1.0	2.0
chr1:169708568:A:G	907	516	1801	576	1225	2	1	2
chr1:169727805:G:A	16	6	23	11	12	1.0	1.0	0.0
chr1:169804176:G:A	18	7	27	11	16	1.0	1.0	0.0
chr1:169854577:T:C	14	7	21	7	14	1.5	0.5	1.0
chr1:169982856:C:T	4	1	5	3	2	1.0	1.0	0.0
chr1:170552235:G:A	23	12	37	11	26	2	0	2
chr1:170552509:T:G	27	14	42	14	28	2	0	2
chr1:171280905:C:T	20	10	30	10	20	1.5	0.5	1.0
chr1:171282370:G:T	0	0	0	0	0	0	0	0
chr1:171339693:A:G	5	2	7	3	4	1	1	0
chr1:171540188:G:A	278	132	436	158	278	1.0	1.0	0.0
chr1:171541900:C:G	260	133	424	142	282	2.0	1.0	2.0
chr1:171545592:C:G	186	101	310	90	220	2.0	0.0	2.0
chr1:171557431:G:A	145	71	227	81	146	1	1	0
chr1:171557771:G:A	287	135	457	172	285	1	1	0
chr1:171587026:G:C	154	82	252	80	172	2.0	0.0	2.0
chr1:171636399:A:G	0	0	0	0	0	0	0	0
chr1:171670579:T:C	1	0	1	1	0	1	1	0
chr1:171781911:A:G	88	38	128	52	76	1.0	1.0	0.0
chr1:171782096:T:C	90	42	134	50	84	1.0	1.0	0.0
chr1:171783899:A:G	22	10	32	12	20	1.0	1.0	0.0
chr1:171786030:G:A	27	14	41	13	28	2	0	2
chr1:172532503:T:C	1	0	1	1	0	1	1	0
chr1:172533339:T:C	482	263	807	245	562	2.0	0.0	2.0
chr1:173487878:C:T	2139	1217	5265	2155	3110	2	1	2
chr1:173637040:A:T	0	0	0	0	0	0	0	0
chr1:173886160:A:T	22	8	30	14	16	1.0	1.0	0.0
chr1:173909694:T:C	1	1	2	0	2	2	0	2
chr1:173909724:T:C	1	1	2	0	2	2	0	2
chr1:175123538:C:T	0	0	0	0	0	0	0	0
chr1:175123571:C:T	0	0	0	0	0	0	0	0
chr1:175147116:C:G	0	0	0	0	0	0	0	0
chr1:175355515:A:G	0	0	0	0	0	0	0	0
chr1:175406499:G:A	0	0	0	0	0	0	0	0
chr1:176206683:A:C	248	116	381	145	236	1.0	1.0	0.0
chr1:176894700:G:C	0	0	0	0	0	0	0	0
chr1:176894731:T:C	0	0	0	0	0	0	0	0
chr1:177023417:A:G	0	0	0	0	0	0	0	0
chr1:177032760:C:G	0	0	0	0	0	0	0	0
chr1:177933252:C:A	0	0	0	0	0	0	0	0
chr1:177946339:A:C	0	0	0	0	0	0	0	0
chr1:177960961:T:C	0	0	0	0	0	0	0	0
chr1:177961507:G:A	0	0	0	0	0	0	0	0
chr1:178514096:G:A	0	0	0	0	0	0	0	0
chr1:178520843:T:G	0	0	0	0	0	0	0	0
chr1:179444970:A:C	0	0	0	0	0	0	0	0
chr1:179592510:A:C	0	0	0	0	0	0	0	0
chr1:179592548:A:T	0	0	0	0	0	0	0	0
chr1:179662107:G:A	0	0	0	0	0	0	0	0
chr1:179882939:T:C	227	121	363	111	252	2	0	2
chr1:180003202:A:C	126	70	204	60	144	2.0	0.0	2.0
chr1:180031407:G:T	16	6	22	10	12	1.0	1.0	0.0
chr1:180111155:T:A	34	18	52	16	36	2.0	0.0	2.0
chr1:180248521:G:A	0	0	0	0	0	0	0	0
chr1:180271617:C:T	3	2	5	1	4	2	0	2
chr1:180928433:C:T	0	0	0	0	0	0	0	0
chr1:180936558:C:T	0	0	0	0	0	0	0	0
chr1:181049100:A:G	131	67	208	68	140	2	0	2
chr1:181088878:C:G	112	55	169	59	110	1.0	1.0	0.0
chr1:181755974:T:C	0	0	0	0	0	0	0	0
chr1:181772165:C:T	0	0	0	0	0	0	0	0
chr1:182387112:T:C	0	0	0	0	0	0	0	0
chr1:182474327:T:C	0	0	0	0	0	0	0	0
chr1:182527694:A:G	1	1	2	0	2	2	0	2
chr1:182585422:C:T	15	7	22	8	14	1	1	0
chr1:182586901:A:G	48	28	77	21	56	2.0	0.0	2.0
chr1:183023998:C:T	4	3	7	1	6	2.0	0.0	2.0
chr1:183103455:T:C	1	0	1	1	0	1	1	0
chr1:183116620:A:G	1	1	2	0	2	2	0	2
chr1:183117622:A:C	2	2	4	0	4	2.0	0.0	2.0
chr1:183124740:T:C	0	0	0	0	0	0	0	0
chr1:183125412:T:C	0	0	0	0	0	0	0	0
chr1:183136399:T:C	15	14	29	1	28	2	0	2
chr1:183136570:G:A	15	14	29	1	28	2	0	2
chr1:183215555:C:T	0	0	0	0	0	0	0	0
chr1:183926301:A:C	0	0	0	0	0	0	0	0
chr1:184708330:G:A	1	1	2	0	2	2	0	2
chr1:184794933:C:G	2	2	6	2	4	3.0	1.0	2.0
chr1:185297982:A:G	43	17	61	27	34	1	1	0
chr1:186015385:T:C	0	0	0	0	0	0	0	0
chr1:186057342:T:C	0	0	0	0	0	0	0	0
chr1:186081285:A:G	0	0	0	0	0	0	0	0
chr1:196673103:G:A	1	0	1	1	0	1	1	0
chr1:196713817:G:A	0	0	0	0	0	0	0	0
chr1:196726612:A:G	0	0	0	0	0	0	0	0
chr1:196740644:G:T	0	0	0	0	0	0	0	0
chr1:197101312:G:T	2	1	5	1	4	2.5	0.5	2.0
chr1:200048458:C:G	0	0	0	0	0	0	0	0
chr1:200911850:C:T	0	0	0	0	0	0	0	0
chr1:200912044:C:A	0	0	0	0	0	0	0	0
chr1:201043469:G:A	0	0	0	0	0	0	0	0
chr1:201077934:G:A	0	0	0	0	0	0	0	0
chr1:201077983:A:G	0	0	0	0	0	0	0	0
chr1:201083182:AGA:TGC	0	0	0	0	0	0	0	0
chr1:201091737:G:A	0	0	0	0	0	0	0	0
chr1:201197255:G:A	0	0	0	0	0	0	0	0
chr1:201205087:C:A	0	0	0	0	0	0	0	0
chr1:201206099:C:A	0	0	0	0	0	0	0	0
chr1:201206146:A:G	0	0	0	0	0	0	0	0
chr1:201206587:G:T	0	0	0	0	0	0	0	0
chr1:201206640:G:C	0	0	0	0	0	0	0	0
chr1:201206890:A:G	0	0	0	0	0	0	0	0
chr1:201207583:G:T	0	0	0	0	0	0	0	0
chr1:201209837:A:G	0	0	0	0	0	0	0	0
chr1:201214296:G:A	0	0	0	0	0	0	0	0
chr1:201215750:C:A	0	0	0	0	0	0	0	0
chr1:201217373:G:A	0	0	0	0	0	0	0	0
chr1:201221604:G:A	0	0	0	0	0	0	0	0
chr1:201225991:C:T	0	0	0	0	0	0	0	0
chr1:201891498:A:G	6	4	10	2	8	2.0	0.0	2.0
chr1:201899205:C:T	0	0	0	0	0	0	0	0
chr1:201900129:G:A	1	1	2	0	2	2	0	2
chr1:201983446:T:C	16	6	24	10	14	1.0	1.0	0.0
chr1:201999954:G:A	39	21	62	20	42	2	1	2
chr1:202001620:G:A	2	1	3	1	2	1.5	0.5	1.0
chr1:202012734:T:C	0	0	0	0	0	0	0	0
chr1:202303326:G:A	7	4	11	3	8	2	0	2
chr1:202335740:T:C	102	47	158	57	101	1.0	1.0	0.0
chr1:202596820:G:A	4	2	6	2	4	1.5	0.5	1.0
chr1:202962711:G:A	9	3	12	6	6	1	1	0
chr1:203039158:C:G	0	0	0	0	0	0	0	0
chr1:203061557:T:C	0	0	0	0	0	0	0	0
chr1:203063794:C:T	0	0	0	0	0	0	0	0
chr1:203067629:T:C	0	0	0	0	0	0	0	0
chr1:203085973:A:G	0	0	0	0	0	0	0	0
chr1:203174597:G:C	0	0	0	0	0	0	0	0
chr1:203183673:T:C	0	0	0	0	0	0	0	0
chr1:203342193:C:A	120	63	190	60	130	2.0	0.0	2.0
chr1:203861803:G:A	271	117	408	162	246	1	1	0
chr1:204151824:G:T	1	0	1	1	0	1	1	0
chr1:204229081:A:G	0	0	0	0	0	0	0	0
chr1:204230486:C:T	0	0	0	0	0	0	0	0
chr1:204273710:A:C	0	0	0	0	0	0	0	0
chr1:204988640:G:C	1	0	1	1	0	1	1	0
chr1:205009576:G:A	0	0	0	0	0	0	0	0
chr1:205058433:G:T	0	0	0	0	0	0	0	0
chr1:205058609:G:A	0	0	0	0	0	0	0	0
chr1:205059787:C:T	0	0	0	0	0	0	0	0
chr1:205061988:C:T	0	0	0	0	0	0	0	0
chr1:205069603:C:T	0	0	0	0	0	0	0	0
chr1:205070081:C:A	0	0	0	0	0	0	0	0
chr1:205073712:G:A	0	0	0	0	0	0	0	0
chr1:205073811:C:T	0	0	0	0	0	0	0	0
chr1:205083595:C:T	5	3	8	2	6	2	0	2
chr1:205084022:A:G	6	3	9	3	6	1.5	0.5	1.0
chr1:205121977:G:C	116	46	173	75	98	1.0	1.0	0.0
chr1:205147507:A:T	25	16	41	9	32	2	0	2
chr1:205160191:G:A	9	4	13	5	8	1	1	0
chr1:205303790:G:A	4	3	7	1	6	2.0	0.0	2.0
chr1:205308653:C:T	20	14	37	7	30	2.0	0.0	2.0
chr1:205337462:G:A	0	0	0	0	0	0	0	0
chr1:205339207:G:A	0	0	0	0	0	0	0	0
chr1:205339240:C:T	0	0	0	0	0	0	0	0
chr1:205419256:C:G	0	0	0	0	0	0	0	0
chr1:205531415:T:C	0	0	0	0	0	0	0	0
chr1:205592244:C:T	10	6	16	4	12	2.0	0.0	2.0
chr1:205664739:C:T	0	0	0	0	0	0	0	0
chr1:205795512:G:A	0	0	0	0	0	0	0	0
chr1:205810103:G:A	0	0	0	0	0	0	0	0
chr1:205832744:A:G	3	3	6	0	6	2	0	2
chr1:205843784:A:G	1	1	2	0	2	2	0	2
chr1:206023017:G:A	0	0	0	0	0	0	0	0
chr1:206461084:A:G	5	4	9	1	8	2	0	2
chr1:206474444:T:C	223	82	322	152	170	1	1	0
chr1:206474804:T:G	0	0	0	0	0	0	0	0
chr1:206475035:G:A	223	85	325	151	174	1	1	0
chr1:206476722:A:G	4	0	4	4	0	1.0	1.0	0.0
chr1:206478124:C:T	0	0	0	0	0	0	0	0
chr1:207468495:C:T	1	1	2	0	2	2	0	2
chr1:207717521:T:C	0	0	0	0	0	0	0	0
chr1:208034494:G:A	0	0	0	0	0	0	0	0
chr1:208216741:G:C	0	0	0	0	0	0	0	0
chr1:208217124:C:T	0	0	0	0	0	0	0	0
chr1:208217909:C:T	0	0	0	0	0	0	0	0
chr1:209608998:A:G	0	0	0	0	0	0	0	0
chr1:209615169:G:A	2	2	4	0	4	2.0	0.0	2.0
chr1:209623565:C:T	0	0	0	0	0	0	0	0
chr1:209625908:A:G	0	0	0	0	0	0	0	0
chr1:209634627:G:A	0	0	0	0	0	0	0	0
chr1:209638541:T:G	0	0	0	0	0	0	0	0
chr1:209759986:A:G	313	133	463	187	276	1	1	0
chr1:209760195:A:G	316	136	470	188	282	1.0	1.0	0.0
chr1:209775366:A:C	1436	839	3003	946	2057	2.0	1.0	2.0
chr1:209777503:G:A	51	21	72	30	42	1	1	0
chr1:209783197:C:A	6	1	7	5	2	1.0	1.0	0.0
chr1:209795339:C:A	2	2	4	0	4	2.0	0.0	2.0
chr1:209833258:C:T	103	50	159	57	102	2	1	0
chr1:209843364:A:T	6	1	7	5	2	1.0	1.0	0.0
chr1:209843738:G:A	9	1	10	8	2	1	1	0
chr1:210404540:G:A	31	31	68	0	68	2	0	2
chr1:211360648:A:G	3	2	5	1	4	2	0	2
chr1:212414864:C:G	114	62	185	57	128	2.0	0.0	2.0
chr1:212445997:T:C	1554	865	3007	1043	1964	2.0	1.0	2.0
chr1:212625635:A:G	0	0	0	0	0	0	0	0
chr1:212858367:C:T	45	27	78	18	60	2	0	2
chr1:212858606:G:C	47	24	74	24	50	2	1	2
chr1:212974058:G:A	0	0	0	0	0	0	0	0
chr1:213129822:A:C	29	13	43	17	26	1	1	0
chr1:214332253:C:T	3	2	5	1	4	2	0	2
chr1:214357896:C:T	0	0	0	0	0	0	0	0
chr1:214483325:GC:CT	0	0	0	0	0	0	0	0
chr1:214613787:G:A	39	19	74	22	52	2	1	0
chr1:214646756:A:G	3	2	13	1	12	2	0	2
chr1:214657274:A:G	1	0	1	1	0	1	1	0
chr1:214663767:C:G	1	0	1	1	0	1	1	0
chr1:215567710:T:G	7	7	14	0	14	2	0	2
chr1:215620492:G:A	0	0	0	0	0	0	0	0
chr1:215675245:T:C	0	0	0	0	0	0	0	0
chr1:215728150:C:T	0	0	0	0	0	0	0	0
chr1:215786825:T:G	0	0	0	0	0	0	0	0
chr1:215813880:T:C	0	0	0	0	0	0	0	0
chr1:215838019:T:C	0	0	0	0	0	0	0	0
chr1:215877783:G:A	0	0	0	0	0	0	0	0
chr1:216084852:G:T	0	0	0	0	0	0	0	0
chr1:216175422:C:T	0	0	0	0	0	0	0	0
chr1:216323605:G:A	0	0	0	0	0	0	0	0
chr1:216418661:T:C	0	0	0	0	0	0	0	0
chr1:216421964:C:T	0	0	0	0	0	0	0	0
chr1:216519327:C:T	0	0	0	0	0	0	0	0
chr1:217630983:G:A	628	327	1062	364	698	2.0	1.0	2.0
chr1:217683284:G:A	2	2	4	0	4	2.0	0.0	2.0
chr1:217741982:C:T	1	1	2	0	2	2	0	2
chr1:219609937:T:A	0	0	0	0	0	0	0	0
chr1:219968728:C:T	208	117	350	102	248	2.0	0.0	2.0
chr1:220147681:A:G	87	42	133	47	86	2	1	0
chr1:220880203:T:C	43	22	66	22	44	2	1	2
chr1:220881419:C:G	4	1	5	3	2	1.0	1.0	0.0
chr1:221739019:T:C	203	98	318	112	206	1	1	0
chr1:221739466:T:C	265	137	419	136	283	2	0	2
chr1:222540159:C:A	0	0	0	0	0	0	0	0
chr1:222540279:C:T	0	0	0	0	0	0	0	0
chr1:222547946:C:T	0	0	0	0	0	0	0	0
chr1:222561461:G:C	17	8	26	10	16	2	1	0
chr1:222660196:C:G	35	16	53	21	32	2	1	0
chr1:223004232:A:G	1	1	2	0	2	2	0	2
chr1:223005219:A:C	7	1	8	6	2	1	1	0
chr1:223111186:A:G	0	0	0	0	0	0	0	0
chr1:223543146:C:T	1	0	1	1	0	1	1	0
chr1:223544122:A:G	1	1	2	0	2	2	0	2
chr1:223545156:A:C	1	1	2	0	2	2	0	2
chr1:223625884:G:T	1	0	1	1	0	1	1	0
chr1:223766378:A:C	178	111	296	70	226	2.0	0.0	2.0
chr1:223799979:C:T	13	6	19	7	12	1	1	0
chr1:224175668:A:T	0	0	0	0	0	0	0	0
chr1:225324327:T:C	0	0	0	0	0	0	0	0
chr1:225831932:T:C	28	12	44	18	26	1.0	1.0	0.0
chr1:225853788:G:A	18	7	26	12	14	1.0	1.0	0.0
chr1:226986509:T:C	32	16	48	16	32	1.5	0.5	1.0
chr1:227193770:T:G	0	0	0	0	0	0	0	0
chr1:227732402:G:A	262	138	425	137	288	2.0	0.0	2.0
chr1:227732746:C:T	24	14	38	10	28	2.0	0.0	2.0
chr1:227775790:G:T	4	2	6	2	4	1.5	0.5	1.0
chr1:227845496:A:G	1	1	2	0	2	2	0	2
chr1:227921770:C:T	6	2	9	5	4	1.5	1.0	0.0
chr1:228243394:A:G	1	0	1	1	0	1	1	0
chr1:228245516:A:G	0	0	0	0	0	0	0	0
chr1:228246694:T:C	0	0	0	0	0	0	0	0
chr1:228246766:T:C	1	0	1	1	0	1	1	0
chr1:228264125:C:T	1	0	1	1	0	1	1	0
chr1:228273428:A:G	0	0	0	0	0	0	0	0
chr1:228275732:C:T	0	0	0	0	0	0	0	0
chr1:228276547:T:G	3	2	5	1	4	2	0	2
chr1:228276575:T:C	3	2	5	1	4	2	0	2
chr1:228316010:G:A	0	0	0	0	0	0	0	0
chr1:228372293:C:T	0	0	0	0	0	0	0	0
chr1:228372438:A:G	0	0	0	0	0	0	0	0
chr1:228377507:C:T	4	3	7	1	6	2.0	0.0	2.0
chr1:228411048:G:A	9	5	14	4	10	2	0	2
chr1:228457362:A:G	2	0	3	3	0	1.5	1.5	0.0
chr1:229325277:C:T	172	66	247	113	134	1.0	1.0	0.0
chr1:229495987:T:C	27	10	37	17	20	1	1	0
chr1:229499774:A:G	37	14	51	23	28	1	1	0
chr1:229547517:G:A	42	20	63	23	40	1.0	1.0	0.0
chr1:229594705:G:A	7	6	13	1	12	2	0	2
chr1:229602423:T:G	16	9	27	7	20	2.0	0.0	2.0
chr1:229614289:C:T	22	14	36	8	28	2.0	0.0	2.0
chr1:229636946:T:G	5	2	7	3	4	1	1	0
chr1:229654301:A:G	60	31	92	29	63	1.5	0.0	1.5
chr1:229659323:T:G	29	15	44	14	30	2	0	2
chr1:230249191:T:C	75	40	121	35	86	2	0	2
chr1:230249224:G:A	75	35	113	43	70	2	1	0
chr1:230279547:C:T	203	144	387	65	322	2	0	2
chr1:230678922:A:G	15	6	21	9	12	1	1	0
chr1:230690196:A:G	0	0	0	0	0	0	0	0
chr1:230693241:C:A	2	2	4	0	4	2.0	0.0	2.0
chr1:230762748:C:T	5	5	10	0	10	2	0	2
chr1:230767604:T:C	2	2	4	0	4	2.0	0.0	2.0
chr1:230772053:C:T	3	0	3	3	0	1	1	0
chr1:230778983:A:C	2	0	2	2	0	1.0	1.0	0.0
chr1:230780514:C:T	2	0	3	3	0	1.5	1.5	0.0
chr1:230787567:C:T	0	0	0	0	0	0	0	0
chr1:230961296:G:A	67	25	97	43	54	1	1	0
chr1:231241335:C:T	470	216	728	279	449	1.0	1.0	0.0
chr1:231818355:C:T	1	1	2	0	2	2	0	2
chr1:232399030:C:T	1	0	1	1	0	1	1	0
chr1:232399211:T:C	1	1	2	0	2	2	0	2
chr1:232402488:T:G	0	0	0	0	0	0	0	0
chr1:232415670:G:A	0	0	0	0	0	0	0	0
chr1:232428551:T:A	1	1	2	0	2	2	0	2
chr1:232439175:T:C	0	0	0	0	0	0	0	0
chr1:232445690:G:A	0	0	0	0	0	0	0	0
chr1:233262967:C:T	56	33	88	23	65	2.0	0.0	2.0
chr1:233905676:G:C	0	0	0	0	0	0	0	0
chr1:234467640:G:T	13	5	20	8	12	1	1	0
chr1:234607491:G:A	229	109	362	135	227	1	1	0
chr1:235182031:C:T	185	103	299	91	208	2	0	2
chr1:235465591:A:G	1	0	1	1	0	1	1	0
chr1:235777150:C:T	10	4	14	6	8	1.0	1.0	0.0
chr1:235791850:G:A	132	54	205	95	110	1.0	1.0	0.0
chr1:235808463:A:G	10	5	15	5	10	1.5	0.5	1.0
chr1:235809135:T:C	24	13	37	11	26	2.0	0.0	2.0
chr1:235809567:T:C	26	14	42	14	28	2.0	0.5	2.0
chr1:236012027:C:A	0	0	0	0	0	0	0	0
chr1:236048738:G:A	0	0	0	0	0	0	0	0
chr1:236539074:G:A	84	40	131	47	84	1.0	1.0	0.0
chr1:236543052:A:C	19	7	28	14	14	1	1	0
chr1:236543071:A:G	19	7	28	14	14	1	1	0
chr1:236543125:G:A	14	4	20	12	8	1.0	1.0	0.0
chr1:236543562:G:C	66	30	102	38	64	1.0	1.0	0.0
chr1:236548023:T:C	64	28	97	37	60	1.0	1.0	0.0
chr1:236551035:C:T	45	18	63	27	36	1	1	0
chr1:236553659:C:T	32	10	43	23	20	1.0	1.0	0.0
chr1:236555320:T:C	19	7	27	13	14	1	1	0
chr1:236558310:G:A	10	7	19	3	16	2.0	0.0	2.0
chr1:236558360:T:C	8	5	15	3	12	2.0	0.0	2.0
chr1:236566656:T:C	12	6	18	6	12	1.5	0.5	1.0
chr1:236585205:T:C	24	13	37	11	26	2.0	0.0	2.0
chr1:236586349:T:C	28	16	44	12	32	2.0	0.0	2.0
chr1:236595587:T:C	35	20	55	15	40	2	0	2
chr1:236604030:A:G	337	205	586	146	440	2	0	2
chr1:236885200:A:G	9	5	13	4	9	1	0	1
chr1:236891269:A:G	7	2	9	5	4	1	1	0
chr1:236895444:C:A	15	5	20	10	10	1	1	0
chr1:237830424:C:T	0	0	0	0	0	0	0	0
chr1:240474271:A:G	0	0	0	0	0	0	0	0
chr1:241592046:C:T	82	38	130	48	82	2.0	1.0	0.0
chr1:241744515:T:C	0	0	0	0	0	0	0	0
chr1:241770574:A:G	0	0	0	0	0	0	0	0
chr1:241788027:C:T	0	0	0	0	0	0	0	0
chr1:241801257:C:T	0	0	0	0	0	0	0	0
chr1:242524088:G:A	58	31	78	28	50	1.0	0.0	1.0
chr1:244842071:A:G	81	43	126	38	88	2	0	2
chr1:244864047:C:T	1985	1239	4862	1587	3275	2	1	2
chr1:245685694:G:A	0	0	0	0	0	0	0	0
chr1:245749538:C:T	113	48	175	71	104	1	1	0
chr1:245858549:G:A	108	49	167	63	104	1.0	1.0	0.0
chr1:246327150:G:A	24	13	37	11	26	2.0	0.0	2.0
chr1:246507179:C:G	215	103	339	124	215	2	1	0
chr1:246544556:A:G	46	30	77	18	59	2.0	0.0	2.0
chr1:246861024:G:A	16	6	22	10	12	1.0	1.0	0.0
chr1:246945712:G:C	0	0	0	0	0	0	0	0
chr1:246988185:C:T	1	0	1	1	0	1	1	0
chr1:246988255:A:G	1	1	2	0	2	2	0	2
chr1:247038289:T:C	8	5	13	3	10	2.0	0.0	2.0
chr1:247256207:T:C	2	2	4	0	4	2.0	0.0	2.0
chr1:247256362:C:T	2	1	3	1	2	1.5	0.5	1.0
chr1:247451594:A:C	0	0	0	0	0	0	0	0
chr1:247491691:T:C	0	0	0	0	0	0	0	0
chr1:247491973:T:C	0	0	0	0	0	0	0	0
chr1:247531647:G:C	0	0	0	0	0	0	0	0
chr1:247531656:G:A	0	0	0	0	0	0	0	0
chr1:247588807:A:G	0	0	0	0	0	0	0	0
chr1:247588859:T:C	0	0	0	0	0	0	0	0
chr1:247605915:T:G	0	0	0	0	0	0	0	0
chr1:247606290:C:T	0	0	0	0	0	0	0	0
chr1:247606450:A:G	0	0	0	0	0	0	0	0
chr1:247672648:T:C	0	0	0	0	0	0	0	0
chr1:247712113:A:G	0	0	0	0	0	0	0	0
chr1:247712281:G:C	0	0	0	0	0	0	0	0
chr1:247712306:C:G	0	0	0	0	0	0	0	0
chr1:247857254:G:C	0	0	0	0	0	0	0	0
chr1:247860664:C:T	0	0	0	0	0	0	0	0
chr1:247864917:G:A	0	0	0	0	0	0	0	0
chr1:247896121:C:T	0	0	0	0	0	0	0	0
chr1:247896154:G:A	0	0	0	0	0	0	0	0
chr1:247896401:T:A	0	0	0	0	0	0	0	0
chr1:247896410:T:C	0	0	0	0	0	0	0	0
chr1:247921132:G:A	0	0	0	0	0	0	0	0
chr1:247921209:T:C	0	0	0	0	0	0	0	0
chr1:247921523:C:T	0	0	0	0	0	0	0	0
chr1:247921822:G:A	0	0	0	0	0	0	0	0
chr1:247949325:T:C	0	0	0	0	0	0	0	0
chr1:247949613:A:G	0	0	0	0	0	0	0	0
chr1:247965627:G:A	0	0	0	0	0	0	0	0
chr1:247965938:G:A	0	0	0	0	0	0	0	0
chr1:248180241:C:T	0	0	0	0	0	0	0	0
chr1:248180643:C:G	0	0	0	0	0	0	0	0
chr1:248180688:T:C	0	0	0	0	0	0	0	0
chr1:248203400:G:A	0	0	0	0	0	0	0	0
chr1:248203490:T:C	0	0	0	0	0	0	0	0
chr1:248273670:A:G	0	0	0	0	0	0	0	0
chr1:248295434:A:G	0	0	0	0	0	0	0	0
chr1:248295458:C:A	0	0	0	0	0	0	0	0
chr1:248323714:C:T	0	0	0	0	0	0	0	0
chr1:248323998:C:T	0	0	0	0	0	0	0	0
chr1:248349196:A:G	0	0	0	0	0	0	0	0
chr1:248349335:C:T	0	0	0	0	0	0	0	0
chr1:248349447:G:A	0	0	0	0	0	0	0	0
chr1:248349465:G:T	0	0	0	0	0	0	0	0
chr1:248362345:CACC:AACT	0	0	0	0	0	0	0	0
chr1:248362355:G:A	0	0	0	0	0	0	0	0
chr1:248362478:C:T	0	0	0	0	0	0	0	0
chr1:248387902:T:C	0	0	0	0	0	0	0	0
chr1:248388259:C:T	0	0	0	0	0	0	0	0
chr1:248388335:T:G	0	0	0	0	0	0	0	0
chr1:248442135:C:G	0	0	0	0	0	0	0	0
chr1:248442141:G:T	0	0	0	0	0	0	0	0
chr1:248574028:C:T	0	0	0	0	0	0	0	0
chr1:248574153:A:G	0	0	0	0	0	0	0	0
chr1:248649991:T:C	0	0	0	0	0	0	0	0
chr1:248813215:T:C	3	2	5	1	4	2	0	2
chr1:248854200:C:T	11	6	19	5	14	2	0	2
chr2:242800:T:C	22	0	23	23	0	1.0	1.0	0.0
chr2:264019:C:A	82	21	111	69	42	1.0	1.0	0.0
chr2:272203:C:T	400	233	699	195	504	2.0	0.0	2.0
chr2:677295:C:T	740	415	1404	440	964	2.0	0.0	2.0
chr2:1316371:C:T	0	0	0	0	0	0	0	0
chr2:1414420:C:G	0	0	0	0	0	0	0	0
chr2:1477383:G:T	0	0	0	0	0	0	0	0
chr2:1487951:G:A	0	0	0	0	0	0	0	0
chr2:1540845:G:A	0	0	0	0	0	0	0	0
chr2:1648888:G:A	0	0	0	0	0	0	0	0
chr2:1889361:C:T	0	0	0	0	0	0	0	0
chr2:3189269:G:A	338	200	579	155	424	2.0	0.0	2.0
chr2:3500916:A:G	639	369	1195	345	850	2	0	2
chr2:3550384:T:C	517	279	870	276	594	2	0	2
chr2:3575950:A:G	247	119	381	135	246	1	1	0
chr2:3580058:G:C	8	1	9	7	2	1.0	1.0	0.0
chr2:7024447:A:G	0	0	0	0	0	0	0	0
chr2:8730684:A:G	61	36	101	25	76	2	0	2
chr2:9475906:A:G	33	16	52	18	34	2	1	0
chr2:9493008:T:G	12	7	19	5	14	2.0	0.0	2.0
chr2:9494727:A:G	108	65	182	44	138	2.0	0.0	2.0
chr2:9843557:G:T	299	175	511	133	378	2	0	2
chr2:9919600:A:G	63	35	105	29	76	2	0	2
chr2:10122732:G:A	0	0	0	0	0	0	0	0
chr2:10423107:G:A	7	4	12	4	8	2	0	2
chr2:10423110:G:A	7	3	12	4	8	1	1	0
chr2:10768767:A:G	1	1	2	0	2	2	0	2
chr2:10790777:T:C	875	481	1660	567	1093	2	1	2
chr2:10820826:G:A	0	0	0	0	0	0	0	0
chr2:10913614:C:T	0	0	0	0	0	0	0	0
chr2:11308832:A:T	3	1	4	2	2	1	1	0
chr2:11562535:A:C	2	1	3	1	2	1.5	0.5	1.0
chr2:11580860:G:A	0	0	0	0	0	0	0	0
chr2:11585821:T:C	1	1	2	0	2	2	0	2
chr2:11596179:G:A	0	0	0	0	0	0	0	0
chr2:11792047:G:T	1	1	2	0	2	2	0	2
chr2:15330724:C:T	1	0	1	1	0	1	1	0
chr2:15461317:C:T	10	4	14	6	8	1.0	1.0	0.0
chr2:15475786:A:G	24	13	37	11	26	2.0	0.0	2.0
chr2:15534562:T:C	162	91	262	76	186	2.0	0.0	2.0
chr2:17515306:C:T	1	1	2	0	2	2	0	2
chr2:17517411:A:G	9	7	18	2	16	2	0	2
chr2:17716221:T:C	100	44	145	58	87	1.0	1.0	0.0
chr2:17932241:G:A	0	0	0	0	0	0	0	0
chr2:17932522:G:A	0	0	0	0	0	0	0	0
chr2:18576235:G:C	5	1	6	4	2	1	1	0
chr2:18587584:A:G	3	0	4	4	0	1	1	0
chr2:20624738:C:T	125	65	200	64	136	2	0	2
chr2:20624799:C:T	127	63	199	69	130	2	1	0
chr2:21001981:C:T	0	0	0	0	0	0	0	0
chr2:21005955:C:T	0	0	0	0	0	0	0	0
chr2:21008652:G:A	0	0	0	0	0	0	0	0
chr2:21009323:G:A	0	0	0	0	0	0	0	0
chr2:21041028:G:A	0	0	0	0	0	0	0	0
chr2:24216179:A:G	14	5	21	11	10	1.5	1.0	0.0
chr2:24302089:C:T	538	294	915	297	618	2.0	0.5	2.0
chr2:24820741:C:T	42	5	50	40	10	1.0	1.0	0.0
chr2:24841324:G:A	8	0	9	9	0	1.0	1.0	0.0
chr2:25136553:G:A	0	0	0	0	0	0	0	0
chr2:26424409:T:G	0	0	0	0	0	0	0	0
chr2:26453527:G:T	0	0	0	0	0	0	0	0
chr2:26516555:T:C	0	0	0	0	0	0	0	0
chr2:26519093:G:A	0	0	0	0	0	0	0	0
chr2:26577554:G:A	0	0	0	0	0	0	0	0
chr2:27104404:C:T	0	0	0	0	0	0	0	0
chr2:27201768:G:A	42	22	64	20	44	2.0	0.0	2.0
chr2:27212506:G:A	970	506	1735	585	1150	2.0	1.0	2.0
chr2:27216504:A:G	5	1	8	6	2	2	1	0
chr2:27226425:C:G	1	0	1	1	0	1	1	0
chr2:27238100:A:G	5	3	8	2	6	2	0	2
chr2:27239208:C:T	13	8	21	5	16	2	0	2
chr2:27328100:A:G	48	27	75	21	54	2.0	0.0	2.0
chr2:27336059:G:A	4	2	6	2	4	1.5	0.5	1.0
chr2:27366943:T:C	13	7	22	6	16	2	0	2
chr2:27367171:G:C	69	30	105	41	64	1	1	0
chr2:27369556:C:T	141	72	231	69	162	2	0	2
chr2:27434814:C:T	13	9	22	4	18	2	0	2
chr2:27436624:T:C	10	6	18	4	14	2.0	0.0	2.0
chr2:27440348:T:A	86	10	100	80	20	1.0	1.0	0.0
chr2:27440549:G:T	82	9	95	77	18	1.0	1.0	0.0
chr2:27444430:A:G	15	15	32	0	32	2	0	2
chr2:27453420:A:T	2	1	5	1	4	2.5	0.5	2.0
chr2:27492340:T:A	1	1	2	0	2	2	0	2
chr2:27506613:G:A	0	0	0	0	0	0	0	0
chr2:27508073:T:C	0	0	0	0	0	0	0	0
chr2:27578892:A:G	0	0	0	0	0	0	0	0
chr2:27629051:G:A	117	41	163	79	84	1	1	0
chr2:27664167:C:A	358	180	574	196	378	2.0	1.0	2.0
chr2:28411923:G:A	0	0	0	0	0	0	0	0
chr2:28632091:C:T	0	0	0	0	0	0	0	0
chr2:28642894:T:C	0	0	0	0	0	0	0	0
chr2:28643102:T:C	0	0	0	0	0	0	0	0
chr2:28778825:A:G	286	149	463	143	320	2.0	0.0	2.0
chr2:28869813:T:C	364	180	579	205	374	2.0	1.0	0.0
chr2:28869984:G:T	367	182	582	206	376	2	1	0
chr2:28929590:A:G	169	88	269	87	182	2	0	2
chr2:29002636:TCT:GCC	0	0	0	0	0	0	0	0
chr2:29003632:G:A	0	0	0	0	0	0	0	0
chr2:29017917:A:G	0	0	0	0	0	0	0	0
chr2:29023178:T:C	0	0	0	0	0	0	0	0
chr2:29033508:C:T	0	0	0	0	0	0	0	0
chr2:29051864:G:T	0	0	0	0	0	0	0	0
chr2:29133701:G:C	43	27	75	17	58	2	0	2
chr2:29193500:G:C	4	1	5	3	2	1.0	1.0	0.0
chr2:29193615:T:C	5	2	7	3	4	1	1	0
chr2:30459604:A:T	34	11	45	23	22	1.0	1.0	0.0
chr2:30753192:C:T	0	0	0	0	0	0	0	0
chr2:30758074:C:T	0	0	0	0	0	0	0	0
chr2:31580636:G:C	0	0	0	0	0	0	0	0
chr2:32250040:G:A	0	0	0	0	0	0	0	0
chr2:32251321:T:G	3	1	4	2	2	1	1	0
chr2:32597890:G:A	33	11	44	22	22	1	1	0
chr2:33539219:T:C	28	23	51	5	46	2.0	0.0	2.0
chr2:36583443:T:C	228	132	371	105	266	2.0	0.0	2.0
chr2:37013907:G:A	34	18	58	16	42	2.0	0.0	2.0
chr2:38310437:T:C	39	22	63	17	46	2	0	2
chr2:38781807:G:A	169	81	287	103	184	2	1	0
chr2:38960049:T:C	0	0	0	0	0	0	0	0
chr2:42723045:C:T	6	3	10	4	6	2.0	0.5	1.0
chr2:42763196:T:G	17	7	24	10	14	1	1	0
chr2:42770474:G:A	9	7	16	2	14	2	0	2
chr2:43292838:C:T	11	7	19	5	14	2	0	2
chr2:43574573:A:G	8	3	11	5	6	1.0	1.0	0.0
chr2:43577090:T:C	30	13	43	17	26	1.0	1.0	0.0
chr2:43578600:C:T	53	30	85	23	62	2	0	2
chr2:43675372:G:C	0	0	0	0	0	0	0	0
chr2:43675927:A:G	0	0	0	0	0	0	0	0
chr2:43676215:T:C	0	0	0	0	0	0	0	0
chr2:43676344:T:C	0	0	0	0	0	0	0	0
chr2:43794687:T:A	6	5	11	1	10	2.0	0.0	2.0
chr2:43809783:T:C	89	54	145	37	108	2	0	2
chr2:43837951:G:A	0	0	0	0	0	0	0	0
chr2:43839035:T:G	0	0	0	0	0	0	0	0
chr2:43839108:G:C	0	0	0	0	0	0	0	0
chr2:43851714:G:A	0	0	0	0	0	0	0	0
chr2:43896620:G:A	18	5	23	13	10	1.0	1.0	0.0
chr2:43943710:T:C	12	3	18	10	8	1.0	1.0	0.0
chr2:44275649:A:C	3	3	6	0	6	2	0	2
chr2:44320435:G:A	21	7	28	14	14	1	1	0
chr2:44321474:T:C	7	4	11	3	8	2	0	2
chr2:46512018:A:G	16	4	21	13	8	1.0	1.0	0.0
chr2:46581663:A:G	242	128	400	128	272	2.0	0.5	2.0
chr2:46759277:A:G	30	16	51	17	34	2.0	0.0	2.0
chr2:46950478:C:T	258	132	427	145	282	2.0	1.0	2.0
chr2:46993483:G:A	11	5	18	6	12	1	1	0
chr2:47373967:T:C	0	0	0	0	0	0	0	0
chr2:47795976:T:C	127	69	211	65	146	2	0	2
chr2:47798625:C:T	106	53	173	61	112	2.0	1.0	1.0
chr2:48454729:C:G	121	43	175	83	92	1	1	0
chr2:48580657:A:C	6	3	9	3	6	1.5	0.5	1.0
chr2:48580837:T:C	8	4	12	4	8	1.5	0.5	1.0
chr2:48581013:G:C	10	5	15	5	10	1.5	0.5	1.0
chr2:48581455:C:T	4	3	7	1	6	2.0	0.0	2.0
chr2:48582454:G:T	1	1	2	0	2	2	0	2
chr2:48582490:G:T	1	0	1	1	0	1	1	0
chr2:48595401:T:C	0	0	0	0	0	0	0	0
chr2:49973972:A:G	0	0	0	0	0	0	0	0
chr2:50465422:A:G	0	0	0	0	0	0	0	0
chr2:53728713:C:T	100	44	145	57	88	1.0	1.0	0.0
chr2:53787166:A:G	761	391	1296	438	858	2	1	2
chr2:53888767:A:G	34	21	57	13	44	2.0	0.0	2.0
chr2:53892888:A:T	25	19	44	6	38	2	0	2
chr2:53906607:T:C	25	14	41	11	30	2	0	2
chr2:53908292:G:C	17	9	26	8	18	2	0	2
chr2:54255852:C:T	0	0	0	0	0	0	0	0
chr2:54631374:C:T	28	9	38	20	18	1.0	1.0	0.0
chr2:54659210:G:A	61	25	87	37	50	1	1	0
chr2:55209798:G:A	14	10	25	5	20	2.0	0.0	2.0
chr2:55249455:G:A	83	43	132	42	90	2	0	2
chr2:55349498:C:T	17	6	23	11	12	1	1	0
chr2:55355548:A:T	122	69	204	58	146	2.0	0.0	2.0
chr2:55362298:T:A	63	30	100	34	66	1	1	0
chr2:55617309:T:C	1547	856	3019	1011	2008	2	1	2
chr2:61873245:G:T	215	116	353	107	246	2	0	2
chr2:62506054:C:T	9	5	14	4	10	2	0	2
chr2:62506118:C:T	9	5	14	4	10	2	0	2
chr2:62949004:A:C	13	8	22	6	16	2	0	2
chr2:63842175:AAG:AAC	15	0	15	15	0	1	1	0
chr2:64094689:A:G	286	133	468	180	288	2.0	1.0	0.0
chr2:65018231:G:A	16	9	27	7	20	2.0	0.0	2.0
chr2:65313771:C:G	1	1	2	0	2	2	0	2
chr2:65313953:C:A	1	0	1	1	0	1	1	0
chr2:68319242:T:C	1	0	6	6	0	6	6	0
chr2:68319317:G:A	1	0	6	6	0	6	6	0
chr2:68365452:T:C	6	4	10	2	8	2.0	0.0	2.0
chr2:68386578:G:A	82	37	132	54	78	1.0	1.0	0.0
chr2:68395782:G:A	97	38	151	69	82	1	1	0
chr2:68395820:G:C	103	41	160	72	88	1	1	0
chr2:68775149:C:G	654	370	1228	386	842	2.0	1.0	2.0
chr2:68950137:C:A	0	0	0	0	0	0	0	0
chr2:69102986:A:G	0	0	0	0	0	0	0	0
chr2:69431994:A:T	777	423	1355	447	908	2	1	2
chr2:69514477:C:T	0	0	0	0	0	0	0	0
chr2:69806452:C:T	362	181	604	208	396	2.0	1.0	1.0
chr2:69935402:T:G	87	42	138	48	90	1	1	0
chr2:69961544:T:C	5	2	7	3	4	1	1	0
chr2:70150521:G:A	20	15	35	5	30	2.0	0.0	2.0
chr2:70258188:C:T	55	35	94	22	72	2	0	2
chr2:70293714:C:T	1915	1005	3944	1474	2470	2	1	2
chr2:70297445:G:A	362	182	604	212	392	2.0	1.0	2.0
chr2:70301695:G:A	15	7	22	8	14	1	1	0
chr2:70450862:G:A	0	0	0	0	0	0	0	0
chr2:70785472:G:A	0	0	0	0	0	0	0	0
chr2:70831053:C:T	0	0	0	0	0	0	0	0
chr2:70831095:C:T	0	0	0	0	0	0	0	0
chr2:70833805:G:C	0	0	0	0	0	0	0	0
chr2:70833977:G:A	0	0	0	0	0	0	0	0
chr2:70984685:G:A	27	22	49	5	44	2	0	2
chr2:70984859:A:G	38	31	74	8	66	2.0	0.0	2.0
chr2:70984999:A:T	40	33	78	8	70	2.0	0.0	2.0
chr2:70985275:T:C	44	36	86	10	76	2.0	0.0	2.0
chr2:71070565:T:C	713	314	1170	497	673	1	1	0
chr2:71070852:C:T	8	5	14	4	10	2.0	0.0	2.0
chr2:71124273:C:A	230	108	355	131	224	1.5	1.0	0.0
chr2:71124357:G:A	231	125	375	113	262	2	0	2
chr2:71133152:G:A	631	323	1079	369	710	2	1	2
chr2:71178646:C:T	1	1	4	0	4	4	0	4
chr2:71190004:C:T	104	39	151	67	84	1.0	1.0	0.0
chr2:71427045:G:A	112	68	193	49	144	2.0	0.0	2.0
chr2:71427320:A:G	110	63	180	48	132	2.0	0.0	2.0
chr2:71431411:C:T	120	67	193	57	136	2.0	0.0	2.0
chr2:71553085:T:C	0	0	0	0	0	0	0	0
chr2:71568022:A:T	0	0	0	0	0	0	0	0
chr2:71658970:G:A	0	0	0	0	0	0	0	0
chr2:72998961:G:A	21	13	35	9	26	2	0	2
chr2:73089412:A:T	0	0	0	0	0	0	0	0
chr2:73112580:G:A	2	1	3	1	2	1.5	0.5	1.0
chr2:73263284:A:G	2	1	3	1	2	1.5	0.5	1.0
chr2:73902537:A:G	0	0	0	0	0	0	0	0
chr2:74414497:G:C	55	24	82	32	50	1	1	0
chr2:74455385:C:T	52	7	60	46	14	1.0	1.0	0.0
chr2:74460423:T:C	538	253	851	343	508	1.0	1.0	0.0
chr2:74460654:G:A	656	365	1151	339	812	2.0	0.0	2.0
chr2:74462912:G:A	24	8	32	16	16	1.0	1.0	0.0
chr2:74463251:C:T	52	21	73	31	42	1.0	1.0	0.0
chr2:74472651:C:A	1157	557	2129	827	1302	2	1	0
chr2:74483364:C:T	188	96	303	99	204	2.0	1.0	2.0
chr2:74492783:G:T	1	0	1	1	0	1	1	0
chr2:74498051:G:A	27	9	37	19	18	1	1	0
chr2:74505288:T:G	16	4	20	12	8	1.0	1.0	0.0
chr2:74519195:A:T	0	0	0	0	0	0	0	0
chr2:74529049:G:C	129	75	211	57	154	2	0	2
chr2:74531807:G:A	4	3	7	1	6	2.0	0.0	2.0
chr2:74673461:G:T	10	6	16	4	12	2.0	0.0	2.0
chr2:74886530:C:T	1	1	2	0	2	2	0	2
chr2:74886662:C:G	0	0	0	0	0	0	0	0
chr2:74887981:A:G	0	0	0	0	0	0	0	0
chr2:74959210:A:G	19	8	27	11	16	1	1	0
chr2:75198602:A:G	1	1	2	0	2	2	0	2
chr2:75647264:G:C	15	9	24	6	18	2	0	2
chr2:75687909:C:T	14	10	24	4	20	2.0	0.0	2.0
chr2:79026020:T:C	0	0	0	0	0	0	0	0
chr2:79026024:A:G	0	0	0	0	0	0	0	0
chr2:79026249:C:T	0	0	0	0	0	0	0	0
chr2:79026691:TC:TG	0	0	0	0	0	0	0	0
chr2:80574221:T:C	0	0	0	0	0	0	0	0
chr2:84653571:G:A	0	0	0	0	0	0	0	0
chr2:84699632:G:A	0	0	0	0	0	0	0	0
chr2:85306547:C:T	1	0	1	1	0	1	1	0
chr2:85326661:C:T	913	446	1555	587	968	2	1	0
chr2:85326957:G:A	1079	535	1883	695	1188	2	1	0
chr2:85553008:G:A	20	8	28	12	16	1.0	1.0	0.0
chr2:85553413:C:T	16	6	22	10	12	1.0	1.0	0.0
chr2:85579143:C:T	2424	1656	6940	2121	4819	2.0	1.0	2.0
chr2:85581614:A:G	2465	1696	7143	2167	4976	2	1	2
chr2:85581748:C:T	2441	1659	7002	2143	4859	2	1	2
chr2:85616308:C:T	279	137	439	153	286	2	1	0
chr2:85754718:T:G	0	0	0	0	0	0	0	0
chr2:86158605:C:T	166	80	261	91	170	1.0	1.0	0.0
chr2:86815702:T:C	1	1	2	0	2	2	0	2
chr2:88124547:T:C	0	0	0	0	0	0	0	0
chr2:88173272:G:A	1	1	2	0	2	2	0	2
chr2:95090402:C:T	231	113	358	124	234	1	1	0
chr2:96114968:T:G	0	0	0	0	0	0	0	0
chr2:96124048:T:C	0	0	0	0	0	0	0	0
chr2:96129869:T:G	3	3	8	0	8	2	0	2
chr2:96129975:G:A	2	2	6	0	6	3.0	0.0	3.0
chr2:96193176:A:G	39	20	58	19	39	1	0	1
chr2:96193296:A:G	179	90	279	95	184	2	1	2
chr2:96195421:C:G	446	203	707	275	432	1.0	1.0	0.0
chr2:96253904:C:T	75	41	118	36	82	2	0	2
chr2:96267639:C:T	369	172	570	212	358	1	1	0
chr2:96274951:A:G	320	155	502	180	322	2.0	1.0	0.0
chr2:96277735:T:C	16	7	22	9	13	1.0	1.0	0.0
chr2:96278815:G:A	88	37	128	54	74	1.0	1.0	0.0
chr2:96287095:A:G	65	29	94	36	58	1	1	0
chr2:96328019:C:T	14	3	17	11	6	1.0	1.0	0.0
chr2:96328146:A:G	18	3	21	15	6	1.0	1.0	0.0
chr2:96354311:T:C	5	1	6	4	2	1	1	0
chr2:96601907:G:A	1	0	1	1	0	1	1	0
chr2:96604271:A:C	9	6	15	3	12	2	0	2
chr2:96686103:A:G	0	0	0	0	0	0	0	0
chr2:96734587:A:G	0	0	0	0	0	0	0	0
chr2:97194750:T:C	68	46	120	24	96	2.0	0.0	2.0
chr2:97738048:G:A	241	105	361	145	216	1	1	0
chr2:97739527:G:A	345	154	528	206	322	1	1	0
chr2:97792583:G:A	70	34	109	37	72	1.5	1.0	0.0
chr2:99195607:G:A	113	65	193	57	136	2	0	2
chr2:99376359:A:C	140	65	224	85	139	2.0	1.0	0.0
chr2:99406310:T:C	35	20	56	16	40	2	0	2
chr2:99439044:A:G	288	173	490	128	362	2.0	0.0	2.0
chr2:99442408:C:T	324	193	555	147	408	2.0	0.0	2.0
chr2:99593612:G:C	122	56	185	73	112	1.0	1.0	0.0
chr2:99594180:T:C	69	30	105	43	62	1	1	0
chr2:99601618:G:A	89	54	146	38	108	2	0	2
chr2:100299853:A:G	0	0	0	0	0	0	0	0
chr2:100300647:C:T	0	0	0	0	0	0	0	0
chr2:100393620:G:C	8	1	10	8	2	1.0	1.0	0.0
chr2:100964113:G:A	0	0	0	0	0	0	0	0
chr2:100970993:C:T	0	0	0	0	0	0	0	0
chr2:100977729:C:T	0	0	0	0	0	0	0	0
chr2:100995589:G:A	2	2	4	0	4	2.0	0.0	2.0
chr2:101008009:T:C	22	9	31	13	18	1.0	1.0	0.0
chr2:101011390:C:T	11	3	17	9	8	1	1	0
chr2:101022426:A:G	1	0	1	1	0	1	1	0
chr2:101029682:G:A	7	4	11	3	8	2	0	2
chr2:101040264:T:C	1	0	1	1	0	1	1	0
chr2:101402446:A:G	0	0	0	0	0	0	0	0
chr2:102009686:C:A	0	0	0	0	0	0	0	0
chr2:102016120:T:A	0	0	0	0	0	0	0	0
chr2:102024739:A:G	0	0	0	0	0	0	0	0
chr2:106491111:G:C	0	0	0	0	0	0	0	0
chr2:107827055:C:G	0	0	0	0	0	0	0	0
chr2:107890812:T:C	0	0	0	0	0	0	0	0
chr2:108489925:A:G	45	28	75	17	58	2	0	2
chr2:108731491:T:G	74	46	122	30	92	2.0	0.0	2.0
chr2:108758496:A:G	40	14	54	26	28	1.0	1.0	0.0
chr2:109545495:C:T	21	10	35	11	24	1	1	0
chr2:111929411:G:A	1	0	1	1	0	1	1	0
chr2:112722037:G:A	0	0	0	0	0	0	0	0
chr2:112722389:C:T	0	0	0	0	0	0	0	0
chr2:112740989:A:G	0	0	0	0	0	0	0	0
chr2:112831216:C:T	0	0	0	0	0	0	0	0
chr2:112832813:G:A	1	1	4	0	4	4	0	4
chr2:113074368:T:C	0	0	0	0	0	0	0	0
chr2:113074735:T:C	0	0	0	0	0	0	0	0
chr2:113129758:T:G	0	0	0	0	0	0	0	0
chr2:113183104:T:C	33	24	57	9	48	2	0	2
chr2:113183262:G:C	37	25	62	12	50	2	0	2
chr2:113185893:A:G	22	12	34	10	24	2.0	0.0	2.0
chr2:115753241:G:C	0	0	0	0	0	0	0	0
chr2:117817639:C:G	1560	884	3169	1049	2120	2.0	1.0	2.0
chr2:117826364:C:T	257	133	409	131	278	2	0	2
chr2:117936817:C:G	10	8	18	2	16	2.0	0.0	2.0
chr2:117995521:C:T	1	0	1	1	0	1	1	0
chr2:119230989:G:A	0	0	0	0	0	0	0	0
chr2:119367453:A:G	217	76	393	203	190	1	1	0
chr2:119368360:T:C	13	9	25	5	20	2	0	2
chr2:119440094:G:A	0	0	0	0	0	0	0	0
chr2:119441564:A:G	0	0	0	0	0	0	0	0
chr2:119601228:G:A	0	0	0	0	0	0	0	0
chr2:119656507:C:T	0	0	0	0	0	0	0	0
chr2:120989968:A:G	0	0	0	0	0	0	0	0
chr2:120990472:G:A	0	0	0	0	0	0	0	0
chr2:121224374:A:G	0	0	0	0	0	0	0	0
chr2:126899088:A:G	0	0	0	0	0	0	0	0
chr2:126899632:C:T	0	0	0	0	0	0	0	0
chr2:126899645:C:T	0	0	0	0	0	0	0	0
chr2:127195478:A:C	0	0	0	0	0	0	0	0
chr2:127199415:G:A	0	0	0	0	0	0	0	0
chr2:127292558:T:C	5	3	8	2	6	2	0	2
chr2:127419801:C:T	0	0	0	0	0	0	0	0
chr2:127564195:G:A	0	0	0	0	0	0	0	0
chr2:127609517:G:A	0	0	0	0	0	0	0	0
chr2:127620258:C:G	5	0	5	5	0	1	1	0
chr2:127631215:G:A	0	0	0	0	0	0	0	0
chr2:127631287:G:C	0	0	0	0	0	0	0	0
chr2:127634316:G:T	3	1	5	3	2	2	1	0
chr2:127635686:T:C	3	1	4	2	2	1	1	0
chr2:127635714:T:C	3	1	4	2	2	1	1	0
chr2:127636225:T:C	25	11	45	19	26	2	1	0
chr2:127637380:A:G	31	13	52	22	30	2	1	0
chr2:127639232:A:G	122	46	180	85	95	1.0	1.0	0.0
chr2:127643033:C:T	0	0	0	0	0	0	0	0
chr2:127673823:A:G	1	0	1	1	0	1	1	0
chr2:130074719:T:A	0	0	0	0	0	0	0	0
chr2:130139661:C:T	0	0	0	0	0	0	0	0
chr2:130167515:C:T	60	32	92	28	64	2.0	0.0	2.0
chr2:130181590:G:T	352	159	546	212	334	1.0	1.0	0.0
chr2:130182517:G:T	200	104	317	105	212	2.0	1.0	2.0
chr2:130191918:G:A	7	4	11	3	8	2	0	2
chr2:130194008:AGCT:GGCC	0	0	0	0	0	0	0	0
chr2:130195145:G:A	2	1	3	1	2	1.5	0.5	1.0
chr2:130195152:C:T	2	1	3	1	2	1.5	0.5	1.0
chr2:130230219:G:A	0	0	0	0	0	0	0	0
chr2:130342923:G:A	601	272	955	379	576	1	1	0
chr2:130359547:G:A	0	0	0	0	0	0	0	0
chr2:130508957:C:A	0	0	0	0	0	0	0	0
chr2:130762605:C:G	0	0	0	0	0	0	0	0
chr2:131263831:C:T	0	0	0	0	0	0	0	0
chr2:131424299:C:T	0	0	0	0	0	0	0	0
chr2:131443715:A:G	0	0	0	0	0	0	0	0
chr2:131480410:A:G	1	1	2	0	2	2	0	2
chr2:131490806:T:G	7	7	14	0	14	2	0	2
chr2:131516901:G:A	5	4	9	1	8	2	0	2
chr2:131517823:T:C	4	3	7	1	6	2.0	0.0	2.0
chr2:131518681:A:G	8	4	12	4	8	1.5	0.5	1.0
chr2:131519077:G:C	8	4	12	4	8	1.5	0.5	1.0
chr2:131520113:C:T	12	5	17	7	10	1.0	1.0	0.0
chr2:131530789:T:C	1	1	2	0	2	2	0	2
chr2:131723413:C:T	1	0	1	1	0	1	1	0
chr2:131723579:AT:TC	1	1	2	0	2	2	0	2
chr2:132318236:G:A	0	0	0	0	0	0	0	0
chr2:132732028:A:G	0	0	0	0	0	0	0	0
chr2:132781993:G:A	0	0	0	0	0	0	0	0
chr2:132783534:T:A	0	0	0	0	0	0	0	0
chr2:132783881:A:G	0	0	0	0	0	0	0	0
chr2:132784441:T:C	0	0	0	0	0	0	0	0
chr2:132785001:C:T	0	0	0	0	0	0	0	0
chr2:134456688:G:A	2	1	3	1	2	1.5	0.5	1.0
chr2:134953946:C:T	89	41	136	52	84	1	1	0
chr2:134954087:G:A	34	13	47	21	26	1.0	1.0	0.0
chr2:134987822:G:A	0	0	0	0	0	0	0	0
chr2:134987975:C:T	0	0	0	0	0	0	0	0
chr2:134988152:A:G	0	0	0	0	0	0	0	0
chr2:135135802:A:G	66	32	102	36	66	2.0	1.0	0.0
chr2:135153852:T:C	45	26	72	20	52	2	0	2
chr2:135636088:A:G	117	55	121	65	56	1	1	0
chr2:135788274:C:G	5	0	6	6	0	1	1	0
chr2:135788540:A:G	5	0	6	6	0	1	1	0
chr2:135794618:G:A	0	0	0	0	0	0	0	0
chr2:135798089:T:C	0	0	0	0	0	0	0	0
chr2:135803987:G:A	0	0	0	0	0	0	0	0
chr2:135817629:G:T	0	0	0	0	0	0	0	0
chr2:135833176:C:T	0	0	0	0	0	0	0	0
chr2:135836588:G:A	1	0	1	1	0	1	1	0
chr2:135876392:G:A	58	28	89	33	56	2.0	1.0	0.0
chr2:136115979:A:T	82	38	125	45	80	1.0	1.0	0.0
chr2:140950299:G:T	0	0	0	0	0	0	0	0
chr2:144141992:C:A	21	9	30	12	18	1	1	0
chr2:149214642:T:C	0	0	0	0	0	0	0	0
chr2:151455056:G:A	77	50	129	27	102	2	0	2
chr2:151463604:G:A	145	80	234	68	166	2	0	2
chr2:151465581:A:T	36	16	54	20	34	1.0	1.0	0.0
chr2:151485923:C:T	6	1	7	5	2	1.0	1.0	0.0
chr2:151490465:T:C	3	3	6	0	6	2	0	2
chr2:151492512:G:A	1	0	1	1	0	1	1	0
chr2:151527007:C:T	3	1	4	2	2	1	1	0
chr2:151546364:C:T	3	2	5	1	4	2	0	2
chr2:151619514:C:G	0	0	0	0	0	0	0	0
chr2:151633705:A:G	2	0	2	2	0	1.0	1.0	0.0
chr2:151640012:A:G	3	0	3	3	0	1	1	0
chr2:151640574:G:A	2	0	2	2	0	1.0	1.0	0.0
chr2:151643935:C:G	1	1	2	0	2	2	0	2
chr2:151659071:C:T	2	1	3	1	2	1.5	0.5	1.0
chr2:151663744:C:T	0	0	0	0	0	0	0	0
chr2:151664582:C:T	0	0	0	0	0	0	0	0
chr2:151671058:C:T	0	0	0	0	0	0	0	0
chr2:151671094:C:T	0	0	0	0	0	0	0	0
chr2:151671122:C:G	0	0	0	0	0	0	0	0
chr2:151674563:A:G	0	0	0	0	0	0	0	0
chr2:151679785:T:C	1	1	2	0	2	2	0	2
chr2:151717467:A:G	7	3	10	4	6	1	1	0
chr2:151860817:A:T	0	0	0	0	0	0	0	0
chr2:154854845:T:C	0	0	0	0	0	0	0	0
chr2:157587377:G:A	0	0	0	0	0	0	0	0
chr2:157780398:G:A	11	8	19	3	16	2	0	2
chr2:158338713:T:G	0	0	0	0	0	0	0	0
chr2:158533250:C:T	0	0	0	0	0	0	0	0
chr2:158662856:G:A	0	0	0	0	0	0	0	0
chr2:158807087:T:C	0	0	0	0	0	0	0	0
chr2:159097663:C:T	0	0	0	0	0	0	0	0
chr2:159178684:C:T	0	0	0	0	0	0	0	0
chr2:159225843:C:T	0	0	0	0	0	0	0	0
chr2:159227752:A:G	0	0	0	0	0	0	0	0
chr2:159228023:A:G	0	0	0	0	0	0	0	0
chr2:159231024:T:G	0	0	0	0	0	0	0	0
chr2:159256370:G:T	201	70	282	136	146	1	1	0
chr2:159438331:A:G	29	21	52	8	44	2	0	2
chr2:159453735:A:G	99	88	202	12	190	2	0	2
chr2:159747941:C:T	198	103	309	99	210	2.0	0.0	2.0
chr2:159748425:G:A	157	79	238	80	158	2	1	2
chr2:159817015:A:G	35	23	58	12	46	2	0	2
chr2:159819839:T:C	38	15	53	23	30	1.0	1.0	0.0
chr2:159854411:T:C	26	18	45	9	36	2.0	0.0	2.0
chr2:159854534:G:C	22	7	31	15	16	1.0	1.0	0.0
chr2:159882166:G:A	162	62	237	112	125	1.0	1.0	0.0
chr2:160045006:A:G	0	0	0	0	0	0	0	0
chr2:161408759:A:G	3	1	4	2	2	1	1	0
chr2:161501281:A:G	0	0	0	0	0	0	0	0
chr2:162073469:A:G	13	6	20	8	12	1	1	0
chr2:162267541:C:T	81	43	128	39	89	2	0	2
chr2:164722071:A:G	4	2	6	2	4	1.5	0.5	1.0
chr2:165295879:G:A	2	1	3	1	2	1.5	0.5	1.0
chr2:165679408:C:T	0	0	0	0	0	0	0	0
chr2:165749816:C:T	9	0	9	9	0	1	1	0
chr2:165917461:G:A	37	20	57	17	40	2	0	2
chr2:165941136:C:T	136	67	213	73	140	1.5	1.0	0.0
chr2:166041354:A:G	0	0	0	0	0	0	0	0
chr2:166046935:T:C	0	0	0	0	0	0	0	0
chr2:166199827:C:A	0	0	0	0	0	0	0	0
chr2:166288632:A:G	1	1	2	0	2	2	0	2
chr2:167135972:G:A	0	0	0	0	0	0	0	0
chr2:167247440:T:C	0	0	0	0	0	0	0	0
chr2:168850918:C:T	0	0	0	0	0	0	0	0
chr2:168850996:T:C	0	0	0	0	0	0	0	0
chr2:168864867:G:A	0	0	0	0	0	0	0	0
chr2:168932506:T:C	0	0	0	0	0	0	0	0
chr2:168973818:A:G	0	0	0	0	0	0	0	0
chr2:169095663:G:C	3	2	5	1	4	2	0	2
chr2:169168573:A:G	0	0	0	0	0	0	0	0
chr2:169176479:C:T	0	0	0	0	0	0	0	0
chr2:169196995:C:T	0	0	0	0	0	0	0	0
chr2:169242963:T:C	0	0	0	0	0	0	0	0
chr2:169246826:T:C	0	0	0	0	0	0	0	0
chr2:169246841:G:T	0	0	0	0	0	0	0	0
chr2:169259078:T:C	0	0	0	0	0	0	0	0
chr2:169479514:G:C	27	12	39	15	24	1	1	0
chr2:169504905:A:G	1	1	2	0	2	2	0	2
chr2:169504916:T:C	1	1	2	0	2	2	0	2
chr2:169694329:A:G	133	59	203	81	122	1	1	0
chr2:169736199:A:G	2	2	4	0	4	2.0	0.0	2.0
chr2:170217377:G:A	19	19	38	0	38	2	0	2
chr2:170369331:A:G	7	0	7	7	0	1	1	0
chr2:170386251:G:A	1	0	1	1	0	1	1	0
chr2:170404287:A:G	1	1	2	0	2	2	0	2
chr2:170822115:T:C	1	1	2	0	2	2	0	2
chr2:171517568:C:G	24	0	24	24	0	1.0	1.0	0.0
chr2:171517610:G:A	2	2	4	0	4	2.0	0.0	2.0
chr2:171522379:CCAAG:GCAAA	4	2	6	2	4	1.5	0.5	1.0
chr2:171554763:G:A	31	9	43	23	20	1	1	0
chr2:172101522:T:C	0	0	0	0	0	0	0	0
chr2:172102574:C:T	0	0	0	0	0	0	0	0
chr2:172821935:G:T	0	0	0	0	0	0	0	0
chr2:172967206:C:T	0	0	0	0	0	0	0	0
chr2:173209647:T:C	0	0	0	0	0	0	0	0
chr2:174335141:G:T	0	0	0	0	0	0	0	0
chr2:174336175:G:C	0	0	0	0	0	0	0	0
chr2:174336571:C:G	0	0	0	0	0	0	0	0
chr2:174812294:C:T	0	0	0	0	0	0	0	0
chr2:174847214:C:T	5	4	9	1	8	2	0	2
chr2:175181439:C:A	2587	1772	7924	2440	5484	2	1	2
chr2:176100176:G:A	0	0	0	0	0	0	0	0
chr2:176152000:T:C	0	0	0	0	0	0	0	0
chr2:176169051:C:T	0	0	0	0	0	0	0	0
chr2:176169393:G:T	0	0	0	0	0	0	0	0
chr2:176190041:G:A	0	0	0	0	0	0	0	0
chr2:177617832:C:T	21	11	32	10	22	2	0	2
chr2:177617970:A:G	21	11	32	10	22	2	0	2
chr2:178104312:G:A	0	0	0	0	0	0	0	0
chr2:178530340:C:G	13	7	20	6	14	2	0	2
chr2:178567458:A:G	10	3	13	7	6	1.0	1.0	0.0
chr2:178575302:G:A	11	6	17	5	12	2	0	2
chr2:178597767:A:G	41	18	59	23	36	1	1	0
chr2:178632406:C:T	47	21	71	27	44	1	1	0
chr2:178714003:G:A	21	11	34	10	24	2	0	2
chr2:178714366:T:C	23	16	45	7	38	2	0	2
chr2:178714485:T:C	19	14	39	5	34	2	0	2
chr2:178715095:T:A	15	13	34	2	32	2	0	2
chr2:178717600:C:T	21	10	31	11	20	1	1	0
chr2:178717810:G:T	19	9	28	10	18	1	1	0
chr2:178718769:T:G	18	8	28	10	18	1.0	1.0	0.0
chr2:178722403:C:G	20	7	31	15	16	1.0	1.0	0.0
chr2:178729499:C:T	18	7	26	12	14	1.0	1.0	0.0
chr2:178733501:A:G	11	5	16	6	10	1	1	0
chr2:178740453:C:T	2	1	3	1	2	1.5	0.5	1.0
chr2:178905448:C:A	217	95	329	129	200	1	1	0
chr2:178918743:C:T	213	90	320	131	189	1	1	0
chr2:181656850:C:T	0	0	0	0	0	0	0	0
chr2:184937020:G:A	0	0	0	0	0	0	0	0
chr2:184937516:C:A	1	0	1	1	0	1	1	0
chr2:184938637:C:G	1	1	2	0	2	2	0	2
chr2:185763216:T:C	4	3	7	1	6	2.0	0.0	2.0
chr2:185764622:G:A	8	6	14	2	12	2.0	0.0	2.0
chr2:185788819:G:A	9	5	14	4	10	2	0	2
chr2:185789865:A:G	2	0	2	2	0	1.0	1.0	0.0
chr2:185792229:T:C	0	0	0	0	0	0	0	0
chr2:185792362:C:A	0	0	0	0	0	0	0	0
chr2:185793329:G:A	1	1	2	0	2	2	0	2
chr2:185793711:C:T	0	0	0	0	0	0	0	0
chr2:185793838:G:T	0	0	0	0	0	0	0	0
chr2:185794632:G:T	1	1	2	0	2	2	0	2
chr2:185796946:A:G	2	1	3	1	2	1.5	0.5	1.0
chr2:185800236:C:A	3	1	4	2	2	1	1	0
chr2:185800705:G:A	2	2	4	0	4	2.0	0.0	2.0
chr2:185802394:T:C	2	1	3	1	2	1.5	0.5	1.0
chr2:185802633:A:C	0	0	0	0	0	0	0	0
chr2:185806053:T:A	0	0	0	0	0	0	0	0
chr2:185806630:G:A	0	0	0	0	0	0	0	0
chr2:185807185:G:A	0	0	0	0	0	0	0	0
chr2:186694233:G:A	0	0	0	0	0	0	0	0
chr2:186762610:G:A	0	0	0	0	0	0	0	0
chr2:187478770:T:C	0	0	0	0	0	0	0	0
chr2:189034121:G:A	2	1	3	1	2	1.5	0.5	1.0
chr2:189066418:A:G	1	0	1	1	0	1	1	0
chr2:189451899:T:C	22	13	35	9	26	2.0	0.0	2.0
chr2:189458804:A:G	39	20	59	19	40	2	0	2
chr2:189463835:C:T	2	0	3	3	0	1.5	1.5	0.0
chr2:189465147:A:G	19	10	29	9	20	2	0	2
chr2:189565451:A:G	0	0	0	0	0	0	0	0
chr2:189661479:C:T	428	243	728	204	524	2.0	0.0	2.0
chr2:189661498:C:T	518	306	894	235	659	2.0	0.0	2.0
chr2:190200027:C:T	251	130	428	142	286	2	1	2
chr2:190296896:T:C	848	614	1676	306	1370	2.0	0.0	2.0
chr2:190319749:A:G	904	662	1815	322	1493	2.0	0.0	2.0
chr2:190360255:G:T	162	59	237	113	124	1.0	1.0	0.0
chr2:190371175:A:C	60	16	77	45	32	1.0	1.0	0.0
chr2:190436642:A:G	52	27	84	26	58	2.0	0.0	2.0
chr2:190881507:T:G	608	322	1107	363	744	2.0	1.0	2.0
chr2:191836667:A:G	0	0	0	0	0	0	0	0
chr2:191836681:G:C	0	0	0	0	0	0	0	0
chr2:191846716:G:A	0	0	0	0	0	0	0	0
chr2:195957300:C:T	0	0	0	0	0	0	0	0
chr2:196001696:C:T	0	0	0	0	0	0	0	0
chr2:196156552:T:C	414	248	728	205	523	2.0	0.0	2.0
chr2:197408623:T:C	10	4	14	6	8	1.0	1.0	0.0
chr2:197498780:A:G	929	502	1819	617	1202	2	1	2
chr2:197501064:C:T	451	225	774	288	486	2	1	0
chr2:198085305:A:G	0	0	0	0	0	0	0	0
chr2:198085516:G:A	0	0	0	0	0	0	0	0
chr2:199943732:A:G	22	9	32	14	18	1.0	1.0	0.0
chr2:200389326:G:C	13	4	17	9	8	1	1	0
chr2:200490383:G:A	14	3	17	11	6	1.0	1.0	0.0
chr2:201160898:A:G	243	110	384	146	238	1	1	0
chr2:201185954:A:G	7	4	11	3	8	2	0	2
chr2:201217736:T:A	0	0	0	0	0	0	0	0
chr2:201380700:A:T	86	41	131	47	84	1.0	1.0	0.0
chr2:201477679:G:T	7	3	10	4	6	1	1	0
chr2:201565861:G:A	1	1	2	0	2	2	0	2
chr2:201626089:C:A	14	5	19	9	10	1.0	1.0	0.0
chr2:201693964:C:T	0	0	0	0	0	0	0	0
chr2:201733390:C:T	5	0	5	5	0	1	1	0
chr2:201760892:C:T	14	6	20	8	12	1.0	1.0	0.0
chr2:201806658:C:G	0	0	0	0	0	0	0	0
chr2:202188224:G:A	0	0	0	0	0	0	0	0
chr2:202201563:G:T	0	0	0	0	0	0	0	0
chr2:202291213:A:C	1103	606	2043	649	1394	2	1	2
chr2:202556476:G:A	176	86	273	93	180	1.0	1.0	0.0
chr2:205104496:G:A	0	0	0	0	0	0	0	0
chr2:205121597:A:G	0	0	0	0	0	0	0	0
chr2:206144039:C:A	34	20	57	17	40	2.0	0.0	2.0
chr2:206160720:T:C	232	132	384	108	276	2.0	0.0	2.0
chr2:206176329:T:C	0	0	0	0	0	0	0	0
chr2:206305007:G:A	18	18	36	0	36	2.0	0.0	2.0
chr2:206307903:A:G	8	8	16	0	16	2.0	0.0	2.0
chr2:206309592:T:C	22	22	48	0	48	2.0	0.0	2.0
chr2:206704991:T:C	0	0	0	0	0	0	0	0
chr2:206755055:A:G	0	0	0	0	0	0	0	0
chr2:206765369:C:A	1	1	2	0	2	2	0	2
chr2:206766737:G:A	337	172	540	178	362	2	1	2
chr2:206969259:A:G	0	0	0	0	0	0	0	0
chr2:208112411:A:G	0	0	0	0	0	0	0	0
chr2:208124313:A:G	2	2	6	0	6	3.0	0.0	3.0
chr2:208142835:T:G	0	0	0	0	0	0	0	0
chr2:208145834:A:G	0	0	0	0	0	0	0	0
chr2:209145504:C:G	0	0	0	0	0	0	0	0
chr2:209145517:G:C	0	0	0	0	0	0	0	0
chr2:209696115:G:A	13	6	20	8	12	2	1	0
chr2:210195326:T:G	0	0	0	0	0	0	0	0
chr2:211387139:T:C	0	0	0	0	0	0	0	0
chr2:213317376:A:T	99	38	138	62	76	1	1	0
chr2:213930019:A:C	0	0	0	0	0	0	0	0
chr2:214780740:C:G	29	10	41	19	22	1	1	0
chr2:214809599:C:G	381	200	635	207	428	2	1	2
chr2:214948607:C:T	0	0	0	0	0	0	0	0
chr2:215000851:T:C	0	0	0	0	0	0	0	0
chr2:215037050:C:T	0	0	0	0	0	0	0	0
chr2:215364969:A:G	1	1	2	0	2	2	0	2
chr2:215367833:C:T	5	2	7	3	4	1	1	0
chr2:215391892:T:C	1	1	2	0	2	2	0	2
chr2:215404486:T:G	0	0	0	0	0	0	0	0
chr2:215404531:T:G	0	0	0	0	0	0	0	0
chr2:215433361:G:A	0	0	0	0	0	0	0	0
chr2:216039296:A:T	1	1	2	0	2	2	0	2
chr2:216043956:C:T	2	1	3	1	2	1.5	0.5	1.0
chr2:216065303:G:A	0	0	0	0	0	0	0	0
chr2:216283694:C:A	0	0	0	0	0	0	0	0
chr2:216451064:T:C	31	18	51	13	38	2	0	2
chr2:217880962:G:A	0	0	0	0	0	0	0	0
chr2:218060426:G:A	0	0	0	0	0	0	0	0
chr2:218075536:C:T	0	0	0	0	0	0	0	0
chr2:218387907:C:T	0	0	0	0	0	0	0	0
chr2:219172835:G:A	387	208	657	211	446	2	1	2
chr2:219420057:C:T	0	0	0	0	0	0	0	0
chr2:219420587:C:T	0	0	0	0	0	0	0	0
chr2:219420944:G:C	0	0	0	0	0	0	0	0
chr2:219421420:G:A	0	0	0	0	0	0	0	0
chr2:219552220:G:C	0	0	0	0	0	0	0	0
chr2:219552245:C:T	0	0	0	0	0	0	0	0
chr2:219556695:C:G	0	0	0	0	0	0	0	0
chr2:219556757:A:G	0	0	0	0	0	0	0	0
chr2:219558052:A:G	0	0	0	0	0	0	0	0
chr2:219608633:G:A	5	1	6	4	2	1	1	0
chr2:221437192:C:T	0	0	0	0	0	0	0	0
chr2:222694370:T:C	1	1	2	0	2	2	0	2
chr2:223598446:G:A	0	0	0	0	0	0	0	0
chr2:224001670:G:A	1	1	2	0	2	2	0	2
chr2:224001859:C:A	1	1	2	0	2	2	0	2
chr2:224481929:T:C	113	56	179	61	118	2	1	0
chr2:224497761:C:T	93	47	142	46	96	2	0	2
chr2:224765718:C:T	90	56	155	37	118	2.0	0.0	2.0
chr2:224946864:T:A	1166	804	2446	502	1944	2.0	0.0	2.0
chr2:226796060:C:G	19	7	27	13	14	1	1	0
chr2:227248459:A:G	0	0	0	0	0	0	0	0
chr2:227270915:C:T	0	0	0	0	0	0	0	0
chr2:227871625:C:G	0	0	0	0	0	0	0	0
chr2:227893838:A:T	0	0	0	0	0	0	0	0
chr2:227991150:G:C	0	0	0	0	0	0	0	0
chr2:228018313:A:C	0	0	0	0	0	0	0	0
chr2:228018713:A:G	0	0	0	0	0	0	0	0
chr2:228019005:T:C	0	0	0	0	0	0	0	0
chr2:229804142:T:C	32	15	51	19	32	1.5	1.0	0.0
chr2:229859061:G:C	249	123	392	134	258	2	1	0
chr2:229976358:C:T	5	0	5	5	0	1	1	0
chr2:230170859:A:G	15	10	31	5	26	2	0	2
chr2:230171595:T:C	17	7	24	10	14	1	1	0
chr2:230172052:T:C	6	3	9	3	6	1.5	0.5	1.0
chr2:230172150:G:A	144	68	226	82	144	1.0	1.0	0.0
chr2:230172765:T:G	26	13	39	13	26	1.5	0.5	1.0
chr2:230177560:A:G	644	341	1159	379	780	2.0	1.0	2.0
chr2:230185999:A:G	1057	424	1828	890	938	2	1	0
chr2:230212961:G:A	2523	1484	6379	2407	3972	2	1	2
chr2:230213010:A:G	2505	1465	6278	2369	3909	2	1	2
chr2:230284393:G:A	179	96	293	91	202	2	0	2
chr2:230388719:T:G	95	36	137	63	74	1	1	0
chr2:230878149:G:A	325	118	480	230	250	1	1	0
chr2:230910129:G:A	11	1	12	10	2	1	1	0
chr2:230910429:G:A	8	1	9	7	2	1.0	1.0	0.0
chr2:230996123:C:T	0	0	0	0	0	0	0	0
chr2:231593146:T:C	0	0	0	0	0	0	0	0
chr2:232087576:A:G	191	105	299	88	211	2	0	2
chr2:232334536:G:A	5	3	8	2	6	2	0	2
chr2:232343267:C:G	10	5	17	5	12	1.5	0.5	1.0
chr2:232379271:A:T	0	0	0	0	0	0	0	0
chr2:232380431:T:C	0	0	0	0	0	0	0	0
chr2:232408301:C:G	0	0	0	0	0	0	0	0
chr2:232408308:G:A	0	0	0	0	0	0	0	0
chr2:232408534:C:A	0	0	0	0	0	0	0	0
chr2:232409766:G:C	0	0	0	0	0	0	0	0
chr2:232409799:C:G	0	0	0	0	0	0	0	0
chr2:232525489:C:G	0	0	0	0	0	0	0	0
chr2:232875517:A:G	0	0	0	0	0	0	0	0
chr2:232875681:A:G	0	0	0	0	0	0	0	0
chr2:232885408:G:A	1	0	1	1	0	1	1	0
chr2:232920305:G:A	0	0	0	0	0	0	0	0
chr2:233034416:C:A	0	0	0	0	0	0	0	0
chr2:233060456:G:A	1029	538	1857	637	1220	2	1	2
chr2:233125884:A:G	770	418	1325	424	901	2.0	1.0	2.0
chr2:233274722:A:G	15	11	26	4	22	2	0	2
chr2:233318877:A:G	1	1	2	0	2	2	0	2
chr2:233618225:C:G	0	0	0	0	0	0	0	0
chr2:233672032:T:C	0	0	0	0	0	0	0	0
chr2:233681970:C:A	0	0	0	0	0	0	0	0
chr2:233682559:T:C	0	0	0	0	0	0	0	0
chr2:233682693:G:A	0	0	0	0	0	0	0	0
chr2:233693023:T:G	0	0	0	0	0	0	0	0
chr2:233713134:T:C	0	0	0	0	0	0	0	0
chr2:233713141:C:G	0	0	0	0	0	0	0	0
chr2:233713179:T:C	0	0	0	0	0	0	0	0
chr2:233718890:C:A	0	0	0	0	0	0	0	0
chr2:233729157:T:C	0	0	0	0	0	0	0	0
chr2:233729207:G:A	0	0	0	0	0	0	0	0
chr2:233729266:T:C	0	0	0	0	0	0	0	0
chr2:233729360:A:G	0	0	0	0	0	0	0	0
chr2:233729603:A:G	0	0	0	0	0	0	0	0
chr2:233793813:T:C	0	0	0	0	0	0	0	0
chr2:233794490:T:C	0	0	0	0	0	0	0	0
chr2:233795672:A:G	0	0	0	0	0	0	0	0
chr2:233802185:G:C	0	0	0	0	0	0	0	0
chr2:233802362:G:T	0	0	0	0	0	0	0	0
chr2:233805060:T:C	0	0	0	0	0	0	0	0
chr2:233807780:G:A	0	0	0	0	0	0	0	0
chr2:233816856:T:C	0	0	0	0	0	0	0	0
chr2:233818764:C:A	0	0	0	0	0	0	0	0
chr2:233819340:C:T	0	0	0	0	0	0	0	0
chr2:233819432:T:C	0	0	0	0	0	0	0	0
chr2:233823665:G:A	0	0	0	0	0	0	0	0
chr2:233823671:A:G	0	0	0	0	0	0	0	0
chr2:233828726:C:A	0	0	0	0	0	0	0	0
chr2:233854491:T:C	1	0	1	1	0	1	1	0
chr2:233983342:A:G	0	0	0	0	0	0	0	0
chr2:233996434:C:T	0	0	0	0	0	0	0	0
chr2:234058895:T:A	0	0	0	0	0	0	0	0
chr2:235041233:T:C	0	0	0	0	0	0	0	0
chr2:235041276:A:G	0	0	0	0	0	0	0	0
chr2:235041358:G:A	0	0	0	0	0	0	0	0
chr2:235041543:T:C	0	0	0	0	0	0	0	0
chr2:235041640:A:C	0	0	0	0	0	0	0	0
chr2:235043175:A:G	0	0	0	0	0	0	0	0
chr2:235852752:C:T	0	0	0	0	0	0	0	0
chr2:237374962:G:A	0	0	0	0	0	0	0	0
chr2:237525791:C:T	0	0	0	0	0	0	0	0
chr2:237534583:A:G	0	0	0	0	0	0	0	0
chr2:237540364:T:C	0	0	0	0	0	0	0	0
chr2:237540464:AG:GT	0	0	0	0	0	0	0	0
chr2:237553681:A:G	0	0	0	0	0	0	0	0
chr2:237575011:G:A	0	0	0	0	0	0	0	0
chr2:237575028:G:A	0	0	0	0	0	0	0	0
chr2:237575086:A:G	0	0	0	0	0	0	0	0
chr2:237586038:G:A	0	0	0	0	0	0	0	0
chr2:238081747:G:A	55	24	83	31	52	1	1	0
chr2:238083155:C:T	5	2	7	3	4	1	1	0
chr2:238098238:C:T	13	8	21	5	16	2	0	2
chr2:238102049:C:A	0	0	0	0	0	0	0	0
chr2:238170901:A:G	114	65	188	50	138	2.0	0.0	2.0
chr2:238246412:C:T	4	2	6	2	4	1.5	0.5	1.0
chr2:238329312:G:T	38	16	57	23	34	1.0	1.0	0.0
chr2:238397627:A:C	24	12	44	14	30	2.0	0.5	1.0
chr2:238433455:G:A	0	0	0	0	0	0	0	0
chr2:238435771:C:T	133	52	211	89	122	1	1	0
chr2:240014693:A:G	63	33	99	33	66	2	0	2
chr2:240022311:T:C	881	489	1608	521	1087	2	1	2
chr2:240029895:A:G	0	0	0	0	0	0	0	0
chr2:240045372:C:T	0	0	0	0	0	0	0	0
chr2:240045410:G:A	0	0	0	0	0	0	0	0
chr2:240045930:G:A	0	0	0	0	0	0	0	0
chr2:240046094:A:G	0	0	0	0	0	0	0	0
chr2:240126863:C:T	0	0	0	0	0	0	0	0
chr2:240134033:C:T	1	1	2	0	2	2	0	2
chr2:240450585:A:G	1	1	2	0	2	2	0	2
chr2:240561257:C:G	25	10	35	15	20	1	1	0
chr2:240576677:G:C	91	39	131	53	78	1	1	0
chr2:240589510:G:A	1	0	1	1	0	1	1	0
chr2:240592062:A:G	78	38	116	40	76	1.0	1.0	0.0
chr2:240594517:T:C	1	0	1	1	0	1	1	0
chr2:240596636:C:T	9	4	13	5	8	1	1	0
chr2:240596709:A:G	26	13	38	13	25	1.0	0.5	0.5
chr2:240598004:G:A	97	52	150	46	104	2	0	2
chr2:240618980:G:A	1	0	1	1	0	1	1	0
chr2:240719951:C:A	0	0	0	0	0	0	0	0
chr2:240906483:A:C	0	0	0	0	0	0	0	0
chr2:240925739:T:C	0	0	0	0	0	0	0	0
chr2:240933180:A:G	0	0	0	0	0	0	0	0
chr2:240950520:A:G	0	0	0	0	0	0	0	0
chr2:240959407:A:G	0	0	0	0	0	0	0	0
chr2:240959530:G:T	0	0	0	0	0	0	0	0
chr2:240964584:G:C	0	0	0	0	0	0	0	0
chr2:240966362:A:G	0	0	0	0	0	0	0	0
chr2:240983013:T:C	0	0	0	0	0	0	0	0
chr2:240993179:A:G	0	0	0	0	0	0	0	0
chr2:241040133:T:C	10	10	20	0	20	2.0	0.0	2.0
chr2:241082327:G:T	1	0	1	1	0	1	1	0
chr2:241094281:T:C	137	10	158	136	22	1	1	0
chr2:241094355:T:A	136	127	281	11	270	2.0	0.0	2.0
chr2:241096129:G:C	424	201	654	247	407	1.0	1.0	0.0
chr2:241099783:T:C	409	169	613	259	354	1	1	0
chr2:241124033:G:A	14	3	17	11	6	1.0	1.0	0.0
chr2:241126209:A:G	13	4	17	9	8	1	1	0
chr2:241127415:G:A	8	3	11	5	6	1.0	1.0	0.0
chr2:241138081:C:T	5	0	5	5	0	1	1	0
chr2:241142847:T:C	29	9	38	20	18	1	1	0
chr2:241143065:A:C	27	7	34	20	14	1	1	0
chr2:241190109:G:A	0	0	0	0	0	0	0	0
chr2:241202304:C:T	0	0	0	0	0	0	0	0
chr2:241217672:C:T	1	0	1	1	0	1	1	0
chr2:241229561:T:C	162	82	257	87	170	2.0	1.0	2.0
chr2:241236604:T:C	1	0	1	1	0	1	1	0
chr2:241336164:G:A	92	41	143	53	90	1.0	1.0	0.0
chr2:241465606:C:T	13	5	18	8	10	1	1	0
chr2:241493289:G:C	3	1	4	2	2	1	1	0
chr2:241633431:A:G	41	20	62	22	40	2	1	0
chr2:241816085:T:C	0	0	0	0	0	0	0	0
chr2:241816877:C:T	0	0	0	0	0	0	0	0
chr2:241817000:A:G	0	0	0	0	0	0	0	0
chr2:241851121:A:G	29	16	47	13	34	2	0	2
chr2:241871857:G:A	4	3	7	1	6	2.0	0.0	2.0
chr3:1383166:T:G	0	0	0	0	0	0	0	0
chr3:2988539:C:A	0	0	0	0	0	0	0	0
chr3:3845037:C:A	10	6	17	5	12	2.0	0.0	2.0
chr3:3845163:G:C	6	3	10	4	6	2.0	0.5	1.0
chr3:3845824:C:G	7	3	10	4	6	1	1	0
chr3:3846192:T:C	9	5	14	4	10	2	0	2
chr3:4362083:A:G	39	18	58	22	36	1	1	0
chr3:4362133:TT:AC	38	18	56	20	36	1.0	1.0	0.0
chr3:4362153:A:G	37	17	54	20	34	1	1	0
chr3:4670729:G:A	36	18	36	18	18	1.0	0.5	0.5
chr3:4788048:A:G	42	17	61	27	34	1.0	1.0	0.0
chr3:4800547:C:T	23	10	36	16	20	2	1	0
chr3:7578481:A:G	0	0	0	0	0	0	0	0
chr3:7578695:C:T	0	0	0	0	0	0	0	0
chr3:8627675:C:A	0	0	0	0	0	0	0	0
chr3:8633853:G:A	1	1	2	0	2	2	0	2
chr3:8992874:C:T	8	3	11	5	6	1.0	1.0	0.0
chr3:9365152:T:C	315	145	507	201	306	2	1	0
chr3:9384227:G:A	107	63	171	45	126	2	0	2
chr3:9704754:G:C	0	0	0	0	0	0	0	0
chr3:9726006:T:C	5	5	10	0	10	2	0	2
chr3:9761442:A:G	5	1	6	4	2	1	1	0
chr3:9793095:C:T	818	562	1590	330	1260	2.0	0.0	2.0
chr3:9810464:G:A	76	40	121	37	84	2.0	0.0	2.0
chr3:9817772:C:G	20	12	34	8	26	2.0	0.0	2.0
chr3:9829173:G:A	24	12	36	12	24	1.5	0.5	1.0
chr3:9835235:G:A	105	63	177	47	130	2	0	2
chr3:9835303:G:A	110	68	186	46	140	2.0	0.0	2.0
chr3:9918029:C:T	0	0	0	0	0	0	0	0
chr3:9920440:C:G	0	0	0	0	0	0	0	0
chr3:9986610:G:A	848	476	1516	472	1044	2.0	1.0	2.0
chr3:10222796:C:G	5	0	5	5	0	1	1	0
chr3:10234479:T:A	2	1	3	1	2	1.5	0.5	1.0
chr3:10338239:C:T	0	0	0	0	0	0	0	0
chr3:10372031:G:A	0	0	0	0	0	0	0	0
chr3:10844235:T:C	0	0	0	0	0	0	0	0
chr3:10934059:C:T	0	0	0	0	0	0	0	0
chr3:11020376:C:T	0	0	0	0	0	0	0	0
chr3:11554828:T:C	25	12	37	13	24	1	1	0
chr3:11554928:C:T	26	12	38	14	24	1.0	1.0	0.0
chr3:11846517:C:G	271	101	386	177	209	1	1	0
chr3:12572367:T:C	123	78	212	52	160	2	0	2
chr3:12796680:A:G	28	0	29	29	0	1.0	1.0	0.0
chr3:12807323:T:C	19	19	40	0	40	2	0	2
chr3:12815357:A:G	0	0	0	0	0	0	0	0
chr3:12815994:C:T	0	0	0	0	0	0	0	0
chr3:12816529:T:C	0	0	0	0	0	0	0	0
chr3:12817505:A:C	2	2	4	0	4	2.0	0.0	2.0
chr3:12920574:G:A	8	4	12	4	8	1.5	0.5	1.0
chr3:13854643:A:G	0	0	0	0	0	0	0	0
chr3:13854787:C:T	0	0	0	0	0	0	0	0
chr3:14145949:G:T	217	123	367	103	264	2	0	2
chr3:14147840:A:G	8	4	12	4	8	1.5	0.5	1.0
chr3:14158387:G:A	99	37	142	64	78	1	1	0
chr3:14158706:G:A	85	52	139	34	105	2	0	2
chr3:14178595:C:G	811	275	1252	664	588	1	1	0
chr3:14447862:G:T	27	12	40	16	24	1	1	0
chr3:14485030:G:A	16	6	22	10	12	1.0	1.0	0.0
chr3:15434504:C:G	43	26	69	17	52	2	0	2
chr3:15475403:T:C	0	0	0	0	0	0	0	0
chr3:15477224:G:C	0	0	0	0	0	0	0	0
chr3:15635512:G:A	272	118	421	169	252	1.0	1.0	0.0
chr3:16271057:C:T	82	43	127	41	86	2.0	0.0	2.0
chr3:16286348:T:G	62	35	99	29	70	2.0	0.0	2.0
chr3:16317077:T:C	16	9	25	7	18	2.0	0.0	2.0
chr3:16323412:A:C	75	40	118	36	82	2	0	2
chr3:16377802:C:T	69	31	104	40	64	1	1	0
chr3:16605238:C:G	0	0	0	0	0	0	0	0
chr3:17166775:T:C	68	36	106	34	72	2.0	0.0	2.0
chr3:19888638:A:T	0	0	0	0	0	0	0	0
chr3:19933647:C:T	0	0	0	0	0	0	0	0
chr3:19950940:G:T	770	394	1349	479	870	2.0	1.0	2.0
chr3:20072338:G:A	38	17	57	21	36	1.0	1.0	0.0
chr3:21751110:G:C	0	0	0	0	0	0	0	0
chr3:23918589:G:C	53	27	84	26	58	2	0	2
chr3:24143504:G:A	0	0	0	0	0	0	0	0
chr3:27162561:G:A	0	0	0	0	0	0	0	0
chr3:27284606:G:T	0	0	0	0	0	0	0	0
chr3:27284960:A:G	0	0	0	0	0	0	0	0
chr3:27291329:A:G	0	0	0	0	0	0	0	0
chr3:27421738:C:T	0	0	0	0	0	0	0	0
chr3:28492167:G:A	6	5	14	2	12	2.0	0.0	2.0
chr3:31661972:T:C	176	94	279	87	192	2.0	0.0	2.0
chr3:31670901:C:T	50	24	75	27	48	1.5	1.0	0.0
chr3:31683824:G:A	53	25	81	29	52	1	1	0
chr3:31989532:C:T	43	27	72	18	54	2	0	2
chr3:31989643:A:G	42	26	68	16	52	2.0	0.0	2.0
chr3:31990905:G:T	16	8	24	8	16	1.5	0.5	1.0
chr3:33077139:G:A	2	2	4	0	4	2.0	0.0	2.0
chr3:33094100:T:C	5	1	6	4	2	1	1	0
chr3:33097057:G:A	65	28	96	40	56	1	1	0
chr3:33120406:C:T	153	70	234	92	142	1	1	0
chr3:33132664:T:G	86	45	136	42	94	2.0	0.0	2.0
chr3:33153498:C:A	3	2	5	1	4	2	0	2
chr3:33842000:G:A	112	60	178	56	122	2.0	0.0	2.0
chr3:35737281:A:G	0	0	0	0	0	0	0	0
chr3:35738258:A:G	0	0	0	0	0	0	0	0
chr3:36380634:C:T	0	0	0	0	0	0	0	0
chr3:36380643:G:A	0	0	0	0	0	0	0	0
chr3:36380724:T:C	0	0	0	0	0	0	0	0
chr3:36738216:G:A	0	0	0	0	0	0	0	0
chr3:36856321:T:C	20	10	34	11	23	2.0	0.5	1.0
chr3:36899250:G:T	279	148	442	137	305	2	0	2
chr3:36908471:G:T	287	154	461	141	320	2	0	2
chr3:36993455:G:A	14	6	22	8	14	1.0	1.0	0.0
chr3:37065979:G:A	17	11	28	6	22	2	0	2
chr3:37519351:A:G	1	1	2	0	2	2	0	2
chr3:37732813:C:T	0	0	0	0	0	0	0	0
chr3:37999296:G:T	3	0	3	3	0	1	1	0
chr3:38039461:T:G	0	0	0	0	0	0	0	0
chr3:38039540:A:T	0	0	0	0	0	0	0	0
chr3:38084214:G:A	0	0	0	0	0	0	0	0
chr3:38110240:T:C	1	0	1	1	0	1	1	0
chr3:38307458:G:T	0	0	0	0	0	0	0	0
chr3:38316326:C:T	0	0	0	0	0	0	0	0
chr3:38355867:A:G	0	0	0	0	0	0	0	0
chr3:38362981:C:A	5	0	6	6	0	1	1	0
chr3:38365282:G:T	8	1	10	8	2	1.0	1.0	0.0
chr3:38366870:G:A	3	0	4	4	0	1	1	0
chr3:38477933:A:G	4	2	6	2	4	1.5	0.5	1.0
chr3:38483251:C:T	12	8	20	4	16	2.0	0.0	2.0
chr3:38550198:T:C	0	0	0	0	0	0	0	0
chr3:38550915:A:G	1	0	1	1	0	1	1	0
chr3:38722372:G:C	0	0	0	0	0	0	0	0
chr3:38723507:A:G	0	0	0	0	0	0	0	0
chr3:38725184:A:G	0	0	0	0	0	0	0	0
chr3:38725269:G:T	0	0	0	0	0	0	0	0
chr3:38726756:G:A	0	0	0	0	0	0	0	0
chr3:38726809:T:C	0	0	0	0	0	0	0	0
chr3:38752498:G:A	0	0	0	0	0	0	0	0
chr3:38756680:C:T	0	0	0	0	0	0	0	0
chr3:38894643:C:T	1	1	2	0	2	2	0	2
chr3:38904069:A:G	0	0	0	0	0	0	0	0
chr3:39094060:G:A	8	3	11	5	6	1.0	1.0	0.0
chr3:39103419:A:G	4	2	6	2	4	1.5	0.5	1.0
chr3:39107727:A:T	111	59	175	55	120	2	0	2
chr3:39110854:G:A	72	42	117	31	86	2.0	0.0	2.0
chr3:39128879:C:T	6	2	8	4	4	1.0	1.0	0.0
chr3:39132971:T:C	5	1	6	4	2	1	1	0
chr3:39138608:T:C	62	26	91	37	54	1.0	1.0	0.0
chr3:39138671:A:C	5	0	6	6	0	1	1	0
chr3:39138772:G:A	67	28	99	41	58	1	1	0
chr3:39143468:C:T	82	43	127	41	86	2.0	0.5	2.0
chr3:39143586:G:A	80	43	124	38	86	2.0	0.0	2.0
chr3:39146691:C:T	72	27	104	48	56	1.0	1.0	0.0
chr3:39184623:G:A	0	0	0	0	0	0	0	0
chr3:39189506:A:G	0	0	0	0	0	0	0	0
chr3:39265765:C:T	1	0	1	1	0	1	1	0
chr3:39281672:A:C	0	0	0	0	0	0	0	0
chr3:39389590:G:A	212	116	346	104	242	2.0	0.0	2.0
chr3:39407646:T:C	1089	494	1872	792	1080	2	1	0
chr3:39408574:C:T	174	91	272	86	186	2.0	0.0	2.0
chr3:39411669:G:A	687	329	1132	442	690	2	1	0
chr3:41789711:C:T	3	2	5	1	4	2	0	2
chr3:41954644:T:C	223	87	340	156	184	1	1	0
chr3:42397262:T:C	14	14	28	0	28	2.0	0.0	2.0
chr3:42519390:T:A	6	2	8	4	4	1.0	1.0	0.0
chr3:42865620:A:C	0	0	0	0	0	0	0	0
chr3:42874386:C:T	0	0	0	0	0	0	0	0
chr3:42906301:C:T	0	0	0	0	0	0	0	0
chr3:42979596:G:A	0	0	0	0	0	0	0	0
chr3:43032269:G:A	0	0	0	0	0	0	0	0
chr3:43032938:AGCTC:GGCTT	0	0	0	0	0	0	0	0
chr3:43056218:A:G	0	0	0	0	0	0	0	0
chr3:43081474:G:A	0	0	0	0	0	0	0	0
chr3:43549835:G:A	1	0	1	1	0	1	1	0
chr3:43561311:C:T	2	2	4	0	4	2.0	0.0	2.0
chr3:43576788:T:C	3	1	4	2	2	1	1	0
chr3:44242033:A:G	0	0	0	0	0	0	0	0
chr3:44242180:T:C	0	0	0	0	0	0	0	0
chr3:44242316:C:A	0	0	0	0	0	0	0	0
chr3:44500177:G:C	56	33	93	27	66	2.0	0.0	2.0
chr3:44570558:C:T	1	1	2	0	2	2	0	2
chr3:44580623:T:C	2	1	3	1	2	1.5	0.5	1.0
chr3:44580684:G:A	2	1	3	1	2	1.5	0.5	1.0
chr3:44651072:C:G	179	91	281	93	188	2	1	2
chr3:44710169:C:T	0	0	0	0	0	0	0	0
chr3:44887795:G:C	0	0	0	0	0	0	0	0
chr3:45011283:G:C	439	241	738	232	506	2	0	2
chr3:45035631:G:A	3	1	4	2	2	1	1	0
chr3:45093330:T:C	0	0	0	0	0	0	0	0
chr3:45112216:G:A	0	0	0	0	0	0	0	0
chr3:45146293:C:G	0	0	0	0	0	0	0	0
chr3:45706937:G:A	89	50	139	39	100	2	0	2
chr3:45706943:A:G	89	50	141	39	102	2	0	2
chr3:45713257:G:A	4	1	5	3	2	1.0	1.0	0.0
chr3:45739656:C:T	1	1	2	0	2	2	0	2
chr3:45771533:A:G	0	0	0	0	0	0	0	0
chr3:45947552:T:G	0	0	0	0	0	0	0	0
chr3:45966595:G:A	6	3	9	3	6	1.5	0.5	1.0
chr3:45967995:G:A	11	6	17	5	12	2	0	2
chr3:45967999:C:T	11	5	16	6	10	1	1	0
chr3:45968372:C:G	22	13	35	9	26	2.0	0.0	2.0
chr3:45968515:T:C	22	13	35	9	26	2.0	0.0	2.0
chr3:46021837:T:C	0	0	0	0	0	0	0	0
chr3:46265209:T:C	0	0	0	0	0	0	0	0
chr3:46358307:T:C	0	0	0	0	0	0	0	0
chr3:46408806:A:G	2	0	2	2	0	1.0	1.0	0.0
chr3:46439310:A:G	0	0	0	0	0	0	0	0
chr3:46443473:G:A	0	0	0	0	0	0	0	0
chr3:46447363:T:C	0	0	0	0	0	0	0	0
chr3:46448983:G:A	0	0	0	0	0	0	0	0
chr3:46459723:T:C	0	0	0	0	0	0	0	0
chr3:46671612:C:T	0	0	0	0	0	0	0	0
chr3:46675575:C:G	0	0	0	0	0	0	0	0
chr3:46681202:G:T	0	0	0	0	0	0	0	0
chr3:46902784:T:C	0	0	0	0	0	0	0	0
chr3:46922012:T:C	1127	652	2109	668	1441	2	1	2
chr3:46923707:C:G	3	2	5	1	4	2	0	2
chr3:46995266:C:G	1	1	2	0	2	2	0	2
chr3:47002048:C:T	2	1	3	1	2	1.5	0.5	1.0
chr3:47002132:G:A	1	0	1	1	0	1	1	0
chr3:47004249:C:G	1	1	2	0	2	2	0	2
chr3:47004425:C:T	0	0	0	0	0	0	0	0
chr3:47005352:G:C	0	0	0	0	0	0	0	0
chr3:47005868:A:C	1	0	1	1	0	1	1	0
chr3:47083895:G:A	83	48	132	36	96	2	0	2
chr3:47121171:A:G	123	64	202	66	136	2	1	2
chr3:47123221:C:T	57	33	93	27	66	2	0	2
chr3:47240813:G:A	2	2	4	0	4	2.0	0.0	2.0
chr3:47411296:G:A	16	8	24	8	16	1.5	0.5	1.0
chr3:47418189:C:T	34	19	53	15	38	2.0	0.0	2.0
chr3:47422632:A:G	3	2	5	1	4	2	0	2
chr3:47513652:C:A	449	256	771	233	538	2	0	2
chr3:47670712:T:C	317	139	484	196	288	1	1	0
chr3:48689679:G:A	177	83	264	98	166	1	1	0
chr3:48695413:G:A	536	236	846	340	506	1.0	1.0	0.0
chr3:49007334:C:T	27	17	44	10	34	2	0	2
chr3:49015352:T:A	234	109	361	136	225	1.0	1.0	0.0
chr3:49015786:A:G	532	256	880	316	564	2.0	1.0	0.0
chr3:49017259:T:C	316	160	498	164	334	2.0	1.0	2.0
chr3:49033066:C:T	30	19	49	11	38	2.0	0.0	2.0
chr3:49098528:C:G	6	2	8	4	4	1.0	1.0	0.0
chr3:49119243:A:G	36	21	60	16	44	2.0	0.0	2.0
chr3:49128636:C:T	0	0	0	0	0	0	0	0
chr3:49132349:G:A	1	1	2	0	2	2	0	2
chr3:49163194:A:G	49	25	76	24	52	2	0	2
chr3:49163259:T:A	47	25	74	22	52	2	0	2
chr3:49652766:G:A	0	0	0	0	0	0	0	0
chr3:49663865:G:A	0	0	0	0	0	0	0	0
chr3:49686351:C:A	0	0	0	0	0	0	0	0
chr3:49687375:T:C	2	1	3	1	2	1.5	0.5	1.0
chr3:49702074:G:C	0	0	0	0	0	0	0	0
chr3:49712755:T:A	2	1	3	1	2	1.5	0.5	1.0
chr3:49715570:T:G	0	0	0	0	0	0	0	0
chr3:49793625:G:A	3	2	5	1	4	2	0	2
chr3:49810209:G:A	7	4	11	3	8	2	0	2
chr3:49829151:T:G	7	5	12	2	10	2	0	2
chr3:49860840:A:G	0	0	0	0	0	0	0	0
chr3:49860885:C:G	0	0	0	0	0	0	0	0
chr3:49862362:G:A	0	0	0	0	0	0	0	0
chr3:49887507:T:C	4	1	5	3	2	1.0	1.0	0.0
chr3:49898669:T:C	0	0	0	0	0	0	0	0
chr3:49911638:A:G	6	2	8	4	4	1.0	1.0	0.0
chr3:50077082:C:T	283	151	462	138	324	2	0	2
chr3:50107518:T:C	139	70	217	75	142	2	1	2
chr3:50115923:T:C	162	78	244	86	158	1.0	1.0	0.0
chr3:50217873:A:G	0	0	0	0	0	0	0	0
chr3:50252421:C:T	1303	725	2487	822	1665	2	1	2
chr3:50256634:C:G	7	2	9	5	4	1	1	0
chr3:50287239:GGT:GGG	0	0	0	0	0	0	0	0
chr3:50292284:C:A	265	141	428	135	293	2	0	2
chr3:50292395:A:G	262	123	406	150	256	1.5	1.0	0.0
chr3:50320438:A:C	33	17	51	17	34	2	0	2
chr3:50332115:C:A	578	288	941	339	602	2.0	1.0	0.0
chr3:50337137:T:C	249	122	385	133	252	1	1	0
chr3:50342701:G:A	2	2	4	0	4	2.0	0.0	2.0
chr3:50343230:G:A	0	0	0	0	0	0	0	0
chr3:51637442:G:A	2	1	3	1	2	1.5	0.5	1.0
chr3:51778936:C:T	0	0	0	0	0	0	0	0
chr3:51944624:G:A	2	0	2	2	0	1.0	1.0	0.0
chr3:51977896:G:A	477	232	785	289	496	2	1	0
chr3:52239094:G:A	490	263	826	272	554	2.0	1.0	2.0
chr3:52396510:G:A	5	3	8	2	6	2	0	2
chr3:52506757:T:C	0	0	0	0	0	0	0	0
chr3:52514802:C:T	0	0	0	0	0	0	0	0
chr3:52516994:C:T	0	0	0	0	0	0	0	0
chr3:52521941:T:C	0	0	0	0	0	0	0	0
chr3:52522353:C:T	0	0	0	0	0	0	0	0
chr3:52523992:T:C	0	0	0	0	0	0	0	0
chr3:52686064:A:C	593	306	978	331	647	2	1	2
chr3:52777730:G:A	0	0	0	0	0	0	0	0
chr3:52780240:T:A	0	0	0	0	0	0	0	0
chr3:52780241:A:T	0	0	0	0	0	0	0	0
chr3:52796748:C:T	0	0	0	0	0	0	0	0
chr3:52818522:G:T	28	20	48	8	40	2.0	0.0	2.0
chr3:52819731:C:G	0	0	0	0	0	0	0	0
chr3:52826800:C:T	6	3	9	3	6	1.5	0.5	1.0
chr3:52826920:C:T	5	2	7	3	4	1	1	0
chr3:52827195:A:T	4	2	6	2	4	1.5	0.5	1.0
chr3:52830568:A:G	4	2	6	2	4	1.5	0.5	1.0
chr3:52830677:T:G	0	0	0	0	0	0	0	0
chr3:52840430:C:T	79	37	116	42	74	1	1	0
chr3:53225980:G:A	1	1	2	0	2	2	0	2
chr3:53226694:G:A	4	3	7	1	6	2.0	0.0	2.0
chr3:53226700:C:T	4	3	7	1	6	2.0	0.0	2.0
chr3:53233139:G:A	2	1	3	1	2	1.5	0.5	1.0
chr3:53811268:C:T	1	1	2	0	2	2	0	2
chr3:53821655:T:C	0	0	0	0	0	0	0	0
chr3:53822626:C:T	1	1	2	0	2	2	0	2
chr3:54123683:A:T	0	0	0	0	0	0	0	0
chr3:54764231:G:A	0	0	0	0	0	0	0	0
chr3:56296340:C:T	0	0	0	0	0	0	0	0
chr3:56624843:T:C	67	34	104	34	70	2	0	2
chr3:56633654:G:C	45	22	69	23	46	1	1	0
chr3:56682894:T:G	513	252	832	291	541	2	1	0
chr3:57301848:C:T	0	0	0	0	0	0	0	0
chr3:57377088:A:G	0	0	0	0	0	0	0	0
chr3:57556446:C:T	158	79	245	82	163	2.0	1.0	0.5
chr3:57757519:G:A	69	41	113	29	84	2	0	2
chr3:57757610:C:G	74	32	108	42	66	1.0	1.0	0.0
chr3:58096161:T:C	34	18	53	17	36	2.0	0.0	2.0
chr3:58126713:A:G	21	13	34	8	26	2	0	2
chr3:58285236:T:C	1	1	2	0	2	2	0	2
chr3:58397119:C:T	207	86	317	129	188	1	1	0
chr3:58413003:G:A	5	3	8	2	6	2	0	2
chr3:58424827:C:T	20	7	27	13	14	1.0	1.0	0.0
chr3:58429840:C:T	8	6	14	2	12	2.0	0.0	2.0
chr3:58431689:C:T	18	9	27	9	18	1.5	0.5	1.0
chr3:58526510:A:G	0	0	0	0	0	0	0	0
chr3:58526558:T:C	0	0	0	0	0	0	0	0
chr3:58533578:C:G	0	0	0	0	0	0	0	0
chr3:58534579:G:C	0	0	0	0	0	0	0	0
chr3:58535132:A:G	0	0	0	0	0	0	0	0
chr3:58640148:C:A	0	0	0	0	0	0	0	0
chr3:59049699:C:A	0	0	0	0	0	0	0	0
chr3:59922400:A:G	55	28	89	29	60	2	1	2
chr3:61742582:G:T	6	4	10	2	8	2.0	0.0	2.0
chr3:62324026:G:A	2	2	4	0	4	2.0	0.0	2.0
chr3:62372752:C:A	0	0	0	0	0	0	0	0
chr3:64100068:G:A	0	0	0	0	0	0	0	0
chr3:64602142:G:A	0	0	0	0	0	0	0	0
chr3:66243264:A:G	496	281	834	245	589	2.0	0.0	2.0
chr3:66377858:C:T	279	108	401	180	221	1	1	0
chr3:66380387:T:G	16	9	24	7	17	1.5	0.0	1.5
chr3:66384219:T:C	10	5	15	5	10	1.5	0.5	1.0
chr3:66394191:G:A	3	0	3	3	0	1	1	0
chr3:66998338:T:C	289	129	448	170	278	1	1	0
chr3:68733062:A:G	0	0	0	0	0	0	0	0
chr3:69118700:G:T	0	0	0	0	0	0	0	0
chr3:71041364:T:G	1155	640	2153	741	1412	2	1	2
chr3:72750552:C:T	9	5	14	4	10	2	0	2
chr3:73384343:T:C	0	0	0	0	0	0	0	0
chr3:73401047:G:A	0	0	0	0	0	0	0	0
chr3:75423058:C:T	49	27	81	23	58	2	0	2
chr3:75423109:C:T	6	3	10	4	6	2.0	0.5	1.0
chr3:75426519:A:C	100	53	161	51	110	2.0	0.0	2.0
chr3:75426534:A:G	100	53	161	51	110	2.0	0.0	2.0
chr3:75664356:C:T	0	0	0	0	0	0	0	0
chr3:75664415:T:C	0	0	0	0	0	0	0	0
chr3:75665637:A:C	0	0	0	0	0	0	0	0
chr3:75665658:C:T	0	0	0	0	0	0	0	0
chr3:75665668:G:A	0	0	0	0	0	0	0	0
chr3:75665689:A:G	0	0	0	0	0	0	0	0
chr3:75665936:T:A	0	0	0	0	0	0	0	0
chr3:75665948:T:A	0	0	0	0	0	0	0	0
chr3:75736845:G:A	1	0	2	2	0	2	2	0
chr3:75736862:G:C	1	0	2	2	0	2	2	0
chr3:75736880:A:C	1	0	2	2	0	2	2	0
chr3:75736885:A:C	1	0	2	2	0	2	2	0
chr3:75736922:C:G	1	0	2	2	0	2	2	0
chr3:75737024:C:A	1	0	2	2	0	2	2	0
chr3:75737070:G:A	1	0	2	2	0	2	2	0
chr3:75737100:GG:AT	1	0	2	2	0	2	2	0
chr3:75737289:C:T	1	1	4	0	4	4	0	4
chr3:75737477:G:C	0	0	0	0	0	0	0	0
chr3:75738389:T:C	6	3	9	3	6	1.5	0.5	1.0
chr3:75738658:T:C	5	1	6	4	2	1	1	0
chr3:76435315:A:G	0	0	0	0	0	0	0	0
chr3:87227549:C:T	637	351	1098	340	758	2	0	2
chr3:88139270:G:A	22	15	37	7	30	2.0	0.0	2.0
chr3:88140191:T:C	25	13	39	13	26	2	0	2
chr3:88150029:T:C	628	353	1073	307	766	2.0	0.0	2.0
chr3:88150148:T:C	642	364	1100	311	789	2.0	0.0	2.0
chr3:97822174:C:T	13	8	21	5	16	2	0	2
chr3:97872309:C:T	2	1	3	1	2	1.5	0.5	1.0
chr3:97873146:A:C	0	0	0	0	0	0	0	0
chr3:97874641:C:T	1	1	2	0	2	2	0	2
chr3:97875417:G:A	0	0	0	0	0	0	0	0
chr3:97876334:A:G	1	0	1	1	0	1	1	0
chr3:97876535:G:A	1	0	1	1	0	1	1	0
chr3:97941240:C:T	2	1	3	1	2	1.5	0.5	1.0
chr3:97941262:A:C	2	1	3	1	2	1.5	0.5	1.0
chr3:98007903:A:T	0	0	0	0	0	0	0	0
chr3:98087772:G:A	0	0	0	0	0	0	0	0
chr3:98088100:T:C	0	0	0	0	0	0	0	0
chr3:98133154:A:C	0	0	0	0	0	0	0	0
chr3:98149575:G:A	0	0	0	0	0	0	0	0
chr3:98149772:C:T	0	0	0	0	0	0	0	0
chr3:98150126:T:A	0	0	0	0	0	0	0	0
chr3:98169021:G:A	0	0	0	0	0	0	0	0
chr3:98169353:C:T	0	0	0	0	0	0	0	0
chr3:98283014:A:G	0	0	0	0	0	0	0	0
chr3:98391191:C:A	0	0	0	0	0	0	0	0
chr3:98532142:C:T	0	0	0	0	0	0	0	0
chr3:98533183:G:A	0	0	0	0	0	0	0	0
chr3:98812498:A:G	0	0	0	0	0	0	0	0
chr3:99850926:C:T	453	188	755	329	426	2	1	0
chr3:99924332:C:T	12	2	14	10	4	1.0	1.0	0.0
chr3:100339177:C:T	557	318	1017	313	704	2	1	2
chr3:100346058:C:T	50	28	80	22	58	2.0	0.0	2.0
chr3:100455878:G:A	13	7	20	6	14	2	0	2
chr3:100635680:A:G	0	0	0	0	0	0	0	0
chr3:100748174:T:C	192	84	282	112	170	1.0	1.0	0.0
chr3:100898824:G:T	0	0	0	0	0	0	0	0
chr3:100898836:C:T	0	0	0	0	0	0	0	0
chr3:100993405:T:C	0	0	0	0	0	0	0	0
chr3:101230998:G:A	0	0	0	0	0	0	0	0
chr3:101244310:G:A	0	0	0	0	0	0	0	0
chr3:101366569:G:A	58	27	85	31	54	1.0	1.0	0.0
chr3:101576718:T:C	97	37	143	65	78	1	1	0
chr3:105524545:T:C	12	6	19	7	12	1.5	1.0	1.0
chr3:105541674:G:A	32	24	58	8	50	2.0	0.0	2.0
chr3:105670309:A:G	34	20	57	15	42	2.0	0.0	2.0
chr3:105704000:C:T	49	25	76	26	50	2	0	2
chr3:105720113:T:G	23	10	33	13	20	1	1	0
chr3:108428881:T:C	0	0	0	0	0	0	0	0
chr3:108470780:C:T	1	0	1	1	0	1	1	0
chr3:108755677:A:C	0	0	0	0	0	0	0	0
chr3:111567528:G:C	3	1	6	2	4	1	1	0
chr3:111845992:A:G	0	0	0	0	0	0	0	0
chr3:111913767:A:G	0	0	0	0	0	0	0	0
chr3:111969731:C:T	0	0	0	0	0	0	0	0
chr3:112000939:A:T	0	0	0	0	0	0	0	0
chr3:112169290:A:T	0	0	0	0	0	0	0	0
chr3:112347715:G:A	880	477	1625	538	1087	2.0	1.0	2.0
chr3:112536660:G:A	156	104	278	59	219	2.0	0.0	2.0
chr3:113013348:C:T	130	68	203	63	140	2.0	0.0	2.0
chr3:113936360:C:T	7	3	10	4	6	1	1	0
chr3:113954278:A:G	34	20	54	14	40	2.0	0.0	2.0
chr3:114076987:G:A	12	5	20	8	12	1.5	1.0	0.0
chr3:114236973:G:C	8	3	11	5	6	1.0	1.0	0.0
chr3:118981936:T:C	0	0	0	0	0	0	0	0
chr3:119146485:A:G	0	0	0	0	0	0	0	0
chr3:119146762:C:T	0	0	0	0	0	0	0	0
chr3:119146954:C:T	0	0	0	0	0	0	0	0
chr3:119294867:C:A	68	39	111	29	82	2.0	0.0	2.0
chr3:119409551:G:A	6	1	7	5	2	1.0	1.0	0.0
chr3:119414336:G:A	3	1	4	2	2	1	1	0
chr3:119431989:C:T	68	41	110	27	83	2.0	0.0	2.0
chr3:119480026:G:A	17	4	24	14	10	1	1	0
chr3:119503609:G:C	588	298	984	344	640	2.0	1.0	2.0
chr3:119660025:G:A	17	6	25	11	14	1	1	0
chr3:119660130:G:A	3	2	5	1	4	2	0	2
chr3:119660339:C:T	1	1	2	0	2	2	0	2
chr3:119807502:G:A	0	0	0	0	0	0	0	0
chr3:120348950:G:A	86	47	134	40	94	2.0	0.0	2.0
chr3:120349175:C:G	83	37	122	46	76	1	1	0
chr3:120628527:T:G	2	1	3	1	2	1.5	0.5	1.0
chr3:120652594:T:G	0	0	0	0	0	0	0	0
chr3:121545877:T:C	5	3	8	2	6	2	0	2
chr3:121621689:T:C	0	0	0	0	0	0	0	0
chr3:121627027:G:C	0	0	0	0	0	0	0	0
chr3:121634407:T:C	746	382	1272	450	822	2.0	1.0	2.0
chr3:121635736:G:A	739	373	1253	451	802	2	1	2
chr3:121664450:G:A	84	50	138	37	101	2.0	0.0	2.0
chr3:121695214:C:T	149	67	239	95	144	2	1	0
chr3:121696873:T:C	65	27	92	38	54	1	1	0
chr3:121781852:C:T	115	68	193	49	144	2	0	2
chr3:121993204:A:C	1	0	1	1	0	1	1	0
chr3:121993958:G:C	1	0	1	1	0	1	1	0
chr3:122284910:G:T	0	0	0	0	0	0	0	0
chr3:122414983:T:G	29	19	50	10	40	2	0	2
chr3:122540793:T:C	200	100	328	114	214	2.0	1.0	1.0
chr3:122555910:G:C	367	200	597	179	418	2	0	2
chr3:122558421:G:A	231	111	362	134	228	2	1	0
chr3:122577800:G:A	2202	1464	5758	1789	3969	2.0	1.0	2.0
chr3:122627023:C:T	54	14	71	43	28	1.0	1.0	0.0
chr3:122635190:A:G	120	62	192	62	130	2.0	0.0	2.0
chr3:122635869:C:T	132	72	214	64	150	2.0	0.0	2.0
chr3:122718474:T:C	207	97	327	125	202	1	1	0
chr3:122915616:C:A	0	0	0	0	0	0	0	0
chr3:123915199:G:A	14	5	19	9	10	1.0	1.0	0.0
chr3:123933629:G:A	16	6	22	10	12	1.0	1.0	0.0
chr3:124477247:A:T	0	0	0	0	0	0	0	0
chr3:124632469:G:A	1	0	1	1	0	1	1	0
chr3:124632577:T:C	1	0	1	1	0	1	1	0
chr3:124699999:C:T	0	0	0	0	0	0	0	0
chr3:124730444:A:G	96	42	143	55	88	1.0	1.0	0.0
chr3:125009628:C:G	11	3	14	8	6	1	1	0
chr3:125009782:A:G	18	6	24	12	12	1.0	1.0	0.0
chr3:125012641:C:G	12	5	17	7	10	1.0	1.0	0.0
chr3:125012845:T:A	12	5	17	7	10	1.0	1.0	0.0
chr3:125027503:T:C	4	1	5	3	2	1.0	1.0	0.0
chr3:125083833:A:G	13	3	16	10	6	1	1	0
chr3:125084037:A:G	12	3	14	9	5	1.0	1.0	0.0
chr3:125084044:C:T	12	3	15	9	6	1.0	1.0	0.0
chr3:125107564:T:C	11	10	21	1	20	2	0	2
chr3:125110213:A:G	8	8	16	0	16	2.0	0.0	2.0
chr3:125232977:C:T	111	66	185	45	140	2	0	2
chr3:125934448:A:G	2	2	4	0	4	2.0	0.0	2.0
chr3:126006612:G:C	97	34	136	68	68	1	1	0
chr3:126007205:G:C	75	45	123	31	92	2	0	2
chr3:126050914:C:T	1	1	2	0	2	2	0	2
chr3:126107216:T:C	0	0	0	0	0	0	0	0
chr3:126483414:G:A	1	1	2	0	2	2	0	2
chr3:126500784:G:A	0	0	0	0	0	0	0	0
chr3:127575658:A:G	0	0	0	0	0	0	0	0
chr3:127675841:A:C	36	19	57	17	40	2.0	0.0	2.0
chr3:127710724:C:G	0	0	0	0	0	0	0	0
chr3:128486108:C:T	1	1	6	0	6	6	0	6
chr3:128487017:G:C	1	1	6	0	6	6	0	6
chr3:128895342:A:C	66	31	97	35	62	1.0	1.0	0.0
chr3:128909090:C:T	17	7	26	10	16	1	1	0
chr3:128945112:G:A	0	0	0	0	0	0	0	0
chr3:128945811:G:T	0	0	0	0	0	0	0	0
chr3:129001671:G:T	0	0	0	0	0	0	0	0
chr3:129037110:G:A	0	0	0	0	0	0	0	0
chr3:129275150:G:C	4	2	6	2	4	1.5	0.5	1.0
chr3:130397852:A:C	0	0	0	0	0	0	0	0
chr3:130397863:C:T	0	0	0	0	0	0	0	0
chr3:130431466:A:C	0	0	0	0	0	0	0	0
chr3:130468973:T:C	0	0	0	0	0	0	0	0
chr3:130649225:A:G	0	0	0	0	0	0	0	0
chr3:131024968:G:A	72	41	116	32	84	2.0	0.0	2.0
chr3:131228591:A:T	0	0	0	0	0	0	0	0
chr3:132467343:G:A	5	1	6	4	2	1	1	0
chr3:132499779:G:T	21	10	33	11	22	1	1	0
chr3:132559022:G:A	42	24	70	18	52	2.0	0.0	2.0
chr3:132716979:C:T	36	23	66	14	52	2.0	0.0	2.0
chr3:133380401:G:A	0	0	0	0	0	0	0	0
chr3:133637946:G:A	8	4	12	4	8	1.5	0.5	1.0
chr3:133643310:A:G	21	12	33	9	24	2	0	2
chr3:133746439:A:G	0	0	0	0	0	0	0	0
chr3:133768114:G:C	1	0	1	1	0	1	1	0
chr3:133775550:C:T	2	2	4	0	4	2.0	0.0	2.0
chr3:133805873:G:C	246	127	394	132	262	2.0	0.5	2.0
chr3:134222476:C:T	47	28	77	19	58	2	0	2
chr3:134358628:C:G	0	0	0	0	0	0	0	0
chr3:134603900:A:G	0	0	0	0	0	0	0	0
chr3:134603972:G:C	0	0	0	0	0	0	0	0
chr3:134650874:C:A	0	0	0	0	0	0	0	0
chr3:136002939:C:G	0	0	0	0	0	0	0	0
chr3:138263876:T:G	4	2	6	2	4	1.5	0.5	1.0
chr3:138402356:C:T	0	0	0	0	0	0	0	0
chr3:138470189:T:C	0	0	0	0	0	0	0	0
chr3:138470816:A:G	0	0	0	0	0	0	0	0
chr3:139538761:A:G	0	0	0	0	0	0	0	0
chr3:139539569:G:A	0	0	0	0	0	0	0	0
chr3:140459643:G:A	0	0	0	0	0	0	0	0
chr3:140688105:G:A	0	0	0	0	0	0	0	0
chr3:140688418:C:A	0	0	0	0	0	0	0	0
chr3:141608632:G:A	63	34	98	30	68	2	0	2
chr3:142449489:C:T	87	40	130	48	82	1	1	0
chr3:142550233:C:T	11	8	19	3	16	2	0	2
chr3:142555928:T:C	59	30	97	31	66	2	1	2
chr3:142558733:A:T	30	16	47	15	32	2.0	0.0	2.0
chr3:142561266:T:C	48	31	81	19	62	2.0	0.0	2.0
chr3:142561479:T:G	17	5	22	12	10	1	1	0
chr3:142562456:C:T	56	30	88	28	60	2.0	0.0	2.0
chr3:142562770:A:G	81	49	131	33	98	2	0	2
chr3:142563152:C:T	2	2	4	0	4	2.0	0.0	2.0
chr3:142829718:A:G	0	0	0	0	0	0	0	0
chr3:143176669:C:T	0	0	0	0	0	0	0	0
chr3:143176702:G:A	0	0	0	0	0	0	0	0
chr3:143177084:G:A	0	0	0	0	0	0	0	0
chr3:143985674:C:T	36	15	52	22	30	1.0	1.0	0.0
chr3:148857369:C:T	0	0	0	0	0	0	0	0
chr3:148987424:G:A	0	0	0	0	0	0	0	0
chr3:148987570:A:G	1	0	1	1	0	1	1	0
chr3:149186647:T:G	5	2	7	3	4	1	1	0
chr3:149198448:T:A	0	0	0	0	0	0	0	0
chr3:149375451:A:G	1	1	4	0	4	4	0	4
chr3:149475897:T:C	0	0	0	0	0	0	0	0
chr3:149968289:T:C	17	4	24	14	10	1	1	0
chr3:149982732:T:C	2	1	3	1	2	1.5	0.5	1.0
chr3:150410605:G:A	52	16	72	38	34	1.0	1.0	0.0
chr3:150410697:C:A	59	39	103	21	82	2	0	2
chr3:150411207:T:G	79	49	132	30	102	2	0	2
chr3:150562658:C:G	426	246	729	217	512	2.0	0.0	2.0
chr3:150603336:G:A	1308	757	2434	772	1662	2.0	1.0	2.0
chr3:151163987:A:C	0	0	0	0	0	0	0	0
chr3:151214287:T:G	7	2	9	5	4	1	1	0
chr3:151295108:C:T	0	0	0	0	0	0	0	0
chr3:151338222:A:G	0	0	0	0	0	0	0	0
chr3:151745633:G:T	0	0	0	0	0	0	0	0
chr3:151814106:C:T	0	0	0	0	0	0	0	0
chr3:154122077:G:C	0	0	0	0	0	0	0	0
chr3:154122170:CT:TC	0	0	0	0	0	0	0	0
chr3:155596245:A:G	0	0	0	0	0	0	0	0
chr3:155763820:G:A	56	33	92	24	68	2.0	0.0	2.0
chr3:156291825:A:G	0	0	0	0	0	0	0	0
chr3:156979308:G:A	3	2	5	1	4	2	0	2
chr3:157153027:A:G	43	24	69	19	50	2	0	2
chr3:157159014:T:G	1211	699	2451	783	1668	2	1	2
chr3:157265625:T:C	0	0	0	0	0	0	0	0
chr3:157363535:A:G	0	0	0	0	0	0	0	0
chr3:158644652:T:C	264	139	436	132	304	2.0	0.0	2.0
chr3:159840155:G:A	1	0	1	1	0	1	1	0
chr3:159995565:G:A	39	16	58	24	34	1	1	0
chr3:160417640:C:T	37	9	47	29	18	1	1	0
chr3:160430968:C:T	6	2	8	4	4	1.0	1.0	0.0
chr3:161503917:A:C	0	0	0	0	0	0	0	0
chr3:167449398:T:A	1	0	1	1	0	1	1	0
chr3:167467090:T:C	1	0	1	1	0	1	1	0
chr3:167792684:G:A	225	116	358	116	242	2	1	2
chr3:172346301:G:A	0	0	0	0	0	0	0	0
chr3:172381019:G:A	7	3	10	4	6	1	1	0
chr3:172445039:G:A	0	0	0	0	0	0	0	0
chr3:172445047:T:C	0	0	0	0	0	0	0	0
chr3:172448243:G:A	0	0	0	0	0	0	0	0
chr3:172603644:G:T	0	0	0	0	0	0	0	0
chr3:173049032:G:A	0	0	0	0	0	0	0	0
chr3:175096948:G:A	0	0	0	0	0	0	0	0
chr3:175627355:C:G	0	0	0	0	0	0	0	0
chr3:178828238:T:C	0	0	0	0	0	0	0	0
chr3:178842793:A:C	0	0	0	0	0	0	0	0
chr3:179067761:G:A	166	97	268	70	198	2.0	0.0	2.0
chr3:179244582:C:T	18	10	32	8	24	2.0	0.0	2.0
chr3:179333684:A:G	43	21	64	22	42	1	1	0
chr3:183099540:C:G	46	16	66	34	32	1.0	1.0	0.0
chr3:183135882:T:C	2	1	3	1	2	1.5	0.5	1.0
chr3:183180132:A:G	0	0	0	0	0	0	0	0
chr3:183494118:A:G	22	12	34	10	24	2.0	0.0	2.0
chr3:183804151:C:T	17	10	28	8	20	2	0	2
chr3:184036797:C:T	0	0	0	0	0	0	0	0
chr3:184038603:C:G	0	0	0	0	0	0	0	0
chr3:184038849:C:T	0	0	0	0	0	0	0	0
chr3:184165427:G:A	23	5	30	20	10	1	1	0
chr3:184186261:A:G	73	33	111	41	70	1	1	0
chr3:184258315:C:T	40	20	63	21	42	1.5	1.0	1.0
chr3:184302754:G:T	325	153	533	207	326	1	1	0
chr3:184308915:C:T	277	142	451	153	298	2	1	2
chr3:184357259:A:G	2	2	4	0	4	2.0	0.0	2.0
chr3:184366682:C:T	9	6	15	3	12	2	0	2
chr3:184372478:C:T	0	0	0	0	0	0	0	0
chr3:184426858:G:A	0	0	0	0	0	0	0	0
chr3:184711115:T:G	696	298	1072	452	620	1.0	1.0	0.0
chr3:184711626:C:A	731	319	1141	475	666	1	1	0
chr3:184832713:A:G	126	66	202	64	138	2.0	0.5	2.0
chr3:184915459:A:C	7	5	12	2	10	2	0	2
chr3:185052123:C:T	34	26	60	8	52	2.0	0.0	2.0
chr3:185418147:T:C	15	0	15	15	0	1	1	0
chr3:185494805:T:C	4	3	9	1	8	2.0	0.0	2.0
chr3:186048625:C:T	4	1	5	3	2	1.0	1.0	0.0
chr3:186242566:G:A	12	6	18	6	12	1.5	0.5	1.0
chr3:186722454:G:A	0	0	0	0	0	0	0	0
chr3:186725229:T:C	0	0	0	0	0	0	0	0
chr3:186742138:T:C	0	0	0	0	0	0	0	0
chr3:187199963:C:G	0	0	0	0	0	0	0	0
chr3:187236020:C:T	0	0	0	0	0	0	0	0
chr3:189320859:T:C	0	0	0	0	0	0	0	0
chr3:189873035:G:C	6	5	13	1	12	2.0	0.0	2.0
chr3:189973072:T:A	0	0	0	0	0	0	0	0
chr3:189987753:A:G	1	1	2	0	2	2	0	2
chr3:193276754:A:G	0	0	0	0	0	0	0	0
chr3:193454190:T:A	0	0	0	0	0	0	0	0
chr3:193466028:A:G	0	0	0	0	0	0	0	0
chr3:193554628:A:G	0	0	0	0	0	0	0	0
chr3:193644128:G:A	13	6	19	7	12	1	1	0
chr3:194359607:G:A	0	0	0	0	0	0	0	0
chr3:194359919:G:A	0	0	0	0	0	0	0	0
chr3:194359967:G:A	0	0	0	0	0	0	0	0
chr3:194360187:G:A	0	0	0	0	0	0	0	0
chr3:194360254:C:T	0	0	0	0	0	0	0	0
chr3:194360360:C:T	0	0	0	0	0	0	0	0
chr3:194360450:G:A	0	0	0	0	0	0	0	0
chr3:194360663:G:A	0	0	0	0	0	0	0	0
chr3:194360906:T:C	0	0	0	0	0	0	0	0
chr3:194617172:T:C	24	14	38	10	28	2.0	0.0	2.0
chr3:194617694:C:T	3	2	5	1	4	2	0	2
chr3:194648850:CC:AA	26	17	43	9	34	2.0	0.0	2.0
chr3:195726080:G:C	26	14	41	13	28	2.0	0.0	2.0
chr3:195726535:G:C	58	26	85	33	52	1.0	1.0	0.0
chr3:195726541:C:T	59	26	86	34	52	1	1	0
chr3:195729690:C:G	91	45	143	49	94	2	1	0
chr3:195750920:G:A	0	0	0	0	0	0	0	0
chr3:195753282:G:A	0	0	0	0	0	0	0	0
chr3:195762138:C:A	0	0	0	0	0	0	0	0
chr3:195769045:G:C	0	0	0	0	0	0	0	0
chr3:195770303:C:G	0	0	0	0	0	0	0	0
chr3:195778376:G:T	0	0	0	0	0	0	0	0
chr3:195778793:G:A	1	0	1	1	0	1	1	0
chr3:195788723:C:G	0	0	0	0	0	0	0	0
chr3:195789759:G:T	0	0	0	0	0	0	0	0
chr3:195790007:T:C	0	0	0	0	0	0	0	0
chr3:195790387:G:A	1	0	1	1	0	1	1	0
chr3:195790682:A:C	2	0	2	2	0	1.0	1.0	0.0
chr3:195791459:C:G	7	3	10	4	6	1	1	0
chr3:195868761:A:G	0	0	0	0	0	0	0	0
chr3:195985715:C:T	271	89	382	200	182	1	1	0
chr3:196947493:G:A	0	0	0	0	0	0	0	0
chr3:196947878:C:T	0	0	0	0	0	0	0	0
chr3:196948008:A:G	0	0	0	0	0	0	0	0
chr3:196948101:CT:TC	0	0	0	0	0	0	0	0
chr3:197848065:G:C	28	14	44	14	30	1.5	0.5	1.0
chr4:4226555:G:T	0	0	0	0	0	0	0	0
chr4:38827542:A:C	10	5	15	5	10	1.5	0.5	1.0
chr4:38828211:T:C	8	7	17	1	16	2.0	0.0	2.0
chr4:38828391:G:C	12	9	21	3	18	2.0	0.0	2.0
chr4:38878328:G:A	82	55	142	28	114	2.0	0.0	2.0
chr4:38878425:T:C	79	53	137	27	110	2	0	2
chr4:38931483:G:T	35	11	49	27	22	1	1	0
chr4:39115291:T:C	41	27	69	15	54	2	0	2
chr4:39300409:T:C	21	14	35	7	28	2	0	2
chr4:39446909:G:A	1	0	1	1	0	1	1	0
chr4:39446922:C:G	1	0	1	1	0	1	1	0
chr4:39456431:A:G	1460	817	2972	1008	1964	2.0	1.0	2.0
chr4:39457534:G:A	92	44	143	51	92	1.5	1.0	0.0
chr4:39459177:G:A	27	12	41	15	26	1	1	0
chr4:39976385:A:G	20	12	34	10	24	2.0	0.0	2.0
chr4:40102147:G:T	83	32	121	55	66	1	1	0
chr4:40117881:T:C	81	27	108	55	53	1	1	0
chr4:54261281:G:A	0	0	0	0	0	0	0	0
chr4:55424406:T:C	6	3	9	3	6	1.5	0.5	1.0
chr4:55443825:A:G	7	2	11	5	6	1	1	0
chr4:55868535:C:T	51	26	79	25	54	2	0	2
chr4:56314307:C:A	0	0	0	0	0	0	0	0
chr4:56314397:G:C	0	0	0	0	0	0	0	0
chr4:56314450:G:C	0	0	0	0	0	0	0	0
chr4:56315829:C:T	0	0	0	0	0	0	0	0
chr4:56316481:G:A	0	0	0	0	0	0	0	0
chr4:56316592:C:T	0	0	0	0	0	0	0	0
chr4:56324190:G:A	0	0	0	0	0	0	0	0
chr4:56349511:G:A	2	1	3	1	2	1.5	0.5	1.0
chr4:56371517:G:A	13	5	18	8	10	1	1	0
chr4:56530884:A:C	0	0	0	0	0	0	0	0
chr4:56530916:T:C	0	0	0	0	0	0	0	0
chr4:56531030:C:G	0	0	0	0	0	0	0	0
chr4:56931248:C:T	202	88	312	128	184	1.0	1.0	0.0
chr4:56932023:G:A	32	11	43	21	22	1.0	1.0	0.0
chr4:61732971:C:T	0	0	0	0	0	0	0	0
chr4:61934906:A:G	0	0	0	0	0	0	0	0
chr4:67634453:A:G	21	9	30	12	18	1	1	0
chr4:67914681:A:G	0	0	0	0	0	0	0	0
chr4:68670366:A:C	0	0	0	0	0	0	0	0
chr4:68816130:T:C	0	0	0	0	0	0	0	0
chr4:68816218:G:T	0	0	0	0	0	0	0	0
chr4:68830920:A:G	0	0	0	0	0	0	0	0
chr4:68929908:C:T	0	0	0	0	0	0	0	0
chr4:69214120:T:C	0	0	0	0	0	0	0	0
chr4:69280512:G:A	0	0	0	0	0	0	0	0
chr4:69280986:G:A	0	0	0	0	0	0	0	0
chr4:69290595:T:A	0	0	0	0	0	0	0	0
chr4:69290674:A:G	0	0	0	0	0	0	0	0
chr4:69294559:T:G	0	0	0	0	0	0	0	0
chr4:69294591:C:G	0	0	0	0	0	0	0	0
chr4:69727072:G:T	0	0	0	0	0	0	0	0
chr4:70249336:T:A	0	0	0	0	0	0	0	0
chr4:70249343:G:A	0	0	0	0	0	0	0	0
chr4:70389940:A:G	0	0	0	0	0	0	0	0
chr4:70474011:C:T	0	0	0	0	0	0	0	0
chr4:70531272:C:T	0	0	0	0	0	0	0	0
chr4:73076961:C:T	62	28	95	35	60	1.0	1.0	0.0
chr4:73585356:A:G	7	6	15	1	14	2	0	2
chr4:73620528:C:T	15	5	27	15	12	1	1	0
chr4:73998280:T:C	0	0	0	0	0	0	0	0
chr4:74449007:A:C	0	0	0	0	0	0	0	0
chr4:75012761:C:T	0	0	0	0	0	0	0	0
chr4:75012969:G:A	0	0	0	0	0	0	0	0
chr4:75013026:A:G	0	0	0	0	0	0	0	0
chr4:75564135:C:T	1	0	1	1	0	1	1	0
chr4:75724740:C:G	872	447	1498	532	966	2.0	1.0	2.0
chr4:75799732:T:C	82	43	130	42	88	2.0	0.5	2.0
chr4:75884749:C:T	0	0	0	0	0	0	0	0
chr4:75884809:G:A	0	0	0	0	0	0	0	0
chr4:75914984:A:G	122	59	185	65	120	1.0	1.0	0.0
chr4:75957563:G:C	106	47	154	60	94	1.0	1.0	0.0
chr4:76021790:C:G	0	0	0	0	0	0	0	0
chr4:76036018:C:T	0	0	0	0	0	0	0	0
chr4:76213633:C:T	103	52	158	52	106	2	0	2
chr4:76739009:G:C	0	0	0	0	0	0	0	0
chr4:76739578:C:G	0	0	0	0	0	0	0	0
chr4:76896209:T:C	0	0	0	0	0	0	0	0
chr4:78181485:G:A	0	0	0	0	0	0	0	0
chr4:78451776:C:T	0	0	0	0	0	0	0	0
chr4:78466288:C:T	0	0	0	0	0	0	0	0
chr4:78466432:A:G	0	0	0	0	0	0	0	0
chr4:78511301:A:C	0	0	0	0	0	0	0	0
chr4:78516001:C:T	0	0	0	0	0	0	0	0
chr4:78522696:G:A	0	0	0	0	0	0	0	0
chr4:78526609:T:C	0	0	0	0	0	0	0	0
chr4:78610154:C:T	1	0	1	1	0	1	1	0
chr4:78865702:G:A	89	56	150	36	114	2	0	2
chr4:78878926:G:A	39	24	65	15	50	2	0	2
chr4:78911355:A:C	41	28	70	14	56	2	0	2
chr4:78930372:G:C	1	1	2	0	2	2	0	2
chr4:82661058:C:G	0	0	0	0	0	0	0	0
chr4:85722002:A:C	1521	972	3372	919	2453	2	0	2
chr4:85942314:T:A	100	60	164	40	124	2.0	0.0	2.0
chr4:85994695:T:C	106	63	171	45	126	2.0	0.0	2.0
chr4:85994770:G:A	100	59	161	43	118	2.0	0.0	2.0
chr4:86764643:T:G	0	0	0	0	0	0	0	0
chr4:86771240:G:A	0	0	0	0	0	0	0	0
chr4:86848776:T:C	0	0	0	0	0	0	0	0
chr4:86887867:C:G	1	0	1	1	0	1	1	0
chr4:87494484:G:C	0	0	0	0	0	0	0	0
chr4:87662996:C:T	0	0	0	0	0	0	0	0
chr4:87663008:G:A	0	0	0	0	0	0	0	0
chr4:87663355:G:A	0	0	0	0	0	0	0	0
chr4:87811379:T:C	0	0	0	0	0	0	0	0
chr4:87811540:G:A	0	0	0	0	0	0	0	0
chr4:87811594:A:G	0	0	0	0	0	0	0	0
chr4:87811766:A:T	0	0	0	0	0	0	0	0
chr4:87845856:G:A	0	0	0	0	0	0	0	0
chr4:87981540:T:C	0	0	0	0	0	0	0	0
chr4:87982701:C:T	0	0	0	0	0	0	0	0
chr4:88823091:T:C	0	0	0	0	0	0	0	0
chr4:89113535:A:G	0	0	0	0	0	0	0	0
chr4:89248774:A:G	0	0	0	0	0	0	0	0
chr4:94575731:C:T	36	18	54	18	36	1.5	0.5	1.0
chr4:94585691:G:A	23	10	33	13	20	1	1	0
chr4:94666108:A:C	3	2	5	1	4	2	0	2
chr4:95185171:A:G	0	0	0	0	0	0	0	0
chr4:95840105:G:C	0	0	0	0	0	0	0	0
chr4:98472585:T:A	309	175	548	162	386	2	0	2
chr4:98887103:G:A	28	12	40	16	24	1.0	1.0	0.0
chr4:98928975:A:G	68	28	98	40	58	1.0	1.0	0.0
chr4:99131582:C:A	2	0	2	2	0	1.0	1.0	0.0
chr4:99143175:A:T	1	0	1	1	0	1	1	0
chr4:99344976:T:C	0	0	0	0	0	0	0	0
chr4:99420704:C:T	0	0	0	0	0	0	0	0
chr4:99557467:C:T	2	1	3	1	2	1.5	0.5	1.0
chr4:99564098:G:A	2	0	2	2	0	1.0	1.0	0.0
chr4:99583507:T:C	0	0	0	0	0	0	0	0
chr4:99591762:C:G	0	0	0	0	0	0	0	0
chr4:99597126:T:C	0	0	0	0	0	0	0	0
chr4:99612966:G:A	0	0	0	0	0	0	0	0
chr4:99649247:C:T	0	0	0	0	0	0	0	0
chr4:99654241:C:T	0	0	0	0	0	0	0	0
chr4:99654326:G:T	0	0	0	0	0	0	0	0
chr4:101918130:G:A	283	126	431	173	258	1	1	0
chr4:102634835:A:G	30	17	47	13	34	2.0	0.0	2.0
chr4:102690688:C:T	25	13	40	12	28	2	0	2
chr4:102827640:A:G	204	89	315	123	192	1.0	1.0	0.0
chr4:103589806:C:T	0	0	0	0	0	0	0	0
chr4:105275794:A:G	9	3	12	6	6	1	1	0
chr4:105659183:A:G	0	0	0	0	0	0	0	0
chr4:106924041:G:A	0	0	0	0	0	0	0	0
chr4:106925886:C:G	0	0	0	0	0	0	0	0
chr4:107654833:G:A	26	9	35	17	18	1.0	1.0	0.0
chr4:108824180:T:G	0	0	0	0	0	0	0	0
chr4:109315321:A:T	0	0	0	0	0	0	0	0
chr4:109684588:A:T	1245	690	2336	768	1568	2	1	2
chr4:109717654:C:T	178	105	303	77	226	2.0	0.0	2.0
chr4:109760349:C:T	0	0	0	0	0	0	0	0
chr4:109993271:A:T	0	0	0	0	0	0	0	0
chr4:110477052:A:G	0	0	0	0	0	0	0	0
chr4:112430919:A:G	25	11	38	14	24	1	1	0
chr4:112431241:G:A	2	1	3	1	2	1.5	0.5	1.0
chr4:112431743:G:A	0	0	0	0	0	0	0	0
chr4:113358518:C:A	0	0	0	0	0	0	0	0
chr4:113755006:T:G	1033	565	2032	688	1344	2	1	2
chr4:118514975:G:A	0	0	0	0	0	0	0	0
chr4:118523301:G:A	0	0	0	0	0	0	0	0
chr4:118815641:A:C	64	23	90	44	46	1.0	1.0	0.0
chr4:118889025:T:C	0	0	0	0	0	0	0	0
chr4:119023456:G:T	0	0	0	0	0	0	0	0
chr4:119031800:C:T	0	0	0	0	0	0	0	0
chr4:120816612:G:A	0	0	0	0	0	0	0	0
chr4:120816894:T:C	0	0	0	0	0	0	0	0
chr4:121036404:G:A	0	0	0	0	0	0	0	0
chr4:121036936:T:G	0	0	0	0	0	0	0	0
chr4:121037032:A:G	0	0	0	0	0	0	0	0
chr4:121037536:T:C	0	0	0	0	0	0	0	0
chr4:121037542:G:A	0	0	0	0	0	0	0	0
chr4:121696590:G:A	1200	623	2311	878	1433	2.0	1.0	2.0
chr4:121902897:C:T	0	0	0	0	0	0	0	0
chr4:122077926:G:A	0	0	0	0	0	0	0	0
chr4:122743302:C:T	1	0	1	1	0	1	1	0
chr4:124670532:A:G	0	0	0	0	0	0	0	0
chr4:124670910:C:A	0	0	0	0	0	0	0	0
chr4:124671285:T:C	0	0	0	0	0	0	0	0
chr4:125317769:A:T	0	0	0	0	0	0	0	0
chr4:125318831:C:T	0	0	0	0	0	0	0	0
chr4:125319355:T:C	0	0	0	0	0	0	0	0
chr4:125320716:C:T	0	0	0	0	0	0	0	0
chr4:125451587:G:A	0	0	0	0	0	0	0	0
chr4:128946125:T:A	22	13	40	12	28	2.0	0.0	2.0
chr4:129109489:C:T	103	48	160	62	98	1	1	0
chr4:133152903:A:G	0	0	0	0	0	0	0	0
chr4:138561804:G:T	0	0	0	0	0	0	0	0
chr4:139889483:C:T	0	0	0	0	0	0	0	0
chr4:139889546:C:T	0	0	0	0	0	0	0	0
chr4:139889981:T:C	0	0	0	0	0	0	0	0
chr4:140670704:G:T	2	1	3	1	2	1.5	0.5	1.0
chr4:140676972:C:T	20	9	32	12	20	1.5	1.0	0.0
chr4:140679166:A:G	64	36	111	29	82	2.0	0.0	2.0
chr4:143214565:G:A	24	10	35	15	20	1.0	1.0	0.0
chr4:143521458:T:C	1108	623	2041	644	1397	2.0	1.0	2.0
chr4:143521582:C:T	739	410	1285	397	888	2	1	2
chr4:143911627:C:T	17	17	36	0	36	2	0	2
chr4:145097258:A:G	44	26	70	18	52	2.0	0.0	2.0
chr4:146867557:C:T	0	0	0	0	0	0	0	0
chr4:148081258:A:G	1	1	2	0	2	2	0	2
chr4:148436862:G:C	8	4	11	4	7	1.0	0.5	0.5
chr4:150277928:G:A	30	17	47	13	34	2.0	0.0	2.0
chr4:150285975:C:T	14	6	20	8	12	1.0	1.0	0.0
chr4:151279901:G:A	0	0	0	0	0	0	0	0
chr4:151291334:C:T	0	0	0	0	0	0	0	0
chr4:151671039:T:C	34	14	52	20	32	1.0	1.0	0.0
chr4:152975206:C:T	0	0	0	0	0	0	0	0
chr4:152976618:G:A	0	0	0	0	0	0	0	0
chr4:153257545:A:G	2	1	3	1	2	1.5	0.5	1.0
chr4:153704257:T:C	3	3	6	0	6	2	0	2
chr4:153748581:G:A	1	1	1	0	1	1	0	1
chr4:154298510:G:C	0	0	0	0	0	0	0	0
chr4:154489670:G:A	0	0	0	0	0	0	0	0
chr4:154489757:A:G	0	0	0	0	0	0	0	0
chr4:154489913:T:C	0	0	0	0	0	0	0	0
chr4:154490497:G:A	0	0	0	0	0	0	0	0
chr4:154490787:A:C	0	0	0	0	0	0	0	0
chr4:154491312:C:T	0	0	0	0	0	0	0	0
chr4:154567669:C:T	0	0	0	0	0	0	0	0
chr4:154569680:C:T	0	0	0	0	0	0	0	0
chr4:154799122:T:C	0	0	0	0	0	0	0	0
chr4:155214875:C:T	0	0	0	0	0	0	0	0
chr4:155352616:T:C	13	5	18	8	10	1	1	0
chr4:155711239:A:G	2	0	2	2	0	1.0	1.0	0.0
chr4:155918200:G:A	2	1	3	1	2	1.5	0.5	1.0
chr4:156763096:T:C	0	0	0	0	0	0	0	0
chr4:157221623:G:A	0	0	0	0	0	0	0	0
chr4:158709665:T:C	153	80	250	84	166	2	1	2
chr4:158723342:G:C	474	252	792	260	532	2.0	1.0	2.0
chr4:158723349:C:T	473	257	795	253	542	2	1	2
chr4:163519429:T:C	293	154	483	151	332	2	0	2
chr4:163545672:C:T	544	267	881	321	560	2.0	1.0	0.0
chr4:164879002:T:C	0	0	0	0	0	0	0	0
chr4:165100659:G:C	84	49	140	36	104	2.0	0.0	2.0
chr4:165278611:A:C	27	22	55	7	48	2	0	2
chr4:165310716:A:G	29	12	42	18	24	1	1	0
chr4:166078012:T:C	0	0	0	0	0	0	0	0
chr4:166091229:G:A	0	0	0	0	0	0	0	0
chr4:168378377:T:C	13	7	20	6	14	2	0	2
chr4:168406040:C:T	21	9	30	12	18	1	1	0
chr4:168511522:C:T	0	0	0	0	0	0	0	0
chr4:168511690:G:A	0	0	0	0	0	0	0	0
chr4:168512293:C:T	0	0	0	0	0	0	0	0
chr4:169010117:G:A	252	132	400	130	270	2.0	1.0	2.0
chr4:169010123:G:A	252	132	400	130	270	2.0	1.0	2.0
chr4:169010137:T:C	244	125	377	128	249	1.0	1.0	1.0
chr4:176192628:T:C	0	0	0	0	0	0	0	0
chr4:176327295:A:T	12	6	18	6	12	1.5	0.5	1.0
chr4:182680694:T:C	0	0	0	0	0	0	0	0
chr4:182799697:C:T	0	0	0	0	0	0	0	0
chr4:182894535:A:G	214	106	339	119	220	2.0	1.0	0.0
chr4:183282733:G:C	0	0	0	0	0	0	0	0
chr4:183289496:G:T	0	0	0	0	0	0	0	0
chr4:183321806:C:G	0	0	0	0	0	0	0	0
chr4:183697783:G:C	6	2	10	4	6	1.0	1.0	0.0
chr4:184009493:G:A	0	0	0	0	0	0	0	0
chr4:184010935:C:T	0	0	0	0	0	0	0	0
chr4:184091245:T:C	0	0	0	0	0	0	0	0
chr4:184389064:C:T	91	38	129	55	74	1	1	0
chr4:185373044:C:T	8	3	11	5	6	1.0	1.0	0.0
chr4:185458745:G:C	0	0	0	0	0	0	0	0
chr4:185459361:G:A	0	0	0	0	0	0	0	0
chr4:185459692:A:T	0	0	0	0	0	0	0	0
chr4:185459961:G:T	0	0	0	0	0	0	0	0
chr4:185460011:G:A	0	0	0	0	0	0	0	0
chr4:185587569:G:T	1	0	1	1	0	1	1	0
chr4:186076613:C:A	0	0	0	0	0	0	0	0
chr4:186153679:A:G	0	0	0	0	0	0	0	0
chr4:186156052:A:G	0	0	0	0	0	0	0	0
chr4:186157631:A:G	0	0	0	0	0	0	0	0
chr4:186157665:C:G	0	0	0	0	0	0	0	0
chr4:186201165:T:G	71	28	103	45	58	1	1	0
chr4:186251858:T:G	0	0	0	0	0	0	0	0
chr4:186597717:G:A	0	0	0	0	0	0	0	0
chr4:186706638:T:C	0	0	0	0	0	0	0	0
chr4:186706900:C:G	0	0	0	0	0	0	0	0
chr4:186707244:C:G	0	0	0	0	0	0	0	0
chr4:186707986:G:C	0	0	0	0	0	0	0	0
chr4:186709436:G:A	0	0	0	0	0	0	0	0
chr4:186709443:C:G	0	0	0	0	0	0	0	0
chr4:186709835:C:A	0	0	0	0	0	0	0	0
chr4:188139456:G:C	0	0	0	0	0	0	0	0
chr4:188139952:G:A	0	0	0	0	0	0	0	0
chr4:188143798:C:G	0	0	0	0	0	0	0	0
chr4:188738623:G:A	0	0	0	0	0	0	0	0
chr4:188739132:G:A	0	0	0	0	0	0	0	0
chr4:188739306:G:C	0	0	0	0	0	0	0	0
chr4:189955040:C:T	585	272	979	379	600	2	1	0
chr4:189984870:G:A	0	0	0	0	0	0	0	0
chr5:163090:G:C	5	0	6	6	0	1	1	0
chr5:163151:C:G	5	5	11	0	11	2	0	2
chr5:172903:T:C	0	0	0	0	0	0	0	0
chr5:173991:G:A	0	0	0	0	0	0	0	0
chr5:181615:C:G	1	1	2	0	2	2	0	2
chr5:181647:A:G	1	1	2	0	2	2	0	2
chr5:195392:C:T	0	0	0	0	0	0	0	0
chr5:223531:A:T	487	263	818	257	561	2	1	2
chr5:225653:G:C	36	23	61	13	48	2.0	0.0	2.0
chr5:230996:T:C	223	96	341	139	202	1	1	0
chr5:233550:C:T	235	98	351	149	202	1	1	0
chr5:311363:T:C	1297	769	2546	810	1736	2	1	2
chr5:422637:T:C	0	0	0	0	0	0	0	0
chr5:432941:G:T	1	0	1	1	0	1	1	0
chr5:434866:G:C	2	1	3	1	2	1.5	0.5	1.0
chr5:453468:C:T	92	81	185	11	174	2.0	0.0	2.0
chr5:457105:G:A	4	3	7	1	6	2.0	0.0	2.0
chr5:462408:G:A	22	14	36	8	28	2.0	0.0	2.0
chr5:476238:C:T	2	1	3	1	2	1.5	0.5	1.0
chr5:479790:A:C	7	3	10	4	6	1	1	0
chr5:482623:A:G	0	0	0	0	0	0	0	0
chr5:640590:A:G	7	4	11	3	8	2	0	2
chr5:653228:T:C	17	7	27	11	16	1	1	0
chr5:665165:T:C	0	0	0	0	0	0	0	0
chr5:677947:A:G	1	0	1	1	0	1	1	0
chr5:745191:A:C	0	0	0	0	0	0	0	0
chr5:748479:T:C	0	0	0	0	0	0	0	0
chr5:748506:C:G	0	0	0	0	0	0	0	0
chr5:769977:G:A	0	0	0	0	0	0	0	0
chr5:825171:G:T	2	0	2	2	0	1.0	1.0	0.0
chr5:825182:A:G	2	0	2	2	0	1.0	1.0	0.0
chr5:840391:C:T	1	0	1	1	0	1	1	0
chr5:842324:G:A	2	0	3	3	0	1.5	1.5	0.0
chr5:878410:T:A	18	0	18	18	0	1.0	1.0	0.0
chr5:1052245:C:T	0	0	0	0	0	0	0	0
chr5:1057500:A:G	0	0	0	0	0	0	0	0
chr5:1063883:G:A	0	0	0	0	0	0	0	0
chr5:1065284:C:T	0	0	0	0	0	0	0	0
chr5:1076130:G:A	0	0	0	0	0	0	0	0
chr5:1081587:A:G	0	0	0	0	0	0	0	0
chr5:1081652:C:T	0	0	0	0	0	0	0	0
chr5:1216785:G:A	0	0	0	0	0	0	0	0
chr5:1225498:G:A	0	0	0	0	0	0	0	0
chr5:1225511:T:A	0	0	0	0	0	0	0	0
chr5:1240642:C:G	0	0	0	0	0	0	0	0
chr5:1293971:C:T	0	0	0	0	0	0	0	0
chr5:1325652:A:G	1	1	2	0	2	2	0	2
chr5:1325688:A:G	1	1	2	0	2	2	0	2
chr5:1443084:G:A	0	0	0	0	0	0	0	0
chr5:1466804:G:A	16	6	22	10	12	1.0	1.0	0.0
chr5:1466889:A:G	15	9	24	6	18	2	0	2
chr5:1479563:G:C	10	5	15	5	10	1.5	0.5	1.0
chr5:1589272:C:G	81	27	112	54	58	1	1	0
chr5:1593151:T:C	85	25	114	60	54	1	1	0
chr5:1593211:G:A	85	25	114	60	54	1	1	0
chr5:1880777:C:T	0	0	0	0	0	0	0	0
chr5:5146264:T:C	0	0	0	0	0	0	0	0
chr5:5146282:A:G	0	0	0	0	0	0	0	0
chr5:5182173:C:T	0	0	0	0	0	0	0	0
chr5:5462035:G:A	27	13	43	15	28	1	1	0
chr5:6372472:A:G	1532	872	2897	958	1939	2.0	1.0	2.0
chr5:6491384:T:C	0	0	0	0	0	0	0	0
chr5:6604092:A:G	5	3	8	2	6	2	0	2
chr5:6604674:C:T	27	15	42	12	30	2	0	2
chr5:6632929:C:T	197	93	296	108	188	1	1	0
chr5:6748546:T:C	5	2	7	3	4	1	1	0
chr5:7520768:G:T	0	0	0	0	0	0	0	0
chr5:7690641:C:T	0	0	0	0	0	0	0	0
chr5:7743674:C:T	0	0	0	0	0	0	0	0
chr5:7802250:C:T	0	0	0	0	0	0	0	0
chr5:7859410:A:G	54	24	83	31	52	1.0	1.0	0.0
chr5:7878066:C:T	131	65	204	70	134	2	1	0
chr5:7878079:T:C	131	69	207	67	140	2	0	2
chr5:7885846:A:G	59	33	95	27	68	2	0	2
chr5:7892960:T:G	91	44	140	50	90	1	1	0
chr5:7897170:G:A	59	31	90	28	62	2	0	2
chr5:7897206:G:A	59	27	86	32	54	1	1	0
chr5:9154547:G:C	0	0	0	0	0	0	0	0
chr5:10256049:T:C	689	405	1317	393	924	2	1	2
chr5:10264850:A:G	420	259	769	200	569	2.0	0.0	2.0
chr5:10638068:T:C	0	0	0	0	0	0	0	0
chr5:10649672:G:A	0	0	0	0	0	0	0	0
chr5:11397076:C:T	0	0	0	0	0	0	0	0
chr5:13701416:T:C	0	0	0	0	0	0	0	0
chr5:13701427:T:C	0	0	0	0	0	0	0	0
chr5:13829690:G:A	0	0	0	0	0	0	0	0
chr5:13844936:G:A	0	0	0	0	0	0	0	0
chr5:13864619:C:A	0	0	0	0	0	0	0	0
chr5:13865871:T:C	0	0	0	0	0	0	0	0
chr5:13913776:A:G	0	0	0	0	0	0	0	0
chr5:13931231:C:T	0	0	0	0	0	0	0	0
chr5:14368866:C:T	0	0	0	0	0	0	0	0
chr5:14397129:T:C	1	0	1	1	0	1	1	0
chr5:14419918:A:C	0	0	0	0	0	0	0	0
chr5:14498618:G:A	0	0	0	0	0	0	0	0
chr5:14711166:T:C	12	7	19	5	14	2.0	0.0	2.0
chr5:14741812:A:C	0	0	0	0	0	0	0	0
chr5:16673866:C:G	0	0	0	0	0	0	0	0
chr5:16681857:G:A	0	0	0	0	0	0	0	0
chr5:17491550:A:G	0	0	0	0	0	0	0	0
chr5:21842327:A:G	0	0	0	0	0	0	0	0
chr5:24170521:A:G	0	0	0	0	0	0	0	0
chr5:25910820:G:A	0	0	0	0	0	0	0	0
chr5:26988221:G:A	0	0	0	0	0	0	0	0
chr5:28926929:A:G	0	0	0	0	0	0	0	0
chr5:31302181:C:T	0	0	0	0	0	0	0	0
chr5:31317845:T:C	0	0	0	0	0	0	0	0
chr5:32074286:G:A	0	0	0	0	0	0	0	0
chr5:32074356:G:A	0	0	0	0	0	0	0	0
chr5:32087696:A:G	1	0	1	1	0	1	1	0
chr5:32087702:G:C	1	0	1	1	0	1	1	0
chr5:32090188:G:A	0	0	0	0	0	0	0	0
chr5:32523178:T:C	0	0	0	0	0	0	0	0
chr5:33988430:C:T	9	7	16	2	14	2	0	2
chr5:33998663:C:A	35	14	50	22	28	1	1	0
chr5:34004602:C:T	24	16	42	8	34	2.0	0.0	2.0
chr5:34007995:C:T	33	18	53	15	38	2	0	2
chr5:34840736:A:G	0	0	0	0	0	0	0	0
chr5:34998673:C:A	0	0	0	0	0	0	0	0
chr5:34998772:C:A	0	0	0	0	0	0	0	0
chr5:35644519:T:C	1	0	1	1	0	1	1	0
chr5:35654609:C:T	1	1	2	0	2	2	0	2
chr5:35874473:C:T	6	5	32	7	25	4.0	1.5	2.0
chr5:35876172:A:G	6	5	20	6	14	2.5	0.5	2.0
chr5:35904481:G:C	0	0	0	0	0	0	0	0
chr5:35904512:G:T	0	0	0	0	0	0	0	0
chr5:35955580:C:G	0	0	0	0	0	0	0	0
chr5:36686302:G:A	0	0	0	0	0	0	0	0
chr5:37875317:G:A	0	0	0	0	0	0	0	0
chr5:37875668:T:A	0	0	0	0	0	0	0	0
chr5:38370435:T:C	0	0	0	0	0	0	0	0
chr5:38955694:G:A	13	7	20	6	14	2	0	2
chr5:40841639:C:T	95	0	102	102	0	1	1	0
chr5:40998094:T:C	0	0	0	0	0	0	0	0
chr5:40999798:T:A	0	0	0	0	0	0	0	0
chr5:41008678:A:G	0	0	0	0	0	0	0	0
chr5:41018696:A:G	0	0	0	0	0	0	0	0
chr5:41048286:T:G	0	0	0	0	0	0	0	0
chr5:41049378:T:A	0	0	0	0	0	0	0	0
chr5:43039691:T:C	381	192	672	228	444	2	1	2
chr5:43245820:C:T	0	0	0	0	0	0	0	0
chr5:44809060:G:C	569	291	952	317	635	2	1	2
chr5:50633368:G:A	0	0	0	0	0	0	0	0
chr5:52801055:C:A	48	24	74	24	50	1.5	0.5	1.0
chr5:53055583:G:A	0	0	0	0	0	0	0	0
chr5:53560674:G:C	892	468	1642	554	1088	2.0	1.0	2.0
chr5:53683267:G:A	743	394	1364	458	906	2	1	2
chr5:55124971:A:C	0	0	0	0	0	0	0	0
chr5:55143638:G:A	0	0	0	0	0	0	0	0
chr5:55307994:T:C	813	469	1476	440	1036	2	0	2
chr5:55785866:A:G	0	0	0	0	0	0	0	0
chr5:55786646:C:T	0	0	0	0	0	0	0	0
chr5:56504851:G:C	0	0	0	0	0	0	0	0
chr5:56504897:C:T	1	0	1	1	0	1	1	0
chr5:56882390:A:C	107	45	162	66	96	1	1	0
chr5:57230956:G:A	779	402	1329	457	872	2	1	2
chr5:60898280:G:T	51	25	79	27	52	1	1	0
chr5:61544080:C:A	24	10	34	14	20	1.0	1.0	0.0
chr5:61703941:C:T	0	0	0	0	0	0	0	0
chr5:64369621:G:A	0	0	0	0	0	0	0	0
chr5:65563283:T:A	26	10	40	16	24	1.0	1.0	0.0
chr5:66054546:A:G	50	22	75	29	46	1.0	1.0	0.0
chr5:66163945:T:C	66	31	99	35	64	1.0	1.0	0.0
chr5:68273514:T:C	2	0	2	2	0	1.0	1.0	0.0
chr5:69121816:C:T	14	12	30	2	28	2.0	0.0	2.0
chr5:69123227:A:T	18	10	32	8	24	2.0	0.0	2.0
chr5:69250764:C:G	1	1	2	0	2	2	0	2
chr5:72195135:A:G	0	0	0	0	0	0	0	0
chr5:72199214:T:C	0	0	0	0	0	0	0	0
chr5:73123440:T:C	0	0	0	0	0	0	0	0
chr5:73776529:T:C	0	0	0	0	0	0	0	0
chr5:73780686:C:A	0	0	0	0	0	0	0	0
chr5:73852656:G:A	0	0	0	0	0	0	0	0
chr5:73893320:G:A	0	0	0	0	0	0	0	0
chr5:73901360:A:C	0	0	0	0	0	0	0	0
chr5:73911547:T:A	0	0	0	0	0	0	0	0
chr5:73940914:G:A	0	0	0	0	0	0	0	0
chr5:74634926:C:T	35	14	51	21	30	1	1	0
chr5:74636490:T:C	31	14	45	17	28	1	1	0
chr5:74685445:T:C	93	53	148	42	106	2	0	2
chr5:74750639:C:T	33	16	51	19	32	2	1	0
chr5:74767329:C:G	2262	1277	5538	2094	3444	2.0	1.0	2.0
chr5:75028626:C:T	0	0	0	0	0	0	0	0
chr5:75685342:G:A	32	18	50	14	36	2.0	0.0	2.0
chr5:76131693:C:T	0	0	0	0	0	0	0	0
chr5:76132110:G:A	0	0	0	0	0	0	0	0
chr5:76173715:T:G	2	0	2	2	0	1.0	1.0	0.0
chr5:76295885:C:G	0	0	0	0	0	0	0	0
chr5:76298918:G:A	0	0	0	0	0	0	0	0
chr5:76677241:A:G	1	1	2	0	2	2	0	2
chr5:76819138:C:T	0	0	0	0	0	0	0	0
chr5:76953678:G:A	2	0	2	2	0	1.0	1.0	0.0
chr5:77063199:C:A	60	27	90	34	56	1.0	1.0	0.0
chr5:77433193:C:T	101	70	178	32	146	2	0	2
chr5:78885600:C:T	11	3	15	9	6	1	1	0
chr5:79077608:C:T	1	0	1	1	0	1	1	0
chr5:79115999:C:G	0	0	0	0	0	0	0	0
chr5:79126136:G:A	0	0	0	0	0	0	0	0
chr5:79277967:A:T	132	62	197	73	124	1.0	1.0	0.0
chr5:79300221:T:C	64	32	102	34	68	2.0	0.5	1.0
chr5:79799594:C:T	0	0	0	0	0	0	0	0
chr5:80055912:C:T	0	0	0	0	0	0	0	0
chr5:80065442:G:C	48	29	79	19	60	2.0	0.0	2.0
chr5:80321117:A:C	0	0	0	0	0	0	0	0
chr5:80321538:T:C	0	0	0	0	0	0	0	0
chr5:80332388:T:A	0	0	0	0	0	0	0	0
chr5:80351866:A:C	3	3	6	0	6	2	0	2
chr5:80559553:A:G	0	0	0	0	0	0	0	0
chr5:81359890:T:C	0	0	0	0	0	0	0	0
chr5:83538480:G:A	0	0	0	0	0	0	0	0
chr5:83539726:A:G	0	0	0	0	0	0	0	0
chr5:83539905:T:A	0	0	0	0	0	0	0	0
chr5:83541812:G:T	0	0	0	0	0	0	0	0
chr5:90473830:G:A	10	4	14	6	8	1.0	1.0	0.0
chr5:90519291:G:T	94	49	148	49	99	2.0	0.0	2.0
chr5:90525167:T:C	408	215	677	217	460	2.0	1.0	2.0
chr5:90647616:A:G	0	0	0	0	0	0	0	0
chr5:90675436:G:A	0	0	0	0	0	0	0	0
chr5:90692687:A:G	0	0	0	0	0	0	0	0
chr5:90693962:G:A	0	0	0	0	0	0	0	0
chr5:90705420:G:A	0	0	0	0	0	0	0	0
chr5:90705551:T:G	0	0	0	0	0	0	0	0
chr5:93824265:T:C	62	30	96	34	62	2.0	1.0	0.0
chr5:94417312:C:T	1	1	2	0	2	2	0	2
chr5:94942425:T:C	0	0	0	0	0	0	0	0
chr5:95414019:G:A	4	4	8	0	8	2.0	0.0	2.0
chr5:95490951:C:A	62	29	95	33	62	1.0	1.0	0.0
chr5:95816609:A:G	25	14	54	14	40	2	1	2
chr5:96397408:A:G	0	0	0	0	0	0	0	0
chr5:96742605:G:A	12	7	19	5	14	2.0	0.0	2.0
chr5:96742633:C:G	11	6	17	5	12	2	0	2
chr5:96781851:C:T	64	26	91	39	52	1.0	1.0	0.0
chr5:96783162:C:T	60	33	98	28	70	2.0	0.0	2.0
chr5:96785820:C:T	39	22	65	17	48	2	0	2
chr5:96793832:T:C	45	13	58	32	26	1	1	0
chr5:96879976:C:T	94	41	141	55	86	1.0	1.0	0.0
chr5:97095012:C:G	0	0	0	0	0	0	0	0
chr5:97163079:G:A	116	50	184	76	108	1.0	1.0	0.0
chr5:97167674:T:C	112	53	178	62	116	1.0	1.0	0.0
chr5:97167819:C:T	102	52	162	54	108	2.0	1.0	2.0
chr5:97179013:C:G	100	46	155	59	96	1.5	1.0	0.0
chr5:97183223:C:G	204	109	334	106	228	2.0	1.0	2.0
chr5:102296086:T:G	1	1	2	0	2	2	0	2
chr5:102480400:G:A	0	0	0	0	0	0	0	0
chr5:102974462:G:A	0	0	0	0	0	0	0	0
chr5:103009842:A:C	0	0	0	0	0	0	0	0
chr5:103097705:G:A	24	13	37	11	26	2.0	0.0	2.0
chr5:103550811:T:C	2	0	2	2	0	1.0	1.0	0.0
chr5:109052346:T:G	17	8	25	9	16	1	1	0
chr5:109337245:C:T	27	12	39	15	24	1	1	0
chr5:109378597:T:C	525	278	874	288	586	2	1	2
chr5:109774836:T:A	31	10	41	21	20	1	1	0
chr5:109774890:G:A	35	22	57	13	44	2	0	2
chr5:109867006:T:G	62	30	96	35	61	2.0	1.0	0.0
chr5:111071809:C:T	0	0	0	0	0	0	0	0
chr5:111073369:C:G	0	0	0	0	0	0	0	0
chr5:111103810:A:G	115	46	170	72	98	1	1	0
chr5:111121006:A:T	30	12	43	19	24	1.0	1.0	0.0
chr5:111482723:C:T	0	0	0	0	0	0	0	0
chr5:111484055:G:C	0	0	0	0	0	0	0	0
chr5:112184043:T:C	1	0	1	1	0	1	1	0
chr5:112194587:A:G	1	0	1	1	0	1	1	0
chr5:112209973:C:G	1	0	1	1	0	1	1	0
chr5:112707687:T:G	263	144	437	129	308	2	0	2
chr5:112861252:A:C	0	0	0	0	0	0	0	0
chr5:112922211:T:C	1310	814	2638	761	1877	2.0	1.0	2.0
chr5:113013373:T:C	45	23	70	24	46	2	0	2
chr5:113043592:G:A	0	0	0	0	0	0	0	0
chr5:113553677:G:A	47	29	77	19	58	2	0	2
chr5:113563876:T:C	32	13	45	19	26	1.0	1.0	0.0
chr5:113564005:A:G	43	21	64	22	42	1	1	0
chr5:113581581:T:G	8	3	11	5	6	1.0	1.0	0.0
chr5:113584244:G:A	18	11	29	7	22	2.0	0.0	2.0
chr5:114362847:G:C	0	0	0	0	0	0	0	0
chr5:115841317:T:C	352	195	596	179	417	2.0	0.0	2.0
chr5:116134076:C:T	478	238	776	270	506	2.0	1.0	0.0
chr5:119164569:A:G	57	28	86	30	56	1	1	0
chr5:119452501:C:G	199	129	352	80	272	2	0	2
chr5:122182614:G:A	0	0	0	0	0	0	0	0
chr5:122827706:T:C	3	1	4	2	2	1	1	0
chr5:123025822:C:T	0	0	0	0	0	0	0	0
chr5:123350033:C:G	18	10	28	8	20	2.0	0.0	2.0
chr5:124649070:C:T	14	14	28	0	28	2.0	0.0	2.0
chr5:128278780:A:G	0	0	0	0	0	0	0	0
chr5:128303067:A:G	0	0	0	0	0	0	0	0
chr5:128349443:C:T	0	0	0	0	0	0	0	0
chr5:129095064:T:C	161	85	250	78	172	2	0	2
chr5:129704363:A:T	0	0	0	0	0	0	0	0
chr5:131974984:G:T	0	0	0	0	0	0	0	0
chr5:132486973:G:C	842	426	1771	681	1090	2.0	1.0	2.0
chr5:132579521:G:A	66	22	90	46	44	1.0	1.0	0.0
chr5:132660272:A:G	1	0	1	1	0	1	1	0
chr5:132764307:A:G	5	0	5	5	0	1	1	0
chr5:133224258:T:G	0	0	0	0	0	0	0	0
chr5:134411663:C:G	430	225	707	227	480	2.0	1.0	2.0
chr5:135008109:A:G	2	1	3	1	2	1.5	0.5	1.0
chr5:135028828:C:G	1	1	2	0	2	2	0	2
chr5:135029306:G:T	1	0	1	1	0	1	1	0
chr5:135446302:G:A	0	0	0	0	0	0	0	0
chr5:135446323:G:A	0	0	0	0	0	0	0	0
chr5:135446724:G:T	0	0	0	0	0	0	0	0
chr5:135446760:T:A	0	0	0	0	0	0	0	0
chr5:135446820:T:C	0	0	0	0	0	0	0	0
chr5:135446886:T:G	0	0	0	0	0	0	0	0
chr5:135871693:C:T	0	0	0	0	0	0	0	0
chr5:135941012:T:C	0	0	0	0	0	0	0	0
chr5:135941158:T:C	0	0	0	0	0	0	0	0
chr5:136357055:C:A	0	0	0	0	0	0	0	0
chr5:137625877:C:A	2	1	3	1	2	1.5	0.5	1.0
chr5:138091079:C:T	0	0	0	0	0	0	0	0
chr5:138181815:C:T	1	0	1	1	0	1	1	0
chr5:138930857:G:A	99	38	141	63	78	1	1	0
chr5:139121126:T:C	244	135	398	120	278	2.0	0.0	2.0
chr5:139379813:C:T	4	3	7	1	6	2.0	0.0	2.0
chr5:139387719:G:A	1924	1149	4806	1664	3142	2.0	1.0	2.0
chr5:139392844:C:T	8	5	13	3	10	2.0	0.0	2.0
chr5:139396890:C:T	18	5	25	15	10	1.0	1.0	0.0
chr5:139478334:T:C	49	25	75	25	50	2	1	2
chr5:139481561:C:G	55	22	78	34	44	1	1	0
chr5:140342760:G:A	2	2	4	0	4	2.0	0.0	2.0
chr5:140507980:T:C	111	54	173	59	114	1	1	0
chr5:140557175:G:T	1001	617	1923	526	1397	2	0	2
chr5:140557395:A:G	371	200	603	181	422	2	0	2
chr5:140557561:G:A	10	4	14	6	8	1.0	1.0	0.0
chr5:140558652:C:T	24	8	35	17	18	1.0	1.0	0.0
chr5:140560648:G:A	20	9	33	11	22	1.0	1.0	0.0
chr5:140561643:A:G	13	7	22	6	16	2	0	2
chr5:140561733:A:G	6	5	13	1	12	2.0	0.0	2.0
chr5:140644847:C:T	10	6	16	4	12	2.0	0.0	2.0
chr5:140647631:T:C	952	461	1784	680	1104	2.0	1.0	0.0
chr5:140647863:C:T	1440	841	2896	865	2031	2.0	1.0	2.0
chr5:140662375:T:G	607	368	1056	286	770	2	0	2
chr5:140668624:T:C	161	92	262	70	192	2	0	2
chr5:140787635:A:C	0	0	0	0	0	0	0	0
chr5:140787878:C:T	0	0	0	0	0	0	0	0
chr5:140788485:A:G	0	0	0	0	0	0	0	0
chr5:140788566:G:T	0	0	0	0	0	0	0	0
chr5:140795037:G:A	0	0	0	0	0	0	0	0
chr5:140795280:G:C	0	0	0	0	0	0	0	0
chr5:140802063:T:C	0	0	0	0	0	0	0	0
chr5:140802149:A:G	0	0	0	0	0	0	0	0
chr5:140802307:T:C	0	0	0	0	0	0	0	0
chr5:140802516:G:T	0	0	0	0	0	0	0	0
chr5:140803473:G:A	0	0	0	0	0	0	0	0
chr5:140807517:A:G	0	0	0	0	0	0	0	0
chr5:140807737:C:T	0	0	0	0	0	0	0	0
chr5:140808798:T:G	0	0	0	0	0	0	0	0
chr5:140808816:A:G	0	0	0	0	0	0	0	0
chr5:140808990:G:C	0	0	0	0	0	0	0	0
chr5:140821835:T:C	0	0	0	0	0	0	0	0
chr5:140823847:C:T	0	0	0	0	0	0	0	0
chr5:140829882:T:G	0	0	0	0	0	0	0	0
chr5:140834796:G:A	0	0	0	0	0	0	0	0
chr5:140835410:G:A	0	0	0	0	0	0	0	0
chr5:140842572:A:C	0	0	0	0	0	0	0	0
chr5:140843056:A:G	0	0	0	0	0	0	0	0
chr5:140870510:A:G	0	0	0	0	0	0	0	0
chr5:140877403:G:A	0	0	0	0	0	0	0	0
chr5:140883904:G:A	0	0	0	0	0	0	0	0
chr5:141053041:C:T	0	0	0	0	0	0	0	0
chr5:141096338:C:A	0	0	0	0	0	0	0	0
chr5:141135901:T:C	0	0	0	0	0	0	0	0
chr5:141187351:A:G	0	0	0	0	0	0	0	0
chr5:141210476:C:T	0	0	0	0	0	0	0	0
chr5:141303190:C:T	9	3	12	6	6	1	1	0
chr5:141303698:A:G	7	3	10	4	6	1	1	0
chr5:141339523:G:A	0	0	0	0	0	0	0	0
chr5:141340949:C:G	2	1	3	1	2	1.5	0.5	1.0
chr5:141341387:T:C	2	1	3	1	2	1.5	0.5	1.0
chr5:141344268:C:T	0	0	0	0	0	0	0	0
chr5:141360307:G:A	0	0	0	0	0	0	0	0
chr5:141395122:T:C	1	0	1	1	0	1	1	0
chr5:141422997:C:T	0	0	0	0	0	0	0	0
chr5:141863068:C:G	0	0	0	0	0	0	0	0
chr5:141864081:A:G	0	0	0	0	0	0	0	0
chr5:141869398:T:G	0	0	0	0	0	0	0	0
chr5:141957660:A:G	0	0	0	0	0	0	0	0
chr5:142875114:A:G	2	0	2	2	0	1.0	1.0	0.0
chr5:143041850:T:G	1	1	2	0	2	2	0	2
chr5:145866522:T:G	0	0	0	0	0	0	0	0
chr5:145873011:C:T	0	0	0	0	0	0	0	0
chr5:146013801:C:T	0	0	0	0	0	0	0	0
chr5:146062640:G:C	0	0	0	0	0	0	0	0
chr5:146478447:A:G	20	8	29	13	16	1.0	1.0	0.0
chr5:147824629:G:A	0	0	0	0	0	0	0	0
chr5:147906491:G:A	0	0	0	0	0	0	0	0
chr5:148088671:C:G	0	0	0	0	0	0	0	0
chr5:148089408:G:C	0	0	0	0	0	0	0	0
chr5:148107114:C:A	0	0	0	0	0	0	0	0
chr5:148826785:C:T	55	24	82	32	50	1	1	0
chr5:148826812:C:T	55	24	82	32	50	1	1	0
chr5:148826877:G:A	56	24	83	33	50	1.0	1.0	0.0
chr5:148826910:G:C	55	24	82	32	50	1	1	0
chr5:149008857:C:T	0	0	0	0	0	0	0	0
chr5:149026469:C:T	0	0	0	0	0	0	0	0
chr5:149026823:T:C	0	0	0	0	0	0	0	0
chr5:149028330:C:A	0	0	0	0	0	0	0	0
chr5:149259499:C:T	0	0	0	0	0	0	0	0
chr5:149301154:G:A	0	0	0	0	0	0	0	0
chr5:149345636:A:G	8	3	11	5	6	1.0	1.0	0.0
chr5:149368339:G:C	21	11	32	10	22	2	0	2
chr5:149374573:G:A	0	0	0	0	0	0	0	0
chr5:149820480:T:C	9	4	13	5	8	1	1	0
chr5:149833237:G:A	10	4	14	6	8	1.0	1.0	0.0
chr5:150024616:G:T	14	8	22	6	16	2.0	0.0	2.0
chr5:150026850:G:T	11	6	17	5	12	2	0	2
chr5:150054033:TG:GA	2	1	3	1	2	1.5	0.5	1.0
chr5:150077208:CT:AA	0	0	0	0	0	0	0	0
chr5:150078115:G:A	0	0	0	0	0	0	0	0
chr5:150080990:A:G	0	0	0	0	0	0	0	0
chr5:150115690:T:C	0	0	0	0	0	0	0	0
chr5:150115832:T:C	0	0	0	0	0	0	0	0
chr5:150120109:T:C	0	0	0	0	0	0	0	0
chr5:150134063:T:G	0	0	0	0	0	0	0	0
chr5:150222717:T:C	0	0	0	0	0	0	0	0
chr5:150375428:C:T	16	5	21	11	10	1.0	1.0	0.0
chr5:150375858:A:G	15	8	25	7	18	2	0	2
chr5:150376181:G:C	14	8	24	6	18	2.0	0.0	2.0
chr5:150383742:A:G	5	0	5	5	0	1	1	0
chr5:150392717:C:G	52	25	80	28	52	1.0	1.0	0.0
chr5:150444222:G:A	100	21	135	87	48	1.0	1.0	0.0
chr5:150446963:C:T	4410	4379	198302	68126	130176	39.0	13.0	26.0
chr5:150447009:G:A	92	55	148	37	111	2.0	0.0	2.0
chr5:150447535:G:A	426	79	542	376	166	1.0	1.0	0.0
chr5:150758970:G:C	409	213	659	215	444	2	1	2
chr5:150895629:G:A	0	0	0	0	0	0	0	0
chr5:151030574:G:A	452	239	763	249	514	2.0	1.0	2.0
chr5:151030658:C:A	433	224	724	242	482	2	1	2
chr5:151138797:AG:GA	1	0	1	1	0	1	1	0
chr5:151185447:C:T	596	302	1000	352	648	2.0	1.0	2.0
chr5:151510091:C:T	0	0	0	0	0	0	0	0
chr5:151567601:A:G	0	0	0	0	0	0	0	0
chr5:151758650:A:G	16	6	25	11	14	1.0	1.0	0.0
chr5:153494089:A:G	0	0	0	0	0	0	0	0
chr5:153650400:T:C	0	0	0	0	0	0	0	0
chr5:154404027:A:G	6	3	9	3	6	1.5	0.5	1.0
chr5:155015898:G:A	0	0	0	0	0	0	0	0
chr5:155016122:G:A	0	0	0	0	0	0	0	0
chr5:155016945:G:A	0	0	0	0	0	0	0	0
chr5:156344569:T:C	0	0	0	0	0	0	0	0
chr5:157055285:C:G	0	0	0	0	0	0	0	0
chr5:157162388:G:T	0	0	0	0	0	0	0	0
chr5:157343125:C:T	2	0	2	2	0	1.0	1.0	0.0
chr5:157343201:G:A	2	2	4	0	4	2.0	0.0	2.0
chr5:157491842:C:T	19	9	29	11	18	2	1	0
chr5:157509356:T:C	42	19	61	23	38	1.0	1.0	0.0
chr5:157651467:C:G	0	0	0	0	0	0	0	0
chr5:157671748:G:T	1	0	1	1	0	1	1	0
chr5:157679960:C:T	0	0	0	0	0	0	0	0
chr5:159208094:T:C	8	5	13	3	10	2.0	0.0	2.0
chr5:159917454:G:A	0	0	0	0	0	0	0	0
chr5:160232266:C:T	0	0	0	0	0	0	0	0
chr5:160238719:C:T	0	0	0	0	0	0	0	0
chr5:160238726:C:T	0	0	0	0	0	0	0	0
chr5:160670489:A:G	0	0	0	0	0	0	0	0
chr5:160670625:G:A	0	0	0	0	0	0	0	0
chr5:168062165:A:G	0	0	0	0	0	0	0	0
chr5:168486454:C:A	56	11	68	46	22	1.0	1.0	0.0
chr5:168486505:G:A	371	153	547	237	310	1	1	0
chr5:168497255:C:A	37	14	52	24	28	1	1	0
chr5:168671230:A:G	0	0	0	0	0	0	0	0
chr5:168707952:G:A	0	0	0	0	0	0	0	0
chr5:168762643:G:A	0	0	0	0	0	0	0	0
chr5:168806469:G:A	0	0	0	0	0	0	0	0
chr5:170080063:A:G	2	2	4	0	4	2.0	0.0	2.0
chr5:170082925:G:A	214	124	363	107	256	2.0	0.0	2.0
chr5:170108518:T:C	0	0	0	0	0	0	0	0
chr5:170270703:G:A	2	0	2	2	0	1.0	1.0	0.0
chr5:171392883:G:A	142	55	209	97	112	1.0	1.0	0.0
chr5:171791134:G:A	0	0	0	0	0	0	0	0
chr5:172053051:G:A	2	1	3	1	2	1.5	0.5	1.0
chr5:172054602:A:G	40	15	55	25	30	1.0	1.0	0.0
chr5:173889726:G:A	2	1	3	1	2	1.5	0.5	1.0
chr5:176106582:C:T	0	0	0	0	0	0	0	0
chr5:176529176:G:A	4	1	5	3	2	1.0	1.0	0.0
chr5:176529515:G:A	3	2	5	1	4	2	0	2
chr5:176578476:C:T	0	0	0	0	0	0	0	0
chr5:176590454:C:T	0	0	0	0	0	0	0	0
chr5:176590638:C:A	0	0	0	0	0	0	0	0
chr5:176626644:C:G	0	0	0	0	0	0	0	0
chr5:176654906:C:T	34	16	52	18	34	1.0	1.0	0.0
chr5:176656996:G:A	5	2	7	3	4	1	1	0
chr5:176889454:C:T	1	1	2	0	2	2	0	2
chr5:177089630:G:A	0	0	0	0	0	0	0	0
chr5:177093242:G:A	0	0	0	0	0	0	0	0
chr5:177294271:G:C	12	4	16	8	8	1.0	1.0	0.0
chr5:177306340:A:G	101	49	151	56	95	1	1	0
chr5:177307854:G:C	68	32	105	37	68	1.0	1.0	0.0
chr5:177388123:T:C	0	0	0	0	0	0	0	0
chr5:177397136:C:G	0	0	0	0	0	0	0	0
chr5:177403626:G:A	1	0	1	1	0	1	1	0
chr5:177404118:A:G	2	1	3	1	2	1.5	0.5	1.0
chr5:177409531:A:G	1	0	1	1	0	1	1	0
chr5:177436518:G:C	154	75	240	84	156	2.0	1.0	0.0
chr5:177440942:A:G	152	76	235	79	156	2.0	1.0	1.0
chr5:177458498:T:C	20	12	32	8	24	2.0	0.0	2.0
chr5:177466941:C:T	49	25	76	26	50	2	0	2
chr5:177467755:C:T	88	44	139	47	92	2.0	0.5	1.0
chr5:177513273:C:T	0	0	0	0	0	0	0	0
chr5:177513383:G:A	115	65	185	51	134	2	0	2
chr5:177516693:G:A	4	1	5	3	2	1.0	1.0	0.0
chr5:177604347:T:C	214	96	324	126	198	1.0	1.0	0.0
chr5:177608963:T:C	204	101	316	112	204	1.5	1.0	0.0
chr5:177995907:A:G	0	0	0	0	0	0	0	0
chr5:178185982:G:A	0	0	0	0	0	0	0	0
chr5:178186167:C:T	0	0	0	0	0	0	0	0
chr5:178186543:C:T	1	1	2	0	2	2	0	2
chr5:178186835:C:T	0	0	0	0	0	0	0	0
chr5:178187089:GCTCC:CCTCG	0	0	0	0	0	0	0	0
chr5:178187182:T:C	0	0	0	0	0	0	0	0
chr5:178230210:A:T	67	34	103	35	68	2	1	2
chr5:178712441:T:G	94	57	152	38	114	2.0	0.0	2.0
chr5:178982826:C:T	0	0	0	0	0	0	0	0
chr5:178982855:C:T	0	0	0	0	0	0	0	0
chr5:179024931:C:T	10	5	15	5	10	1.5	0.5	1.0
chr5:179028113:A:G	69	27	97	43	54	1	1	0
chr5:179032425:A:C	30	19	51	11	40	2.0	0.0	2.0
chr5:179113879:G:A	0	0	0	0	0	0	0	0
chr5:179113974:G:A	0	0	0	0	0	0	0	0
chr5:179122790:G:A	0	0	0	0	0	0	0	0
chr5:179128044:G:A	0	0	0	0	0	0	0	0
chr5:179135966:G:A	0	0	0	0	0	0	0	0
chr5:179154858:G:A	3	0	3	3	0	1	1	0
chr5:179181111:G:A	0	0	0	0	0	0	0	0
chr5:179980229:C:T	3	0	3	3	0	1	1	0
chr5:180136435:T:C	0	0	0	0	0	0	0	0
chr5:180136532:G:C	0	0	0	0	0	0	0	0
chr5:180313827:T:C	0	0	0	0	0	0	0	0
chr5:180317009:T:G	0	0	0	0	0	0	0	0
chr5:180569111:C:T	39	25	69	15	54	2	0	2
chr5:180603313:C:A	0	0	0	0	0	0	0	0
chr5:180624003:T:C	0	0	0	0	0	0	0	0
chr5:181155043:C:T	0	0	0	0	0	0	0	0
chr5:181155604:A:G	0	0	0	0	0	0	0	0
chr5:181195615:C:T	7	3	10	4	6	1	1	0
chr5:181198254:G:A	0	0	0	0	0	0	0	0
chr5:181199927:A:G	2	0	2	2	0	1.0	1.0	0.0
chr5:181200250:T:C	2	0	2	2	0	1.0	1.0	0.0
chr6:1394808:T:C	0	0	0	0	0	0	0	0
chr6:1742560:A:G	305	170	494	146	348	2	0	2
chr6:2970707:G:C	140	134	292	6	286	2.0	0.0	2.0
chr6:3154637:A:C	202	129	400	98	302	2.0	0.0	2.0
chr6:3177170:G:T	0	0	0	0	0	0	0	0
chr6:4125421:A:G	10	2	12	8	4	1.0	1.0	0.0
chr6:4133621:C:T	631	274	1032	438	594	1	1	0
chr6:6151904:C:G	0	0	0	0	0	0	0	0
chr6:6174623:T:C	0	0	0	0	0	0	0	0
chr6:6318562:C:A	0	0	0	0	0	0	0	0
chr6:7229113:T:C	13	7	20	6	14	2	0	2
chr6:7229386:G:A	9	4	13	5	8	1	1	0
chr6:7230447:G:T	3	0	3	3	0	1	1	0
chr6:7247111:C:A	21	12	34	10	24	2	0	2
chr6:7313173:C:G	309	139	473	182	291	1	1	0
chr6:7373974:T:G	0	0	0	0	0	0	0	0
chr6:7387003:G:A	4	0	4	4	0	1.0	1.0	0.0
chr6:7393219:C:T	178	92	295	95	200	2.0	0.0	2.0
chr6:7395117:G:A	150	72	240	86	154	2.0	1.0	0.0
chr6:7576294:G:A	0	0	0	0	0	0	0	0
chr6:7584384:C:T	0	0	0	0	0	0	0	0
chr6:7585734:G:C	0	0	0	0	0	0	0	0
chr6:7590391:C:T	352	176	582	194	388	2.0	1.0	1.0
chr6:10887018:TCG:CCC	0	0	0	0	0	0	0	0
chr6:10887043:C:G	0	0	0	0	0	0	0	0
chr6:10983738:C:G	0	0	0	0	0	0	0	0
chr6:11005453:G:A	1	0	1	1	0	1	1	0
chr6:11103655:T:C	0	0	0	0	0	0	0	0
chr6:11185300:G:A	10	7	17	3	14	2.0	0.0	2.0
chr6:11213599:T:C	24	14	38	10	28	2.0	0.0	2.0
chr6:11735664:A:T	3	1	4	2	2	1	1	0
chr6:12123016:A:G	42	17	59	25	34	1.0	1.0	0.0
chr6:12124354:C:G	28	8	36	20	16	1.0	1.0	0.0
chr6:12125539:A:G	48	23	73	27	46	2.0	1.0	0.0
chr6:12514412:T:G	51	0	52	52	0	1	1	0
chr6:15496431:C:T	32	16	51	17	34	1.5	1.0	1.0
chr6:15517214:C:T	83	47	131	37	94	2	0	2
chr6:16145094:A:G	82	28	114	58	56	1.0	1.0	0.0
chr6:16290530:T:A	10	7	17	3	14	2.0	0.0	2.0
chr6:16327099:T:C	14	6	21	9	12	1.5	1.0	0.0
chr6:16327384:A:G	12	7	19	5	14	2.0	0.0	2.0
chr6:17543071:A:G	0	0	0	0	0	0	0	0
chr6:17600982:C:T	85	53	149	35	114	2	0	2
chr6:17665248:G:C	29	14	43	15	28	1	1	0
chr6:17675322:T:C	80	42	119	38	81	1.0	0.0	1.0
chr6:17764048:A:C	7	2	9	5	4	1	1	0
chr6:17764500:G:C	3	2	5	1	4	2	0	2
chr6:17764524:T:C	1	1	2	0	2	2	0	2
chr6:17781219:G:A	10	9	21	1	20	2.0	0.0	2.0
chr6:18143623:G:A	97	42	144	56	88	1	1	0
chr6:18399519:T:C	365	197	642	216	426	2	1	2
chr6:24290975:T:C	0	0	0	0	0	0	0	0
chr6:24402968:T:C	91	42	141	53	88	1	1	0
chr6:24403227:C:T	104	48	160	60	100	1.0	1.0	0.0
chr6:24437230:T:C	1	1	2	0	2	2	0	2
chr6:24462792:G:C	10	7	18	4	14	2.0	0.0	2.0
chr6:24588656:C:T	0	0	0	0	0	0	0	0
chr6:24645715:TCTGG:GCTGC	2	1	3	1	2	1.5	0.5	1.0
chr6:24645739:T:G	3	2	5	1	4	2	0	2
chr6:24653148:G:A	68	33	102	36	66	1.5	1.0	0.0
chr6:24697987:G:A	257	124	423	153	270	2	1	0
chr6:24806366:C:T	218	106	339	125	214	2.0	1.0	0.0
chr6:24825283:A:G	116	57	180	62	118	1.5	1.0	0.0
chr6:24835933:C:A	26	13	40	14	26	2.0	0.5	1.0
chr6:25435530:A:G	108	53	171	61	110	2.0	1.0	0.0
chr6:25600599:T:C	24	11	37	13	24	1.0	1.0	0.0
chr6:26056254:G:A	2798	2020	9893	2799	7094	3.0	1.0	2.0
chr6:26091336:C:T	9	2	11	7	4	1	1	0
chr6:26124406:C:T	1036	435	1975	905	1070	2.0	1.0	0.0
chr6:26199852:C:T	0	0	0	0	0	0	0	0
chr6:26445783:G:A	54	11	69	43	26	1.0	1.0	0.0
chr6:26597105:A:G	552	310	909	267	642	2.0	0.0	2.0
chr6:26597960:A:G	514	285	849	262	587	2.0	0.0	2.0
chr6:27247707:C:A	0	0	0	0	0	0	0	0
chr6:27248920:G:T	0	0	0	0	0	0	0	0
chr6:27452809:G:A	15	9	26	6	20	2	0	2
chr6:27957589:G:A	2	0	2	2	0	1.0	1.0	0.0
chr6:28074199:A:G	0	0	0	0	0	0	0	0
chr6:28149553:C:T	33	16	50	18	32	2	1	0
chr6:28259658:A:G	22	12	43	13	30	2.0	0.0	2.0
chr6:28271903:A:G	261	120	393	148	245	1	1	0
chr6:28296915:C:G	7	3	10	4	6	1	1	0
chr6:28301886:A:G	9	3	12	6	6	1	1	0
chr6:28302270:C:G	12	4	16	8	8	1.0	1.0	0.0
chr6:28391393:A:G	9	5	14	4	10	2	0	2
chr6:28574647:G:A	0	0	0	0	0	0	0	0
chr6:28574743:C:T	0	0	0	0	0	0	0	0
chr6:28575487:C:T	0	0	0	0	0	0	0	0
chr6:28586766:G:T	0	0	0	0	0	0	0	0
chr6:28908732:G:A	4	3	7	1	6	2.0	0.0	2.0
chr6:29101560:A:T	0	0	0	0	0	0	0	0
chr6:29112567:G:A	0	0	0	0	0	0	0	0
chr6:29112572:A:G	0	0	0	0	0	0	0	0
chr6:29112673:G:A	0	0	0	0	0	0	0	0
chr6:29173995:A:G	0	0	0	0	0	0	0	0
chr6:29174072:T:C	0	0	0	0	0	0	0	0
chr6:29174277:C:G	0	0	0	0	0	0	0	0
chr6:29396838:G:T	0	0	0	0	0	0	0	0
chr6:29396866:T:C	0	0	0	0	0	0	0	0
chr6:29397464:T:C	0	0	0	0	0	0	0	0
chr6:29397646:A:T	0	0	0	0	0	0	0	0
chr6:29427149:C:T	0	0	0	0	0	0	0	0
chr6:29440193:T:C	0	0	0	0	0	0	0	0
chr6:29440536:C:A	0	0	0	0	0	0	0	0
chr6:29556175:A:G	0	0	0	0	0	0	0	0
chr6:29556391:G:T	0	0	0	0	0	0	0	0
chr6:29622223:A:T	3	2	5	1	4	2	0	2
chr6:29624087:G:A	0	0	0	0	0	0	0	0
chr6:29632327:G:A	140	74	230	76	154	2.0	0.0	2.0
chr6:29659536:A:G	1	0	1	1	0	1	1	0
chr6:29659696:A:T	1	0	1	1	0	1	1	0
chr6:29723995:T:C	57	28	83	29	54	1	1	0
chr6:29724023:C:G	54	28	82	26	56	2.0	0.0	2.0
chr6:29724080:C:G	57	30	87	27	60	2	0	2
chr6:30103502:T:G	0	0	0	0	0	0	0	0
chr6:30103553:C:T	0	0	0	0	0	0	0	0
chr6:30108978:G:A	0	0	0	0	0	0	0	0
chr6:30163738:C:A	0	0	0	0	0	0	0	0
chr6:30196720:G:A	153	81	236	72	164	2	0	2
chr6:30199158:G:A	8	3	11	5	6	1.0	1.0	0.0
chr6:30679228:C:G	191	100	306	100	206	2	0	2
chr6:30704212:G:C	19	6	25	13	12	1	1	0
chr6:30728143:C:T	664	298	1083	441	642	1.0	1.0	0.0
chr6:30730764:A:G	24	20	44	4	40	2.0	0.0	2.0
chr6:30740651:T:C	1	0	1	1	0	1	1	0
chr6:30741587:G:T	118	41	163	79	84	1.0	1.0	0.0
chr6:30742053:T:C	57	22	79	35	44	1	1	0
chr6:30889295:G:C	4	4	8	0	8	2.0	0.0	2.0
chr6:30891080:C:T	5	5	10	0	10	2	0	2
chr6:30897052:T:C	9	7	16	2	14	2	0	2
chr6:30897427:A:C	8	6	14	2	12	2.0	0.0	2.0
chr6:30898983:C:T	22	9	31	13	18	1.0	1.0	0.0
chr6:30899329:C:T	30	17	49	13	36	2.0	0.0	2.0
chr6:30909983:A:C	122	63	189	63	126	2.0	1.0	2.0
chr6:30914857:C:T	11	6	17	5	12	2	0	2
chr6:30915004:G:T	14	9	23	5	18	2.0	0.0	2.0
chr6:30920195:C:T	4	1	5	3	2	1.0	1.0	0.0
chr6:30920211:C:T	4	3	7	1	6	2.0	0.0	2.0
chr6:30921612:T:C	4	2	6	2	4	1.5	0.5	1.0
chr6:30922429:T:C	1	1	2	0	2	2	0	2
chr6:30922706:G:T	11	5	11	6	5	1	1	0
chr6:30923451:C:T	19	10	29	9	20	2	0	2
chr6:30925350:G:A	40	14	54	26	28	1.0	1.0	0.0
chr6:30925651:G:A	45	29	75	17	58	2	0	2
chr6:30931456:C:T	0	0	0	0	0	0	0	0
chr6:30931794:C:T	0	0	0	0	0	0	0	0
chr6:30931969:G:A	0	0	0	0	0	0	0	0
chr6:30951924:T:C	0	0	0	0	0	0	0	0
chr6:30953113:G:A	0	0	0	0	0	0	0	0
chr6:30953180:G:A	0	0	0	0	0	0	0	0
chr6:31025600:T:A	0	0	0	0	0	0	0	0
chr6:31025756:A:G	0	0	0	0	0	0	0	0
chr6:31025790:G:T	0	0	0	0	0	0	0	0
chr6:31025813:A:G	0	0	0	0	0	0	0	0
chr6:31026031:T:C	0	0	0	0	0	0	0	0
chr6:31026706:G:A	0	0	0	0	0	0	0	0
chr6:31027381:C:T	0	0	0	0	0	0	0	0
chr6:31028433:G:T	0	0	0	0	0	0	0	0
chr6:31111459:G:A	0	0	0	0	0	0	0	0
chr6:31111866:T:C	0	0	0	0	0	0	0	0
chr6:31112112:C:G	0	0	0	0	0	0	0	0
chr6:31115952:A:C	0	0	0	0	0	0	0	0
chr6:31116393:A:C	0	0	0	0	0	0	0	0
chr6:31116658:G:A	0	0	0	0	0	0	0	0
chr6:31116862:C:T	0	0	0	0	0	0	0	0
chr6:31120425:A:G	0	0	0	0	0	0	0	0
chr6:31138400:T:C	33	13	52	24	28	1	1	0
chr6:31138491:A:G	2	1	3	1	2	1.5	0.5	1.0
chr6:31138632:A:G	2	1	3	1	2	1.5	0.5	1.0
chr6:31143009:T:A	43	22	65	21	44	2	0	2
chr6:31144825:G:C	6	6	12	0	12	2.0	0.0	2.0
chr6:31144960:C:A	26	9	35	17	18	1.0	1.0	0.0
chr6:31148433:G:A	17	6	23	11	12	1	1	0
chr6:31148443:G:A	17	11	28	6	22	2	0	2
chr6:31148469:G:A	17	6	23	11	12	1	1	0
chr6:31154538:G:C	24	7	31	17	14	1.0	1.0	0.0
chr6:31154553:G:A	24	17	43	7	36	2.0	0.0	2.0
chr6:31154705:G:A	26	7	33	19	14	1.0	1.0	0.0
chr6:31154723:G:A	25	6	31	19	12	1	1	0
chr6:31157381:C:T	1	1	4	0	4	4	0	4
chr6:31170330:G:A	0	0	0	0	0	0	0	0
chr6:31170600:C:T	0	0	0	0	0	0	0	0
chr6:31280814:A:C	2	1	3	1	2	1.5	0.5	1.0
chr6:31411179:C:G	28	15	43	13	30	2.0	0.0	2.0
chr6:31411338:G:A	31	15	46	16	30	1	1	0
chr6:31411357:C:G	31	15	46	16	30	1	1	0
chr6:31412040:T:C	32	15	47	17	30	1.0	1.0	0.0
chr6:31412154:G:A	38	18	58	20	38	1.0	1.0	0.0
chr6:31505769:A:G	26	12	41	15	26	1.5	1.0	0.0
chr6:31506067:T:C	4	1	5	3	2	1.0	1.0	0.0
chr6:31509904:A:G	26	11	39	17	22	1.5	1.0	0.0
chr6:31528999:T:G	2	0	2	2	0	1.0	1.0	0.0
chr6:31529148:G:A	0	0	0	0	0	0	0	0
chr6:31529929:C:T	0	0	0	0	0	0	0	0
chr6:31529967:G:A	0	0	0	0	0	0	0	0
chr6:31530720:C:A	45	24	70	22	48	2	0	2
chr6:31538847:T:C	1388	809	2669	825	1844	2.0	1.0	2.0
chr6:31546087:A:T	3	1	4	2	2	1	1	0
chr6:31615922:C:T	3	1	4	2	2	1	1	0
chr6:31626851:T:A	64	28	95	39	56	1.0	1.0	0.0
chr6:31637422:G:C	74	40	115	35	80	2.0	0.0	2.0
chr6:31642909:A:G	118	66	186	52	134	2.0	0.0	2.0
chr6:31717877:G:C	0	0	0	0	0	0	0	0
chr6:32746398:C:T	1	0	1	1	0	1	1	0
chr6:32756284:A:G	1	0	1	1	0	1	1	0
chr6:32756366:G:A	1	0	1	1	0	1	1	0
chr6:32756481:C:T	0	0	0	0	0	0	0	0
chr6:32756528:T:C	0	0	0	0	0	0	0	0
chr6:32756535:C:G	0	0	0	0	0	0	0	0
chr6:32756540:C:T	0	0	0	0	0	0	0	0
chr6:32756547:T:C	0	0	0	0	0	0	0	0
chr6:32761682:C:T	0	0	0	0	0	0	0	0
chr6:32761865:G:C	0	0	0	0	0	0	0	0
chr6:32763481:G:A	0	0	0	0	0	0	0	0
chr6:32816976:T:C	1026	569	2066	700	1366	2.0	1.0	2.0
chr6:32828876:C:A	283	164	466	131	335	2	0	2
chr6:32828908:A:G	281	164	464	129	335	2	0	2
chr6:32828974:T:C	275	160	454	126	328	2	0	2
chr6:32829520:T:C	226	132	367	99	268	2.0	0.0	2.0
chr6:32858456:A:G	2824	1918	8521	2708	5813	2.0	1.0	2.0
chr6:32948778:G:A	3872	3055	24505	8975	15530	5.0	2.0	2.0
chr6:32949767:C:T	3769	3133	24127	7161	16966	5	1	4
chr6:32974525:G:A	132	72	210	63	147	2.0	0.0	2.0
chr6:32976969:G:A	134	68	210	72	138	2.0	1.0	2.0
chr6:32978356:T:C	181	101	295	87	208	2	0	2
chr6:33080765:C:T	4100	3652	50958	15775	35183	7.0	2.0	6.0
chr6:33085905:G:A	391	382	882	9	873	2	0	2
chr6:33171551:C:T	0	0	0	0	0	0	0	0
chr6:33173384:A:G	0	0	0	0	0	0	0	0
chr6:33173503:G:A	0	0	0	0	0	0	0	0
chr6:33195674:G:A	29	7	36	23	13	1	1	0
chr6:33202567:T:C	233	124	363	113	250	2	0	2
chr6:33279268:A:G	358	182	581	197	384	2.0	1.0	2.0
chr6:33314065:GA:TT	632	251	972	436	536	1.0	1.0	0.0
chr6:33320298:C:A	9	5	14	4	10	2	0	2
chr6:33320494:A:G	76	41	122	38	84	2.0	0.0	2.0
chr6:33391939:G:C	2	0	2	2	0	1.0	1.0	0.0
chr6:33413682:A:G	20	10	30	10	20	1.5	0.5	1.0
chr6:33440765:G:A	3	1	4	2	2	1	1	0
chr6:33669130:C:T	2	0	2	2	0	1.0	1.0	0.0
chr6:33670403:C:T	2	0	2	2	0	1.0	1.0	0.0
chr6:33673602:T:C	3	2	5	1	4	2	0	2
chr6:33680367:C:T	5	3	8	2	6	2	0	2
chr6:33680451:C:T	5	3	8	2	6	2	0	2
chr6:33726882:G:A	0	0	0	0	0	0	0	0
chr6:33772605:G:A	38	16	54	22	32	1.0	1.0	0.0
chr6:33776934:C:T	10	4	14	6	8	1.0	1.0	0.0
chr6:33801120:A:G	0	0	0	0	0	0	0	0
chr6:34246545:C:G	567	302	970	317	653	2	1	2
chr6:34544312:G:A	0	0	0	0	0	0	0	0
chr6:35738115:T:C	6	4	10	2	8	2.0	0.0	2.0
chr6:35835415:C:A	21	12	33	9	24	2	0	2
chr6:35835506:C:T	10	6	16	4	12	2.0	0.0	2.0
chr6:36293081:C:T	0	0	0	0	0	0	0	0
chr6:36302353:C:A	0	0	0	0	0	0	0	0
chr6:36306376:C:T	0	0	0	0	0	0	0	0
chr6:36307681:T:C	0	0	0	0	0	0	0	0
chr6:36319535:G:C	1	0	1	1	0	1	1	0
chr6:36677811:A:C	0	0	0	0	0	0	0	0
chr6:36677919:A:G	0	0	0	0	0	0	0	0
chr6:36745486:A:G	37	27	67	11	56	2	0	2
chr6:36765355:G:A	1	1	2	0	2	2	0	2
chr6:36963038:T:C	39	16	54	23	31	1	1	0
chr6:36963386:A:G	40	16	56	24	32	1.0	1.0	0.0
chr6:37009125:C:A	106	81	196	26	170	2.0	0.0	2.0
chr6:37011058:A:G	18	9	27	9	18	1.5	0.5	1.0
chr6:37282336:A:G	15	8	23	7	16	2	0	2
chr6:37354031:C:G	136	74	214	64	150	2.0	0.0	2.0
chr6:37480218:C:G	43	18	67	25	42	1	1	0
chr6:37483138:T:C	887	391	1683	719	964	2	1	0
chr6:38703061:G:A	2344	1450	5537	1840	3697	2.0	1.0	2.0
chr6:39073726:A:C	0	0	0	0	0	0	0	0
chr6:39314260:T:C	1	0	1	1	0	1	1	0
chr6:39315307:G:A	0	0	0	0	0	0	0	0
chr6:39316274:G:T	0	0	0	0	0	0	0	0
chr6:39316408:A:G	0	0	0	0	0	0	0	0
chr6:39322424:C:T	0	0	0	0	0	0	0	0
chr6:39861086:A:C	0	0	0	0	0	0	0	0
chr6:39883903:A:G	0	0	0	0	0	0	0	0
chr6:39884042:G:A	0	0	0	0	0	0	0	0
chr6:39887651:C:T	0	0	0	0	0	0	0	0
chr6:39896954:C:T	0	0	0	0	0	0	0	0
chr6:39897271:T:C	0	0	0	0	0	0	0	0
chr6:39902176:T:A	0	0	0	0	0	0	0	0
chr6:39906952:C:T	0	0	0	0	0	0	0	0
chr6:39913358:A:T	0	0	0	0	0	0	0	0
chr6:40392726:A:G	0	0	0	0	0	0	0	0
chr6:40432549:C:T	0	0	0	0	0	0	0	0
chr6:41061370:T:C	71	37	117	37	80	2	0	2
chr6:41061603:T:C	56	28	89	29	60	1.5	1.0	1.0
chr6:41071106:C:T	115	58	186	64	122	2	1	2
chr6:41079063:T:C	106	48	162	64	98	1.0	1.0	0.0
chr6:41194780:T:C	11	4	16	8	8	1	1	0
chr6:41236591:A:T	0	0	0	0	0	0	0	0
chr6:41335854:T:C	0	0	0	0	0	0	0	0
chr6:41341814:T:C	0	0	0	0	0	0	0	0
chr6:41653533:G:A	0	0	0	0	0	0	0	0
chr6:41684776:C:T	437	232	724	240	484	2	1	2
chr6:41684866:T:C	397	212	651	213	438	2	1	2
chr6:41771151:C:T	1	1	2	0	2	2	0	2
chr6:41806517:C:T	3	0	3	3	0	1	1	0
chr6:41936044:AG:CA	1235	730	2409	721	1688	2	1	2
chr6:42077207:G:A	64	32	99	33	66	2.0	0.5	1.0
chr6:42142490:C:A	0	0	0	0	0	0	0	0
chr6:42194650:A:G	25	8	34	18	16	1	1	0
chr6:42217826:A:C	684	342	1146	410	736	2.0	1.0	0.5
chr6:42256808:A:T	1	1	2	0	2	2	0	2
chr6:42964462:GGC:TGT	75	54	136	22	114	2	0	2
chr6:42978752:C:A	441	286	758	172	586	2	0	2
chr6:43337359:C:T	35	21	56	14	42	2	0	2
chr6:43338582:T:C	9	3	12	6	6	1	1	0
chr6:43524840:G:A	22	9	31	13	18	1.0	1.0	0.0
chr6:43528924:A:C	32	16	50	16	34	1.5	0.5	1.0
chr6:44001077:A:G	0	0	0	0	0	0	0	0
chr6:44089351:C:T	3	0	3	3	0	1	1	0
chr6:44113981:G:A	894	437	1542	592	950	2.0	1.0	0.0
chr6:44180699:G:C	0	0	0	0	0	0	0	0
chr6:44183753:G:A	0	0	0	0	0	0	0	0
chr6:44265183:A:G	149	69	231	89	142	1	1	0
chr6:44265240:G:A	148	68	229	89	140	1.0	1.0	0.0
chr6:44275726:G:A	0	0	0	0	0	0	0	0
chr6:44287650:C:T	2	2	4	0	4	2.0	0.0	2.0
chr6:44301456:C:T	10	6	16	4	12	2.0	0.0	2.0
chr6:44303133:C:T	6	2	8	4	4	1.0	1.0	0.0
chr6:44307410:G:A	0	0	0	0	0	0	0	0
chr6:44307458:G:T	0	0	0	0	0	0	0	0
chr6:46652503:C:T	0	0	0	0	0	0	0	0
chr6:46711566:A:G	0	0	0	0	0	0	0	0
chr6:46758704:G:C	0	0	0	0	0	0	0	0
chr6:46825438:G:A	0	0	0	0	0	0	0	0
chr6:46833334:G:T	0	0	0	0	0	0	0	0
chr6:46835281:A:T	0	0	0	0	0	0	0	0
chr6:46835365:A:G	0	0	0	0	0	0	0	0
chr6:46839072:C:T	0	0	0	0	0	0	0	0
chr6:46839202:G:T	0	0	0	0	0	0	0	0
chr6:47879443:A:G	0	0	0	0	0	0	0	0
chr6:47879665:A:G	0	0	0	0	0	0	0	0
chr6:49435569:T:C	15	10	25	5	20	2	0	2
chr6:49444720:C:T	9	6	15	3	12	2	0	2
chr6:49472092:G:A	75	29	110	50	60	1	1	0
chr6:49512037:T:C	0	0	0	0	0	0	0	0
chr6:49521684:C:A	0	0	0	0	0	0	0	0
chr6:49692705:A:C	0	0	0	0	0	0	0	0
chr6:49733810:A:G	0	0	0	0	0	0	0	0
chr6:51619163:T:C	0	0	0	0	0	0	0	0
chr6:51627086:T:C	0	0	0	0	0	0	0	0
chr6:52236941:T:C	0	0	0	0	0	0	0	0
chr6:52236960:C:T	0	0	0	0	0	0	0	0
chr6:52264686:C:T	104	48	161	63	98	2.0	1.0	0.0
chr6:53544619:C:T	241	144	408	107	301	2	0	2
chr6:54124728:G:A	0	0	0	0	0	0	0	0
chr6:54137433:A:C	0	0	0	0	0	0	0	0
chr6:54870324:A:G	0	0	0	0	0	0	0	0
chr6:55277539:A:G	0	0	0	0	0	0	0	0
chr6:55774230:G:A	0	0	0	0	0	0	0	0
chr6:55874755:A:G	0	0	0	0	0	0	0	0
chr6:56168296:G:A	0	0	0	0	0	0	0	0
chr6:56560486:A:G	0	0	0	0	0	0	0	0
chr6:56598612:T:C	0	0	0	0	0	0	0	0
chr6:56618003:C:G	0	0	0	0	0	0	0	0
chr6:56619960:C:T	0	0	0	0	0	0	0	0
chr6:63984461:C:T	0	0	0	0	0	0	0	0
chr6:64590250:G:C	0	0	0	0	0	0	0	0
chr6:64590623:T:G	0	0	0	0	0	0	0	0
chr6:64591274:C:T	0	0	0	0	0	0	0	0
chr6:64591318:T:C	0	0	0	0	0	0	0	0
chr6:64591324:G:A	0	0	0	0	0	0	0	0
chr6:64591515:A:G	0	0	0	0	0	0	0	0
chr6:64593207:T:C	0	0	0	0	0	0	0	0
chr6:64912570:A:G	0	0	0	0	0	0	0	0
chr6:65295964:T:A	0	0	0	0	0	0	0	0
chr6:65295995:C:T	0	0	0	0	0	0	0	0
chr6:65335034:T:C	0	0	0	0	0	0	0	0
chr6:70207184:A:C	16	8	27	9	18	2.0	0.5	1.0
chr6:70252130:T:C	0	0	0	0	0	0	0	0
chr6:70956283:G:A	0	0	0	0	0	0	0	0
chr6:70956524:G:A	0	0	0	0	0	0	0	0
chr6:72622393:C:T	62	27	91	38	53	1.0	1.0	0.0
chr6:73194834:C:T	4	1	5	3	2	1.0	1.0	0.0
chr6:73223678:T:G	2	1	3	1	2	1.5	0.5	1.0
chr6:73363808:C:G	0	0	0	0	0	0	0	0
chr6:73369301:A:G	1	1	2	0	2	2	0	2
chr6:73394834:C:G	0	0	0	0	0	0	0	0
chr6:73413640:G:A	0	0	0	0	0	0	0	0
chr6:73416152:A:G	1	1	2	0	2	2	0	2
chr6:73416165:A:G	1	1	2	0	2	2	0	2
chr6:73783709:A:C	0	0	0	0	0	0	0	0
chr6:73823468:G:T	0	0	0	0	0	0	0	0
chr6:75284435:A:G	453	243	765	249	516	2	1	2
chr6:75666836:G:A	55	35	92	20	72	2	0	2
chr6:75715572:A:G	138	70	216	74	142	2.0	1.0	2.0
chr6:75915024:C:T	0	0	0	0	0	0	0	0
chr6:77761409:G:A	0	0	0	0	0	0	0	0
chr6:77923362:A:G	0	0	0	0	0	0	0	0
chr6:78947674:G:A	204	99	326	116	210	2.0	1.0	0.0
chr6:83524112:G:A	0	0	0	0	0	0	0	0
chr6:83591278:A:G	0	0	0	0	0	0	0	0
chr6:83593623:T:C	0	0	0	0	0	0	0	0
chr6:84194886:G:C	28	14	43	15	28	1.5	1.0	1.0
chr6:84764040:C:T	0	0	0	0	0	0	0	0
chr6:89217243:T:C	0	0	0	0	0	0	0	0
chr6:89271694:T:C	2	0	2	2	0	1.0	1.0	0.0
chr6:89630557:G:A	0	0	0	0	0	0	0	0
chr6:89631015:G:A	6	4	10	2	8	2.0	0.0	2.0
chr6:89637792:T:C	1247	682	2303	777	1526	2	1	2
chr6:89672431:C:A	1	1	2	0	2	2	0	2
chr6:89680724:C:A	12	4	16	8	8	1.0	1.0	0.0
chr6:89692763:G:A	5	4	9	1	8	2	0	2
chr6:89708612:A:G	12	7	19	5	14	2.0	0.0	2.0
chr6:89772678:T:C	10	3	13	7	6	1.0	1.0	0.0
chr6:89787870:A:C	20	12	32	8	24	2.0	0.0	2.0
chr6:89867883:C:T	24	14	42	10	32	2.0	0.0	2.0
chr6:89950600:T:C	18	11	31	7	24	2.0	0.0	2.0
chr6:89951857:T:C	60	33	94	28	66	2.0	0.0	2.0
chr6:93258133:C:T	0	0	0	0	0	0	0	0
chr6:93410474:G:A	0	0	0	0	0	0	0	0
chr6:96521818:C:A	278	131	424	156	268	1.0	1.0	0.0
chr6:96604878:C:T	0	0	0	0	0	0	0	0
chr6:96610677:A:G	0	0	0	0	0	0	0	0
chr6:96610691:A:G	0	0	0	0	0	0	0	0
chr6:96610698:G:A	0	0	0	0	0	0	0	0
chr6:97114331:G:T	5	2	7	3	4	1	1	0
chr6:97229034:T:C	2	2	4	0	4	2.0	0.0	2.0
chr6:98926884:A:T	38	17	56	22	34	1.0	1.0	0.0
chr6:99175083:A:G	0	0	0	0	0	0	0	0
chr6:99377472:T:C	23	16	39	7	32	2	0	2
chr6:99446210:C:G	19	9	28	10	18	1	1	0
chr6:100509468:T:C	28	12	40	16	24	1.0	1.0	0.0
chr6:100518130:C:T	12	6	18	6	12	1.5	0.5	1.0
chr6:100848513:G:A	234	135	395	109	286	2.0	0.0	2.0
chr6:105278161:C:T	30	14	47	17	30	1.5	1.0	0.0
chr6:107070192:G:A	0	0	0	0	0	0	0	0
chr6:107707905:T:C	3	1	4	2	2	1	1	0
chr6:107746799:C:T	3	0	3	3	0	1	1	0
chr6:107772376:C:T	5	3	8	2	6	2	0	2
chr6:109270230:T:C	0	0	0	0	0	0	0	0
chr6:109441033:G:A	130	73	215	64	151	2.0	0.0	2.0
chr6:109442628:G:C	40	23	63	17	46	2.0	0.0	2.0
chr6:109443332:G:T	96	72	172	26	146	2.0	0.0	2.0
chr6:109447092:G:A	85	44	129	41	88	2	0	2
chr6:109454233:T:C	84	42	126	42	84	1.5	0.5	1.0
chr6:109465777:T:C	58	28	90	32	58	1.5	1.0	0.0
chr6:109825100:G:A	142	69	223	79	144	2.0	1.0	0.0
chr6:110322753:T:C	0	0	0	0	0	0	0	0
chr6:111025603:CTG:TTA	5	4	9	1	8	2	0	2
chr6:111266063:T:C	100	48	151	53	98	1.0	1.0	0.0
chr6:111374065:C:T	80	36	118	46	72	1.0	1.0	0.0
chr6:111375649:T:C	67	26	101	43	58	1	1	0
chr6:112121931:G:A	0	0	0	0	0	0	0	0
chr6:112136188:C:T	0	0	0	0	0	0	0	0
chr6:112172670:A:G	0	0	0	0	0	0	0	0
chr6:116125413:A:G	6	2	8	4	4	1.0	1.0	0.0
chr6:116253292:G:A	27	16	44	12	32	2	0	2
chr6:116253920:C:A	347	190	577	187	390	2	0	2
chr6:116279611:C:G	431	243	730	216	514	2	0	2
chr6:116279647:G:A	436	247	739	217	522	2.0	0.0	2.0
chr6:116399324:C:T	2	2	4	0	4	2.0	0.0	2.0
chr6:116453096:C:T	0	0	0	0	0	0	0	0
chr6:116793127:A:G	0	0	0	0	0	0	0	0
chr6:117404285:T:G	0	0	0	0	0	0	0	0
chr6:117425756:A:T	0	0	0	0	0	0	0	0
chr6:118565798:G:T	349	167	537	197	340	2	1	0
chr6:118566140:T:C	493	245	803	286	517	2	1	0
chr6:118815848:G:A	35	16	51	19	32	1	1	0
chr6:118816282:C:A	19	7	26	12	14	1	1	0
chr6:118921937:A:G	1	1	2	0	2	2	0	2
chr6:123218539:C:T	0	0	0	0	0	0	0	0
chr6:123548462:G:C	0	0	0	0	0	0	0	0
chr6:124963311:T:C	0	0	0	0	0	0	0	0
chr6:127447617:G:A	1	1	2	0	2	2	0	2
chr6:127450307:T:G	1	1	1	0	1	1	0	1
chr6:127719694:T:C	0	0	0	0	0	0	0	0
chr6:128067654:G:T	1	0	1	1	0	1	1	0
chr6:128883244:C:A	0	0	0	0	0	0	0	0
chr6:130827597:G:A	0	0	0	0	0	0	0	0
chr6:130834962:G:T	0	0	0	0	0	0	0	0
chr6:131579250:C:T	10	2	12	8	4	1.0	1.0	0.0
chr6:131637345:A:C	0	0	0	0	0	0	0	0
chr6:132589473:G:A	0	0	0	0	0	0	0	0
chr6:132724864:G:A	2	2	4	0	4	2.0	0.0	2.0
chr6:132751511:A:G	52	29	81	23	58	2.0	0.0	2.0
chr6:132814747:A:G	4413	4374	258755	86696	172059	53	18	36
chr6:134029330:G:C	0	0	0	0	0	0	0	0
chr6:134942419:C:A	1	0	1	1	0	1	1	0
chr6:135196858:G:A	6	3	9	3	6	1.5	0.5	1.0
chr6:135203378:A:G	2	0	2	2	0	1.0	1.0	0.0
chr6:135318506:C:T	10	3	13	7	6	1.0	1.0	0.0
chr6:136278255:G:C	746	0	861	861	0	1.0	1.0	0.0
chr6:136278266:T:C	744	0	857	857	0	1.0	1.0	0.0
chr6:136361034:G:A	5	5	10	0	10	2	0	2
chr6:136656430:T:C	41	16	63	27	36	1	1	0
chr6:137219198:C:T	61	29	92	32	60	1	1	0
chr6:137219233:A:G	62	29	93	33	60	1.0	1.0	0.0
chr6:137219383:A:G	174	75	257	105	152	1.0	1.0	0.0
chr6:139166257:T:C	233	128	372	108	264	2	0	2
chr6:139166699:T:C	28	13	43	17	26	2.0	1.0	0.0
chr6:139288618:T:C	73	41	124	36	88	2	0	2
chr6:139373924:G:T	175	88	281	95	186	2	1	2
chr6:142382000:C:T	0	0	0	0	0	0	0	0
chr6:142769666:C:T	62	40	107	23	84	2.0	0.0	2.0
chr6:143760631:C:A	8	7	15	1	14	2.0	0.0	2.0
chr6:143941931:C:T	13	3	16	10	6	1	1	0
chr6:143942395:C:A	11	4	18	8	10	1	1	0
chr6:144548649:A:G	56	31	89	27	62	2.0	0.0	2.0
chr6:144554872:C:T	55	30	86	26	60	2	0	2
chr6:144557201:G:T	52	25	79	28	51	1.0	1.0	0.0
chr6:145686196:C:T	26	17	43	9	34	2.0	0.0	2.0
chr6:146672309:T:C	0	0	0	0	0	0	0	0
chr6:146745957:C:T	0	0	0	0	0	0	0	0
chr6:146785705:A:G	0	0	0	0	0	0	0	0
chr6:147359223:A:G	8	6	14	2	12	2.0	0.0	2.0
chr6:147508937:C:T	0	0	0	0	0	0	0	0
chr6:148440467:C:A	0	0	0	0	0	0	0	0
chr6:148747440:A:C	51	0	52	52	0	1	1	0
chr6:148964583:A:G	0	0	0	0	0	0	0	0
chr6:148964632:T:C	0	0	0	0	0	0	0	0
chr6:149379355:G:A	93	40	136	56	80	1	1	0
chr6:149400554:G:A	163	92	262	76	186	2	0	2
chr6:149409710:G:A	74	34	108	40	68	1.0	1.0	0.0
chr6:149452585:C:G	10	7	17	3	14	2.0	0.0	2.0
chr6:149474556:G:A	118	71	199	53	146	2.0	0.0	2.0
chr6:149632845:C:T	306	147	479	171	308	2.0	1.0	0.0
chr6:149683643:A:G	57	40	100	18	82	2	0	2
chr6:149746539:A:G	26	12	38	14	24	1.0	1.0	0.0
chr6:149793609:G:A	901	498	1614	526	1088	2	1	2
chr6:149888581:C:G	0	0	0	0	0	0	0	0
chr6:149889587:C:T	0	0	0	0	0	0	0	0
chr6:149946391:A:C	0	0	0	0	0	0	0	0
chr6:150021096:G:A	0	0	0	0	0	0	0	0
chr6:150025396:T:C	0	0	0	0	0	0	0	0
chr6:150064594:T:G	1	1	2	0	2	2	0	2
chr6:150800779:G:A	185	85	285	107	178	1	1	0
chr6:151099887:C:G	0	0	0	0	0	0	0	0
chr6:151305899:A:G	498	217	775	325	450	1.0	1.0	0.0
chr6:151348740:A:G	437	273	776	193	583	2	0	2
chr6:151349037:A:C	436	268	788	198	590	2.0	0.0	2.0
chr6:151349762:T:C	145	88	242	60	182	2	0	2
chr6:151353190:AA:AC	86	0	93	93	0	1.0	1.0	0.0
chr6:151365770:C:T	26	15	43	11	32	2.0	0.0	2.0
chr6:151417235:C:T	51	27	79	25	54	2	0	2
chr6:151615542:G:A	0	0	0	0	0	0	0	0
chr6:151618046:G:A	0	0	0	0	0	0	0	0
chr6:151807942:T:C	31	18	50	14	36	2	0	2
chr6:152122626:C:T	130	41	175	93	82	1.0	1.0	0.0
chr6:152310898:G:A	0	0	0	0	0	0	0	0
chr6:152318975:G:A	0	0	0	0	0	0	0	0
chr6:152325144:G:C	0	0	0	0	0	0	0	0
chr6:152344126:C:A	0	0	0	0	0	0	0	0
chr6:152354719:A:G	0	0	0	0	0	0	0	0
chr6:152367432:C:T	0	0	0	0	0	0	0	0
chr6:152369424:G:A	0	0	0	0	0	0	0	0
chr6:152373049:T:C	0	0	0	0	0	0	0	0
chr6:152376571:C:T	0	0	0	0	0	0	0	0
chr6:152721900:G:A	0	0	0	0	0	0	0	0
chr6:152994560:C:T	154	56	222	105	117	1.0	1.0	0.0
chr6:152995191:A:G	161	63	238	104	134	1	1	0
chr6:153002459:C:T	519	226	820	336	484	1	1	0
chr6:153002671:A:G	463	201	728	298	430	1	1	0
chr6:153043965:A:C	1	1	2	0	2	2	0	2
chr6:154010635:T:A	0	0	0	0	0	0	0	0
chr6:155164420:G:A	34	28	68	6	62	2.0	0.0	2.0
chr6:155240662:C:T	6	5	11	1	10	2.0	0.0	2.0
chr6:155248034:C:T	14	1	16	14	2	1.0	1.0	0.0
chr6:155285191:C:T	341	164	548	202	346	2	1	0
chr6:155314451:A:C	363	186	596	203	393	2	1	2
chr6:155314490:A:G	60	28	92	36	56	2.0	1.0	0.0
chr6:155428901:CTCC:TTCT	1	1	2	0	2	2	0	2
chr6:155453474:C:T	0	0	0	0	0	0	0	0
chr6:157084796:G:A	37	16	54	22	32	1	1	0
chr6:157323556:C:G	2	1	3	1	2	1.5	0.5	1.0
chr6:158096276:A:G	1	0	1	1	0	1	1	0
chr6:158449049:A:G	8	4	12	4	8	1.5	0.5	1.0
chr6:158644726:C:G	1881	1109	3921	1237	2684	2	1	2
chr6:158757313:C:T	74	38	119	41	78	2.0	0.5	2.0
chr6:158763430:A:G	18	8	26	10	16	1.0	1.0	0.0
chr6:158764531:T:A	29	11	40	18	22	1	1	0
chr6:158977771:C:T	19	5	25	15	10	1	1	0
chr6:159777363:G:A	363	210	647	187	460	2	0	2
chr6:159803980:T:G	1	0	1	1	0	1	1	0
chr6:160047246:A:G	8	4	12	4	8	1.5	0.5	1.0
chr6:160122116:C:T	0	0	0	0	0	0	0	0
chr6:160130172:G:C	2	2	4	0	4	2.0	0.0	2.0
chr6:160139813:A:G	6	3	9	3	6	1.5	0.5	1.0
chr6:160258368:C:A	0	0	0	0	0	0	0	0
chr6:160348779:C:T	0	0	0	0	0	0	0	0
chr6:160437156:G:A	0	0	0	0	0	0	0	0
chr6:160451119:C:T	0	0	0	0	0	0	0	0
chr6:160531806:G:A	0	0	0	0	0	0	0	0
chr6:160548597:A:G	0	0	0	0	0	0	0	0
chr6:160741374:T:C	0	0	0	0	0	0	0	0
chr6:160752914:T:G	0	0	0	0	0	0	0	0
chr6:161136617:A:G	11	7	18	4	14	2	0	2
chr6:161136630:G:A	11	7	18	4	14	2	0	2
chr6:166158447:C:T	14	14	32	0	32	2.0	0.0	2.0
chr6:166158557:C:T	12	0	14	14	0	1.0	1.0	0.0
chr6:166165782:C:T	9	9	18	0	18	2	0	2
chr6:166167659:T:C	7	7	14	0	14	2	0	2
chr6:166324492:G:A	16	8	24	8	16	1.5	0.5	1.0
chr6:166342487:TGTTA:CGTTC	1958	1184	4534	1465	3069	2.0	1.0	2.0
chr6:166538776:G:A	33	19	52	14	38	2	0	2
chr6:167000051:T:C	6	3	9	3	6	1.5	0.5	1.0
chr6:167136287:T:C	2	0	2	2	0	1.0	1.0	0.0
chr6:167136554:C:T	3	0	3	3	0	1	1	0
chr6:167177053:G:A	0	0	0	0	0	0	0	0
chr6:167179036:T:C	0	0	0	0	0	0	0	0
chr6:167179088:G:A	0	0	0	0	0	0	0	0
chr6:167376127:C:T	0	0	0	0	0	0	0	0
chr6:167382927:A:C	0	0	0	0	0	0	0	0
chr6:168057121:A:G	0	0	0	0	0	0	0	0
chr6:168057286:G:A	0	0	0	0	0	0	0	0
chr6:168059165:G:C	0	0	0	0	0	0	0	0
chr6:168065824:A:G	0	0	0	0	0	0	0	0
chr6:168067506:G:T	0	0	0	0	0	0	0	0
chr6:168078924:G:A	0	0	0	0	0	0	0	0
chr6:168079110:C:T	0	0	0	0	0	0	0	0
chr6:169234714:C:T	0	0	0	0	0	0	0	0
chr6:169237374:G:T	0	0	0	0	0	0	0	0
chr6:169239806:C:T	0	0	0	0	0	0	0	0
chr6:169248672:G:A	0	0	0	0	0	0	0	0
chr6:169665329:G:A	1	1	2	0	2	2	0	2
chr6:169710308:T:C	157	87	263	79	184	2	0	2
chr6:169744132:C:A	4	2	6	2	4	1.5	0.5	1.0
chr6:169781420:A:G	70	41	117	31	86	2.0	0.0	2.0
chr7:255994:T:A	0	0	0	0	0	0	0	0
chr7:260010:G:A	0	0	0	0	0	0	0	0
chr7:579301:A:G	190	105	341	103	238	2.0	1.0	2.0
chr7:754772:G:A	7	5	12	2	10	2	0	2
chr7:900544:C:T	0	0	0	0	0	0	0	0
chr7:983377:C:T	0	0	0	0	0	0	0	0
chr7:987262:T:C	0	0	0	0	0	0	0	0
chr7:1058311:G:A	2	1	3	1	2	1.5	0.5	1.0
chr7:1091720:T:C	2	1	3	1	2	1.5	0.5	1.0
chr7:1092439:T:C	0	0	0	0	0	0	0	0
chr7:1155628:T:C	15	6	21	9	12	1	1	0
chr7:1434706:A:T	0	0	0	0	0	0	0	0
chr7:1436884:C:A	0	0	0	0	0	0	0	0
chr7:1437477:T:C	0	0	0	0	0	0	0	0
chr7:1438771:G:A	0	0	0	0	0	0	0	0
chr7:1438859:A:G	3	0	3	3	0	1	1	0
chr7:1438974:C:T	3	0	3	3	0	1	1	0
chr7:1439008:G:A	0	0	0	0	0	0	0	0
chr7:1440023:T:C	3	0	3	3	0	1	1	0
chr7:1442465:C:G	1	0	1	1	0	1	1	0
chr7:1444951:C:T	1	0	1	1	0	1	1	0
chr7:1446815:G:A	0	0	0	0	0	0	0	0
chr7:1482521:T:C	7	2	9	5	4	1	1	0
chr7:1493877:A:G	2	1	3	1	2	1.5	0.5	1.0
chr7:1503061:G:A	14	5	19	9	10	1.0	1.0	0.0
chr7:1503178:T:C	16	5	21	11	10	1.0	1.0	0.0
chr7:1555432:G:A	1	0	1	1	0	1	1	0
chr7:2250887:C:T	1303	940	3363	631	2732	2	0	2
chr7:2598713:C:G	1	1	2	0	2	2	0	2
chr7:2604885:C:T	7	6	13	1	12	2	0	2
chr7:2607316:T:G	1	0	1	1	0	1	1	0
chr7:2607414:C:G	1	1	2	0	2	2	0	2
chr7:2610070:T:G	11	8	19	3	16	2	0	2
chr7:2610185:C:T	11	8	19	3	16	2	0	2
chr7:2652844:G:C	5	3	8	2	6	2	0	2
chr7:2709124:G:C	1	0	1	1	0	1	1	0
chr7:2709169:C:T	1	0	1	1	0	1	1	0
chr7:2712518:G:A	9	1	10	8	2	1	1	0
chr7:2712521:G:A	9	8	17	1	16	2	0	2
chr7:2762873:C:G	7	4	11	3	8	2	0	2
chr7:2762888:T:C	7	4	11	3	8	2	0	2
chr7:2917371:T:C	139	57	199	85	114	1	1	0
chr7:3974407:C:T	0	0	0	0	0	0	0	0
chr7:4132374:C:T	0	0	0	0	0	0	0	0
chr7:4132477:C:T	0	0	0	0	0	0	0	0
chr7:4149443:G:C	0	0	0	0	0	0	0	0
chr7:4268765:G:T	0	0	0	0	0	0	0	0
chr7:4834789:G:C	0	0	0	0	0	0	0	0
chr7:4836426:C:T	0	0	0	0	0	0	0	0
chr7:5214430:G:A	4	1	5	3	2	1.0	1.0	0.0
chr7:5299083:T:C	1	0	1	1	0	1	1	0
chr7:5308118:G:A	1	1	2	0	2	2	0	2
chr7:5357084:T:C	18	12	32	6	26	2.0	0.0	2.0
chr7:5359413:C:G	20	10	32	10	22	1.5	0.5	1.0
chr7:5394504:A:G	35	15	51	21	30	1	1	0
chr7:5481837:G:A	4	4	8	0	8	2.0	0.0	2.0
chr7:5491323:G:A	11	8	19	3	16	2	0	2
chr7:5500613:A:C	7	4	11	3	8	2	0	2
chr7:5501378:C:A	7	5	12	2	10	2	0	2
chr7:5502026:G:A	9	6	15	3	12	2	0	2
chr7:5528735:A:G	99	69	171	31	140	2	0	2
chr7:6009342:C:A	235	137	398	113	285	2	0	2
chr7:6023197:C:A	14	10	28	4	24	2.0	0.0	2.0
chr7:6026819:T:C	167	81	261	91	170	1	1	0
chr7:6026830:T:C	166	81	258	90	168	1.5	1.0	0.0
chr7:6153890:G:C	33	20	53	13	40	2	0	2
chr7:6165368:A:C	0	0	0	0	0	0	0	0
chr7:6409865:T:C	32	13	45	19	26	1.0	1.0	0.0
chr7:6409954:C:T	31	12	43	19	24	1	1	0
chr7:6416716:G:T	6	2	8	4	4	1.0	1.0	0.0
chr7:6474148:T:C	863	456	1543	527	1016	2	1	2
chr7:6551377:C:T	0	0	0	0	0	0	0	0
chr7:6621159:G:A	3	2	5	1	4	2	0	2
chr7:6621625:C:G	1	1	2	0	2	2	0	2
chr7:6643823:A:G	5	3	8	2	6	2	0	2
chr7:6900589:T:G	0	0	0	0	0	0	0	0
chr7:7456104:T:C	0	0	0	0	0	0	0	0
chr7:9726520:G:A	0	0	0	0	0	0	0	0
chr7:9727336:T:G	0	0	0	0	0	0	0	0
chr7:9727794:C:G	0	0	0	0	0	0	0	0
chr7:9727882:C:A	0	0	0	0	0	0	0	0
chr7:9728004:G:C	0	0	0	0	0	0	0	0
chr7:9728157:A:C	0	0	0	0	0	0	0	0
chr7:11481915:T:C	0	0	0	0	0	0	0	0
chr7:11541494:T:C	0	0	0	0	0	0	0	0
chr7:11636750:G:A	0	0	0	0	0	0	0	0
chr7:12351693:G:T	0	0	0	0	0	0	0	0
chr7:12357271:C:T	0	0	0	0	0	0	0	0
chr7:12370486:G:A	0	0	0	0	0	0	0	0
chr7:12379482:A:T	0	0	0	0	0	0	0	0
chr7:12688201:G:C	11	8	19	3	16	2	0	2
chr7:12688864:A:G	5	2	7	3	4	1	1	0
chr7:13939184:T:C	0	0	0	0	0	0	0	0
chr7:14176817:A:G	0	0	0	0	0	0	0	0
chr7:14178048:G:A	0	0	0	0	0	0	0	0
chr7:15686441:G:A	0	0	0	0	0	0	0	0
chr7:16465716:T:C	0	0	0	0	0	0	0	0
chr7:16600733:T:C	45	25	77	21	56	2	0	2
chr7:16615762:C:T	69	40	117	31	86	2	0	2
chr7:17839861:T:C	11	8	19	3	16	2	0	2
chr7:17839930:G:A	23	10	33	13	20	1	1	0
chr7:18026946:C:A	0	0	0	0	0	0	0	0
chr7:18727720:A:G	8	4	12	4	8	1.5	0.5	1.0
chr7:20159107:C:T	0	0	0	0	0	0	0	0
chr7:20643581:G:T	0	0	0	0	0	0	0	0
chr7:20651596:G:A	0	0	0	0	0	0	0	0
chr7:20728390:G:A	0	0	0	0	0	0	0	0
chr7:20786833:T:G	0	0	0	0	0	0	0	0
chr7:21543299:C:T	2	2	6	0	6	3.0	0.0	3.0
chr7:21582013:G:A	1	0	1	1	0	1	1	0
chr7:21599954:A:G	0	0	0	0	0	0	0	0
chr7:21639025:A:G	0	0	0	0	0	0	0	0
chr7:21725879:G:A	0	0	0	0	0	0	0	0
chr7:21735825:G:A	0	0	0	0	0	0	0	0
chr7:21738831:C:T	0	0	0	0	0	0	0	0
chr7:21739660:A:G	0	0	0	0	0	0	0	0
chr7:21816533:G:A	1	1	2	0	2	2	0	2
chr7:21854375:G:T	5	1	6	4	2	1	1	0
chr7:21901205:A:G	138	83	236	64	172	2.0	0.0	2.0
chr7:21904104:T:C	8	5	13	3	10	2.0	0.0	2.0
chr7:22220051:C:A	1	0	1	1	0	1	1	0
chr7:22493833:C:T	0	0	0	0	0	0	0	0
chr7:22773688:T:C	0	0	0	0	0	0	0	0
chr7:22817970:T:C	32	14	47	19	28	1.0	1.0	0.0
chr7:22818063:A:G	11	8	19	3	16	2	0	2
chr7:23200644:G:A	221	121	360	107	253	2	0	2
chr7:23317702:C:T	0	0	0	0	0	0	0	0
chr7:24285140:T:G	0	0	0	0	0	0	0	0
chr7:24285189:C:G	0	0	0	0	0	0	0	0
chr7:24285390:G:A	0	0	0	0	0	0	0	0
chr7:24719176:T:C	18	12	31	7	24	2.0	0.0	2.0
chr7:25136079:G:A	50	25	75	25	50	1.5	0.5	1.0
chr7:25228475:C:T	0	0	0	0	0	0	0	0
chr7:27458639:G:A	0	0	0	0	0	0	0	0
chr7:27458713:A:T	0	0	0	0	0	0	0	0
chr7:27458801:T:C	1	1	2	0	2	2	0	2
chr7:27662771:C:A	274	154	458	130	328	2.0	0.0	2.0
chr7:28956184:G:A	0	0	0	0	0	0	0	0
chr7:28956604:G:A	0	0	0	0	0	0	0	0
chr7:28956941:C:T	0	0	0	0	0	0	0	0
chr7:28957525:G:C	0	0	0	0	0	0	0	0
chr7:29146960:A:G	0	0	0	0	0	0	0	0
chr7:29566359:C:G	0	0	0	0	0	0	0	0
chr7:29566672:C:T	0	0	0	0	0	0	0	0
chr7:29940855:C:T	179	82	266	102	164	1	1	0
chr7:30755672:A:G	0	0	0	0	0	0	0	0
chr7:30755715:A:G	0	0	0	0	0	0	0	0
chr7:30791528:C:T	5	1	6	4	2	1	1	0
chr7:30969071:G:A	0	0	0	0	0	0	0	0
chr7:30969831:A:G	0	0	0	0	0	0	0	0
chr7:31553119:C:A	0	0	0	0	0	0	0	0
chr7:31642839:C:T	0	0	0	0	0	0	0	0
chr7:31642987:T:C	0	0	0	0	0	0	0	0
chr7:31643239:T:C	0	0	0	0	0	0	0	0
chr7:31643796:G:A	0	0	0	0	0	0	0	0
chr7:31815955:G:A	0	0	0	0	0	0	0	0
chr7:32169847:C:T	0	0	0	0	0	0	0	0
chr7:32869570:G:A	42	27	71	17	54	2.0	0.0	2.0
chr7:32963559:G:A	0	0	0	0	0	0	0	0
chr7:32974792:G:A	0	0	0	0	0	0	0	0
chr7:33605329:T:C	37	20	61	17	44	2	0	2
chr7:33605336:C:T	37	20	61	17	44	2	0	2
chr7:33970334:C:T	0	0	0	0	0	0	0	0
chr7:34085808:G:T	0	0	0	0	0	0	0	0
chr7:34778501:A:T	0	0	0	0	0	0	0	0
chr7:35253582:A:G	0	0	0	0	0	0	0	0
chr7:35670232:C:T	112	58	172	56	116	2.0	0.0	2.0
chr7:36406246:AG:CA	0	0	0	0	0	0	0	0
chr7:36513048:G:A	0	0	0	0	0	0	0	0
chr7:37259195:C:T	306	143	463	171	292	1.0	1.0	0.0
chr7:37867702:T:C	0	0	0	0	0	0	0	0
chr7:37912124:G:A	0	0	0	0	0	0	0	0
chr7:37914238:C:T	0	0	0	0	0	0	0	0
chr7:37948987:C:T	10	7	17	3	14	2.0	0.0	2.0
chr7:38391829:A:G	0	0	0	0	0	0	0	0
chr7:38391835:C:T	0	0	0	0	0	0	0	0
chr7:38391869:G:A	0	0	0	0	0	0	0	0
chr7:38391880:C:A	0	0	0	0	0	0	0	0
chr7:38394126:T:G	1	1	2	0	2	2	0	2
chr7:39085813:T:G	0	0	0	0	0	0	0	0
chr7:39433082:C:T	0	0	0	0	0	0	0	0
chr7:39433109:A:G	0	0	0	0	0	0	0	0
chr7:39433247:G:A	0	0	0	0	0	0	0	0
chr7:39609676:G:A	0	0	0	0	0	0	0	0
chr7:39609857:G:C	0	0	0	0	0	0	0	0
chr7:40860368:G:C	0	0	0	0	0	0	0	0
chr7:40860576:A:G	0	0	0	0	0	0	0	0
chr7:42048623:T:C	0	0	0	0	0	0	0	0
chr7:42223069:G:T	0	0	0	0	0	0	0	0
chr7:42912047:C:T	9	6	17	3	14	2	0	2
chr7:43444711:T:C	0	0	0	0	0	0	0	0
chr7:43552233:G:A	0	0	0	0	0	0	0	0
chr7:43876892:G:A	11	5	16	6	10	1	1	0
chr7:43877128:T:G	6	4	10	2	8	2.0	0.0	2.0
chr7:43877414:G:A	3	2	5	1	4	2	0	2
chr7:43942742:G:C	2	2	4	0	4	2.0	0.0	2.0
chr7:43942883:A:C	2	2	4	0	4	2.0	0.0	2.0
chr7:44007245:A:G	14	5	19	9	10	1.0	1.0	0.0
chr7:44007467:T:C	12	4	16	8	8	1.0	1.0	0.0
chr7:44014753:T:C	182	110	310	78	232	2.0	0.0	2.0
chr7:44029282:A:G	73	23	101	54	47	1	1	0
chr7:44029621:G:A	65	19	90	50	40	1	1	0
chr7:44034099:C:G	8	2	10	6	4	1.0	1.0	0.0
chr7:44036751:T:C	63	13	79	53	26	1	1	0
chr7:44040854:G:A	2	1	3	1	2	1.5	0.5	1.0
chr7:44044693:C:G	190	102	302	98	204	2.0	0.0	2.0
chr7:44050305:A:G	5	4	9	1	8	2	0	2
chr7:44051744:A:G	11	5	16	6	10	1	1	0
chr7:44060065:T:C	519	268	842	278	564	2	1	2
chr7:44073274:G:T	94	60	162	38	124	2.0	0.0	2.0
chr7:44074057:T:C	5	3	8	2	6	2	0	2
chr7:44108954:A:G	21	12	33	9	24	2	0	2
chr7:44140445:T:A	0	0	0	0	0	0	0	0
chr7:44146057:G:T	0	0	0	0	0	0	0	0
chr7:44220107:G:A	0	0	0	0	0	0	0	0
chr7:44220272:C:T	0	0	0	0	0	0	0	0
chr7:44969726:G:A	25	12	37	13	24	1	1	0
chr7:45027668:G:C	54	42	100	12	88	2.0	0.0	2.0
chr7:45038379:G:A	499	332	892	194	698	2	0	2
chr7:45073571:G:A	762	319	1224	544	680	1.0	1.0	0.0
chr7:45082865:A:C	1	1	2	0	2	2	0	2
chr7:45083124:G:A	1	1	2	0	2	2	0	2
chr7:45084338:T:C	0	0	0	0	0	0	0	0
chr7:45084409:T:C	0	0	0	0	0	0	0	0
chr7:45084687:A:G	1	0	1	1	0	1	1	0
chr7:45084866:A:T	1	0	1	1	0	1	1	0
chr7:45102546:T:C	4	2	6	2	4	1.5	0.5	1.0
chr7:45109068:G:A	83	51	134	32	102	2	0	2
chr7:45109174:C:A	93	58	151	35	116	2	0	2
chr7:45183419:C:G	0	0	0	0	0	0	0	0
chr7:45662163:C:T	0	0	0	0	0	0	0	0
chr7:47368432:A:G	1	0	1	1	0	1	1	0
chr7:47369377:T:A	4	0	4	4	0	1.0	1.0	0.0
chr7:47812025:C:T	0	0	0	0	0	0	0	0
chr7:47813239:C:T	0	0	0	0	0	0	0	0
chr7:47815358:C:T	0	0	0	0	0	0	0	0
chr7:47833247:A:G	0	0	0	0	0	0	0	0
chr7:47839451:G:A	1	1	2	0	2	2	0	2
chr7:47880747:G:A	0	0	0	0	0	0	0	0
chr7:47882084:A:T	0	0	0	0	0	0	0	0
chr7:47885733:C:G	0	0	0	0	0	0	0	0
chr7:48389118:A:T	0	0	0	0	0	0	0	0
chr7:48847011:A:G	0	0	0	0	0	0	0	0
chr7:48847150:C:T	0	0	0	0	0	0	0	0
chr7:48925155:G:A	0	0	0	0	0	0	0	0
chr7:49775794:C:G	0	0	0	0	0	0	0	0
chr7:50141376:C:T	0	0	0	0	0	0	0	0
chr7:50368335:A:G	57	16	81	45	36	1	1	0
chr7:50400243:C:T	63	34	98	30	68	2	0	2
chr7:50400636:C:T	75	39	114	36	78	2	0	2
chr7:50479886:A:C	0	0	0	0	0	0	0	0
chr7:50605210:T:C	0	0	0	0	0	0	0	0
chr7:50606465:G:A	0	0	0	0	0	0	0	0
chr7:50674483:C:T	0	0	0	0	0	0	0	0
chr7:51219773:A:G	0	0	0	0	0	0	0	0
chr7:53035678:G:T	0	0	0	0	0	0	0	0
chr7:53035689:G:T	0	0	0	0	0	0	0	0
chr7:53035861:C:G	0	0	0	0	0	0	0	0
chr7:53035878:G:A	0	0	0	0	0	0	0	0
chr7:53035980:C:A	0	0	0	0	0	0	0	0
chr7:53036253:G:C	0	0	0	0	0	0	0	0
chr7:53036385:G:A	0	0	0	0	0	0	0	0
chr7:53188169:C:T	0	0	0	0	0	0	0	0
chr7:53188631:T:C	0	0	0	0	0	0	0	0
chr7:54550317:C:T	0	0	0	0	0	0	0	0
chr7:55146655:C:T	0	0	0	0	0	0	0	0
chr7:55562030:A:G	88	56	152	33	119	2.0	0.0	2.0
chr7:55923599:G:A	1	0	1	1	0	1	1	0
chr7:55954996:G:A	275	152	489	143	346	2	0	2
chr7:56078132:G:A	910	519	1664	490	1174	2.0	0.0	2.0
chr7:56079896:A:G	750	417	1322	402	920	2.0	0.0	2.0
chr7:57121011:T:C	0	0	0	0	0	0	0	0
chr7:63560100:T:G	0	0	0	0	0	0	0	0
chr7:63580089:G:A	0	0	0	0	0	0	0	0
chr7:64077471:G:A	0	0	0	0	0	0	0	0
chr7:64219355:A:G	0	0	0	0	0	0	0	0
chr7:64794523:T:C	489	227	781	301	480	2	1	0
chr7:64991331:C:T	54	20	75	35	40	1.0	1.0	0.0
chr7:64992452:C:T	32	15	50	20	30	1.5	1.0	0.0
chr7:66114938:G:A	685	367	1169	384	785	2	1	2
chr7:67286291:C:T	5	4	9	1	8	2	0	2
chr7:67309617:G:C	291	153	472	150	322	2	1	2
chr7:70787199:A:G	1	0	1	1	0	1	1	0
chr7:72829753:A:G	1056	562	1899	643	1256	2.0	1.0	2.0
chr7:72943335:T:C	18	12	31	7	24	2.0	0.0	2.0
chr7:72948424:T:C	394	228	652	178	474	2.0	0.0	2.0
chr7:72948863:C:A	14	6	20	8	12	1.0	1.0	0.0
chr7:73303936:T:C	228	121	364	116	248	2.0	0.0	2.0
chr7:73305022:G:A	181	99	287	87	200	2	0	2
chr7:73318886:C:T	1	0	1	1	0	1	1	0
chr7:73477424:C:T	191	84	300	116	184	1	1	0
chr7:73570818:C:T	42	22	66	20	46	2.0	0.0	2.0
chr7:73605971:T:C	0	0	0	0	0	0	0	0
chr7:73683390:G:C	472	257	767	239	528	2.0	0.0	2.0
chr7:73700871:G:A	7	5	12	2	10	2	0	2
chr7:73708593:A:G	6	3	9	3	6	1.5	0.5	1.0
chr7:73708647:G:A	5	2	7	3	4	1	1	0
chr7:74052018:G:A	0	0	0	0	0	0	0	0
chr7:74056384:G:A	0	0	0	0	0	0	0	0
chr7:74060495:G:C	0	0	0	0	0	0	0	0
chr7:74195381:G:C	185	92	287	99	188	2	1	0
chr7:74216847:C:G	382	203	633	217	416	2.0	1.0	2.0
chr7:74249032:T:C	198	90	296	112	184	1.0	1.0	0.0
chr7:74338920:T:C	0	0	0	0	0	0	0	0
chr7:75042928:C:T	105	44	152	64	88	1	1	0
chr7:75414928:G:A	105	41	153	67	86	1	1	0
chr7:75415153:T:C	130	53	190	82	108	1.0	1.0	0.0
chr7:75419467:A:G	3	0	3	3	0	1	1	0
chr7:75494199:G:T	47	10	60	40	20	1	1	0
chr7:75501512:G:C	7	3	10	4	6	1	1	0
chr7:75811790:CGGG:TGGT	0	0	0	0	0	0	0	0
chr7:75980359:A:G	26	12	38	14	24	1.0	1.0	0.0
chr7:75983485:C:T	1	0	1	1	0	1	1	0
chr7:75985688:C:T	80	47	130	35	95	2.0	0.0	2.0
chr7:76000956:T:C	195	109	260	92	168	1	0	1
chr7:76005369:G:A	294	169	484	134	350	2.0	0.0	2.0
chr7:76048186:C:T	1546	865	3073	1073	2000	2.0	1.0	2.0
chr7:76329871:G:A	100	47	151	55	96	1.0	1.0	0.0
chr7:76404488:A:T	0	0	0	0	0	0	0	0
chr7:76425055:G:A	4	4	9	1	8	2.0	0.0	2.0
chr7:76429450:G:T	0	0	0	0	0	0	0	0
chr7:76440494:T:C	7	7	17	1	16	2	0	2
chr7:76482677:C:G	23	11	35	13	22	2	1	0
chr7:76482743:C:T	13	7	20	6	14	2	0	2
chr7:76502378:A:G	28	11	39	17	22	1.0	1.0	0.0
chr7:76510869:T:C	0	0	0	0	0	0	0	0
chr7:76515166:A:G	5	1	9	7	2	2	2	0
chr7:76980778:C:T	25	8	36	18	18	1	1	0
chr7:77004907:C:T	0	0	0	0	0	0	0	0
chr7:77004920:G:A	0	0	0	0	0	0	0	0
chr7:77121935:C:G	143	68	221	76	145	1	1	0
chr7:77282510:G:A	23	17	46	8	38	2	0	2
chr7:77311296:A:G	106	52	166	56	110	1.0	1.0	0.0
chr7:77329413:A:G	16	6	22	10	12	1.0	1.0	0.0
chr7:77355255:G:A	92	44	139	49	90	1.0	1.0	0.0
chr7:77618504:G:A	84	44	132	42	90	2.0	0.0	2.0
chr7:77794257:G:A	215	109	352	122	230	2	1	2
chr7:77840169:C:T	2	1	3	1	2	1.5	0.5	1.0
chr7:78160086:A:G	0	0	0	0	0	0	0	0
chr7:80789373:A:G	0	0	0	0	0	0	0	0
chr7:82915671:A:G	0	0	0	0	0	0	0	0
chr7:82952543:C:T	0	0	0	0	0	0	0	0
chr7:82953530:C:T	0	0	0	0	0	0	0	0
chr7:83135109:C:G	0	0	0	0	0	0	0	0
chr7:83155781:T:C	0	0	0	0	0	0	0	0
chr7:83408435:C:A	0	0	0	0	0	0	0	0
chr7:87876657:G:A	935	511	1672	548	1124	2	1	2
chr7:87907862:A:G	127	58	195	73	122	1	1	0
chr7:87935182:C:G	0	0	0	0	0	0	0	0
chr7:89334686:C:T	0	0	0	0	0	0	0	0
chr7:89334882:T:A	0	0	0	0	0	0	0	0
chr7:89336334:T:G	0	0	0	0	0	0	0	0
chr7:90232576:G:T	0	0	0	0	0	0	0	0
chr7:90232628:C:T	0	0	0	0	0	0	0	0
chr7:90352818:T:C	331	159	500	178	322	1	1	0
chr7:90385094:G:A	151	77	239	75	164	2	0	2
chr7:90709536:C:T	115	76	211	45	166	2	0	2
chr7:91873914:C:T	38	22	61	17	44	2.0	0.0	2.0
chr7:92398223:C:G	72	40	121	35	86	2.0	0.0	2.0
chr7:92398725:C:A	132	61	207	73	134	1.0	1.0	0.0
chr7:92469462:C:T	3	2	5	1	4	2	0	2
chr7:92532521:A:C	216	123	375	107	268	2.0	0.0	2.0
chr7:92618225:A:G	0	0	0	0	0	0	0	0
chr7:93105670:A:G	932	518	1674	528	1146	2.0	1.0	2.0
chr7:93131425:T:G	327	154	536	227	309	2	1	0
chr7:93232348:C:T	2	2	4	0	4	2.0	0.0	2.0
chr7:93341535:C:T	11	5	16	6	10	1	1	0
chr7:93922116:C:T	0	0	0	0	0	0	0	0
chr7:94426621:T:C	0	0	0	0	0	0	0	0
chr7:94426932:C:G	0	0	0	0	0	0	0	0
chr7:94665670:C:T	2	2	4	0	4	2.0	0.0	2.0
chr7:95269313:C:T	23	22	47	1	46	2	0	2
chr7:95269499:G:A	22	22	45	0	45	2.0	0.0	2.0
chr7:95372243:C:T	0	0	0	0	0	0	0	0
chr7:95394734:A:G	0	0	0	0	0	0	0	0
chr7:95585599:T:C	0	0	0	0	0	0	0	0
chr7:97020904:G:T	0	0	0	0	0	0	0	0
chr7:97859257:A:T	47	25	75	23	52	2	0	2
chr7:99185127:C:T	0	0	0	0	0	0	0	0
chr7:99203211:A:G	0	0	0	0	0	0	0	0
chr7:99479613:G:C	12	6	18	6	12	1.5	0.5	1.0
chr7:99622567:C:T	50	27	78	24	54	2.0	0.0	2.0
chr7:99876804:A:G	0	0	0	0	0	0	0	0
chr7:99971771:G:A	0	0	0	0	0	0	0	0
chr7:99986027:G:A	0	0	0	0	0	0	0	0
chr7:99987527:G:T	0	0	0	0	0	0	0	0
chr7:100077247:C:A	14	6	25	9	16	1.0	1.0	0.0
chr7:100099174:T:C	39	19	60	20	40	1	1	0
chr7:100102003:T:C	39	16	62	24	38	1	1	0
chr7:100107173:A:T	276	142	454	152	302	2.0	1.0	2.0
chr7:100107204:A:G	267	140	440	144	296	2	1	2
chr7:100110089:A:G	10	5	15	5	10	1.5	0.5	1.0
chr7:100110327:C:T	5	0	5	5	0	1	1	0
chr7:100113417:G:A	4	2	8	2	6	1.5	0.5	1.0
chr7:100149507:G:A	3186	2122	10055	3588	6467	3.0	1.0	2.0
chr7:100155498:A:G	3	2	5	1	4	2	0	2
chr7:100159989:G:A	9	4	14	6	8	2	1	0
chr7:100160513:T:G	11	4	15	7	8	1	1	0
chr7:100373690:T:C	3	1	4	2	2	1	1	0
chr7:100374211:A:G	6	4	12	2	10	2.0	0.0	2.0
chr7:100417088:T:C	16	5	21	11	10	1.0	1.0	0.0
chr7:100467096:A:G	349	183	573	185	388	2	0	2
chr7:100562641:T:C	8	4	14	4	10	1.5	0.5	1.0
chr7:100574165:C:A	252	144	418	118	300	2.0	0.0	2.0
chr7:100577850:T:C	96	53	150	44	106	2.0	0.0	2.0
chr7:100582437:G:A	106	59	167	49	118	2.0	0.0	2.0
chr7:100750761:T:C	0	0	0	0	0	0	0	0
chr7:100773477:C:A	0	0	0	0	0	0	0	0
chr7:100773491:C:T	0	0	0	0	0	0	0	0
chr7:100773794:G:A	1	0	1	1	0	1	1	0
chr7:100776465:A:G	1	0	1	1	0	1	1	0
chr7:100789278:T:C	0	0	0	0	0	0	0	0
chr7:100793959:T:C	0	0	0	0	0	0	0	0
chr7:100822533:A:G	0	0	0	0	0	0	0	0
chr7:100858973:G:A	3	0	3	3	0	1	1	0
chr7:100868819:G:A	46	27	73	19	54	2.0	0.0	2.0
chr7:100870481:G:A	1	0	1	1	0	1	1	0
chr7:100886760:T:G	6	4	10	2	8	2.0	0.0	2.0
chr7:100889133:G:C	9	5	14	4	10	2	0	2
chr7:100955225:T:A	1	1	2	0	2	2	0	2
chr7:100964820:T:C	0	0	0	0	0	0	0	0
chr7:100965208:C:T	0	0	0	0	0	0	0	0
chr7:100965216:G:C	0	0	0	0	0	0	0	0
chr7:100965345:C:A	0	0	0	0	0	0	0	0
chr7:100966333:G:C	0	0	0	0	0	0	0	0
chr7:100991195:C:G	0	0	0	0	0	0	0	0
chr7:100991359:T:G	0	0	0	0	0	0	0	0
chr7:101004594:C:A	0	0	0	0	0	0	0	0
chr7:101004639:A:C	0	0	0	0	0	0	0	0
chr7:101004748:G:A	0	0	0	0	0	0	0	0
chr7:101004836:C:G	0	0	0	0	0	0	0	0
chr7:101032695:G:A	0	0	0	0	0	0	0	0
chr7:101036085:A:G	0	0	0	0	0	0	0	0
chr7:101036621:A:G	0	0	0	0	0	0	0	0
chr7:101037930:G:C	0	0	0	0	0	0	0	0
chr7:101037940:G:C	0	0	0	0	0	0	0	0
chr7:101038078:C:G	0	0	0	0	0	0	0	0
chr7:101038481:A:G	0	0	0	0	0	0	0	0
chr7:101039940:A:G	0	0	0	0	0	0	0	0
chr7:101050568:C:T	0	0	0	0	0	0	0	0
chr7:101087903:C:T	79	38	120	42	78	1	1	0
chr7:101088357:C:T	84	43	130	42	88	2.0	0.0	2.0
chr7:101088548:T:C	90	41	135	51	84	1.0	1.0	0.0
chr7:101128436:G:A	4	2	6	2	4	1.5	0.5	1.0
chr7:101613553:T:C	0	0	0	0	0	0	0	0
chr7:102273376:G:A	1	0	1	1	0	1	1	0
chr7:102274250:G:A	1	1	2	0	2	2	0	2
chr7:102285204:C:G	0	0	0	0	0	0	0	0
chr7:102425204:C:T	187	112	309	80	229	2	0	2
chr7:102473107:C:T	466	254	809	251	558	2.0	1.0	2.0
chr7:102572618:A:T	3	2	5	1	4	2	0	2
chr7:102787442:C:T	20	10	30	10	20	1.5	0.5	1.0
chr7:102822189:T:C	2	0	2	2	0	1.0	1.0	0.0
chr7:102973690:C:A	0	0	0	0	0	0	0	0
chr7:102976022:G:A	1	0	1	1	0	1	1	0
chr7:103515258:A:G	0	0	0	0	0	0	0	0
chr7:103515417:A:G	0	0	0	0	0	0	0	0
chr7:104667983:G:A	6	0	6	6	0	1.0	1.0	0.0
chr7:105532238:G:C	329	169	539	177	362	2	1	2
chr7:106018005:G:A	0	0	0	0	0	0	0	0
chr7:106020404:A:G	0	0	0	0	0	0	0	0
chr7:106022244:T:C	0	0	0	0	0	0	0	0
chr7:106032431:G:T	154	65	251	101	150	1.0	1.0	0.0
chr7:107159552:G:A	3	1	4	2	2	1	1	0
chr7:107362361:A:G	88	44	136	46	90	2.0	0.5	1.0
chr7:107923921:T:G	4	2	6	2	4	1.5	0.5	1.0
chr7:107929072:A:G	26	11	41	15	26	1.0	1.0	0.0
chr7:107929517:A:G	18	12	30	6	24	2.0	0.0	2.0
chr7:107940394:A:G	1	1	2	0	2	2	0	2
chr7:108209464:G:A	2	2	4	0	4	2.0	0.0	2.0
chr7:111739142:G:C	0	0	0	0	0	0	0	0
chr7:112340952:G:A	143	66	214	80	134	1	1	0
chr7:112457066:C:T	236	106	365	145	220	1.0	1.0	0.0
chr7:112462300:T:G	43	23	66	20	46	2	0	2
chr7:112467944:T:C	9	3	12	6	6	1	1	0
chr7:113084740:G:T	0	0	0	0	0	0	0	0
chr7:115940875:C:T	1	0	1	1	0	1	1	0
chr7:116500470:G:T	0	0	0	0	0	0	0	0
chr7:116795968:G:A	0	0	0	0	0	0	0	0
chr7:116796043:G:A	0	0	0	0	0	0	0	0
chr7:117480087:G:C	0	0	0	0	0	0	0	0
chr7:120788553:G:A	0	0	0	0	0	0	0	0
chr7:120788745:C:A	0	0	0	0	0	0	0	0
chr7:121100049:G:T	7	3	10	4	6	1	1	0
chr7:121124423:G:C	2	1	3	1	2	1.5	0.5	1.0
chr7:121329715:G:A	21	10	35	15	20	2	1	0
chr7:121339035:C:T	49	24	84	26	58	2	1	0
chr7:121873507:T:G	0	0	0	0	0	0	0	0
chr7:122438360:T:G	0	0	0	0	0	0	0	0
chr7:122994970:C:T	0	0	0	0	0	0	0	0
chr7:123557505:A:C	25	12	37	13	24	1	1	0
chr7:123624750:C:T	0	0	0	0	0	0	0	0
chr7:123629064:G:C	1	0	1	1	0	1	1	0
chr7:123655910:C:T	2	1	3	1	2	1.5	0.5	1.0
chr7:123748678:G:A	235	126	386	120	266	2	0	2
chr7:124747038:C:G	0	0	0	0	0	0	0	0
chr7:124747320:A:G	0	0	0	0	0	0	0	0
chr7:124764317:G:A	0	0	0	0	0	0	0	0
chr7:124764929:A:G	0	0	0	0	0	0	0	0
chr7:124858948:AT:CA	8	4	13	5	8	2.0	0.5	1.0
chr7:127582103:G:A	1	0	1	1	0	1	1	0
chr7:127582467:G:A	0	0	0	0	0	0	0	0
chr7:127584232:A:G	19	8	27	11	16	1	1	0
chr7:127611134:T:G	0	0	0	0	0	0	0	0
chr7:128081455:T:C	104	48	157	59	98	1.0	1.0	0.0
chr7:128351079:G:A	0	0	0	0	0	0	0	0
chr7:128394575:C:T	30	17	47	13	34	2.0	0.0	2.0
chr7:128400698:C:T	6	3	9	3	6	1.5	0.5	1.0
chr7:128500928:T:C	158	81	251	81	170	2.0	0.5	2.0
chr7:128501811:T:C	172	84	269	93	176	2.0	1.0	0.0
chr7:128501969:A:T	114	56	180	74	106	2.0	1.0	0.0
chr7:128672396:C:T	1	1	2	0	2	2	0	2
chr7:128675835:A:T	10	5	15	5	10	1.5	0.5	1.0
chr7:128719079:C:T	0	0	0	0	0	0	0	0
chr7:128830784:C:T	0	0	0	0	0	0	0	0
chr7:128837493:T:C	0	0	0	0	0	0	0	0
chr7:128844762:A:G	0	0	0	0	0	0	0	0
chr7:128865179:C:T	14	4	19	11	8	1.0	1.0	0.0
chr7:128884803:G:A	0	0	0	0	0	0	0	0
chr7:128890222:G:A	0	0	0	0	0	0	0	0
chr7:128892926:T:C	0	0	0	0	0	0	0	0
chr7:128904080:G:T	0	0	0	0	0	0	0	0
chr7:128914021:C:T	0	0	0	0	0	0	0	0
chr7:129427212:T:C	0	0	0	0	0	0	0	0
chr7:130669266:G:C	6	4	10	2	8	2.0	0.0	2.0
chr7:130733698:G:A	0	0	0	0	0	0	0	0
chr7:131505937:T:C	2	1	3	1	2	1.5	0.5	1.0
chr7:131506777:A:G	3	2	5	1	4	2	0	2
chr7:131510953:G:A	0	0	0	0	0	0	0	0
chr7:131511200:C:T	1	0	1	1	0	1	1	0
chr7:131556326:G:A	0	0	0	0	0	0	0	0
chr7:134459081:A:G	251	106	372	153	219	1	1	0
chr7:134933959:A:G	3	2	5	1	4	2	0	2
chr7:134993502:T:A	34	19	60	16	44	2.0	0.0	2.0
chr7:135129101:G:A	1	0	1	1	0	1	1	0
chr7:135164461:G:A	197	76	287	131	156	1	1	0
chr7:135164825:A:C	207	84	305	135	170	1	1	0
chr7:135187023:C:T	61	35	97	27	70	2	0	2
chr7:135193485:G:C	35	23	58	12	46	2	0	2
chr7:135195078:G:A	65	37	104	28	76	2	0	2
chr7:135204389:G:A	44	21	65	23	42	1.0	1.0	0.0
chr7:137915944:C:T	1241	698	2345	743	1602	2	1	2
chr7:138755862:G:A	0	0	0	0	0	0	0	0
chr7:138801351:G:C	0	0	0	0	0	0	0	0
chr7:138916826:C:T	0	0	0	0	0	0	0	0
chr7:138916960:C:A	0	0	0	0	0	0	0	0
chr7:138917080:G:A	0	0	0	0	0	0	0	0
chr7:138917671:G:A	0	0	0	0	0	0	0	0
chr7:138917686:G:C	0	0	0	0	0	0	0	0
chr7:138918536:T:C	0	0	0	0	0	0	0	0
chr7:139047528:C:G	128	64	199	66	133	2.0	0.5	0.5
chr7:139047711:G:A	73	40	119	35	84	2	0	2
chr7:139047751:G:A	66	36	105	31	74	2.0	0.0	2.0
chr7:139055291:G:C	103	49	156	56	100	1	1	0
chr7:139079399:T:C	22	7	29	15	14	1.0	1.0	0.0
chr7:139173024:G:T	2	1	3	1	2	1.5	0.5	1.0
chr7:139283068:G:A	7	2	9	5	4	1	1	0
chr7:139454125:T:G	0	0	0	0	0	0	0	0
chr7:139454204:C:G	0	0	0	0	0	0	0	0
chr7:140015841:G:A	83	47	137	43	94	2	0	2
chr7:140343573:T:C	0	0	0	0	0	0	0	0
chr7:140355678:T:C	1	1	2	0	2	2	0	2
chr7:140425950:T:C	0	0	0	0	0	0	0	0
chr7:140459921:T:C	282	121	438	178	260	1.0	1.0	0.0
chr7:140518664:C:A	1	1	2	0	2	2	0	2
chr7:140527493:A:G	0	0	0	0	0	0	0	0
chr7:140558200:T:C	0	0	0	0	0	0	0	0
chr7:140567223:G:T	0	0	0	0	0	0	0	0
chr7:140726457:A:G	21	9	31	13	18	1	1	0
chr7:141664912:G:A	17	8	25	9	16	1	1	0
chr7:142027685:G:A	0	0	0	0	0	0	0	0
chr7:142055558:T:C	0	0	0	0	0	0	0	0
chr7:142059876:T:C	0	0	0	0	0	0	0	0
chr7:142196259:A:G	0	0	0	0	0	0	0	0
chr7:142762842:G:C	0	0	0	0	0	0	0	0
chr7:143026975:C:T	0	0	0	0	0	0	0	0
chr7:143052320:C:T	0	0	0	0	0	0	0	0
chr7:143052640:C:T	0	0	0	0	0	0	0	0
chr7:143052856:C:T	0	0	0	0	0	0	0	0
chr7:143053050:C:T	0	0	0	0	0	0	0	0
chr7:143222638:C:A	0	0	0	0	0	0	0	0
chr7:143319835:C:T	0	0	0	0	0	0	0	0
chr7:143320714:G:T	0	0	0	0	0	0	0	0
chr7:143391433:T:C	1	1	2	0	2	2	0	2
chr7:143396445:G:A	0	0	0	0	0	0	0	0
chr7:143444382:T:C	0	0	0	0	0	0	0	0
chr7:143478061:G:A	0	0	0	0	0	0	0	0
chr7:143478252:C:T	0	0	0	0	0	0	0	0
chr7:143511121:C:A	0	0	0	0	0	0	0	0
chr7:143511875:A:G	0	0	0	0	0	0	0	0
chr7:143935525:C:T	0	0	0	0	0	0	0	0
chr7:143936204:A:G	0	0	0	0	0	0	0	0
chr7:143960334:C:T	0	0	0	0	0	0	0	0
chr7:143960380:A:G	0	0	0	0	0	0	0	0
chr7:143960708:A:G	0	0	0	0	0	0	0	0
chr7:144050777:A:G	0	0	0	0	0	0	0	0
chr7:144051005:G:T	0	0	0	0	0	0	0	0
chr7:144051164:G:A	0	0	0	0	0	0	0	0
chr7:144051271:T:C	0	0	0	0	0	0	0	0
chr7:144074443:G:A	0	0	0	0	0	0	0	0
chr7:144074844:G:C	0	0	0	0	0	0	0	0
chr7:144095898:G:A	0	0	0	0	0	0	0	0
chr7:144109595:C:A	0	0	0	0	0	0	0	0
chr7:144110211:T:C	0	0	0	0	0	0	0	0
chr7:144129604:C:G	0	0	0	0	0	0	0	0
chr7:144267174:A:G	0	0	0	0	0	0	0	0
chr7:144398507:A:G	0	0	0	0	0	0	0	0
chr7:147395769:G:A	0	0	0	0	0	0	0	0
chr7:148615428:T:C	0	0	0	0	0	0	0	0
chr7:148811726:G:A	5	3	8	2	6	2	0	2
chr7:149003757:C:T	203	119	349	99	250	2	0	2
chr7:149004076:C:T	135	80	229	63	166	2	0	2
chr7:149210594:C:T	7	2	9	5	4	1	1	0
chr7:149455679:A:G	8	4	12	4	8	1.5	0.5	1.0
chr7:149455815:G:A	6	3	9	3	6	1.5	0.5	1.0
chr7:149494369:G:A	88	40	134	52	82	1.0	1.0	0.0
chr7:149494477:C:T	89	52	147	41	106	2	0	2
chr7:149733528:A:G	4	3	7	1	6	2.0	0.0	2.0
chr7:149765292:C:T	0	0	0	0	0	0	0	0
chr7:149765434:C:G	0	0	0	0	0	0	0	0
chr7:149777304:A:G	0	0	0	0	0	0	0	0
chr7:149798112:C:T	0	0	0	0	0	0	0	0
chr7:149816064:C:T	0	0	0	0	0	0	0	0
chr7:149816472:T:C	0	0	0	0	0	0	0	0
chr7:149818015:C:T	0	0	0	0	0	0	0	0
chr7:149818707:C:T	0	0	0	0	0	0	0	0
chr7:149819397:A:G	0	0	0	0	0	0	0	0
chr7:149819792:G:T	0	0	0	0	0	0	0	0
chr7:149821059:A:G	0	0	0	0	0	0	0	0
chr7:149821872:T:C	0	0	0	0	0	0	0	0
chr7:149822095:C:T	0	0	0	0	0	0	0	0
chr7:149822653:G:A	0	0	0	0	0	0	0	0
chr7:149824094:G:A	0	0	0	0	0	0	0	0
chr7:149824455:C:T	0	0	0	0	0	0	0	0
chr7:149825073:G:T	0	0	0	0	0	0	0	0
chr7:149825277:T:G	0	0	0	0	0	0	0	0
chr7:149826188:A:G	0	0	0	0	0	0	0	0
chr7:149847916:G:A	33	21	59	13	46	2	0	2
chr7:149859429:C:T	3	2	5	1	4	2	0	2
chr7:149861320:G:C	0	0	0	0	0	0	0	0
chr7:149862184:C:T	0	0	0	0	0	0	0	0
chr7:149862376:C:T	0	0	0	0	0	0	0	0
chr7:149878795:T:C	22	6	27	16	11	1.0	1.0	0.0
chr7:149879729:A:G	701	318	1121	453	668	1	1	0
chr7:150466749:A:G	7	4	11	3	8	2	0	2
chr7:150474622:T:C	1	1	2	0	2	2	0	2
chr7:150520001:G:A	7	4	18	6	12	2	1	2
chr7:150520160:A:G	7	4	18	6	12	2	1	2
chr7:150627737:C:T	0	0	0	0	0	0	0	0
chr7:150692589:G:C	94	59	162	40	122	2.0	0.0	2.0
chr7:150793288:C:T	1	1	2	0	2	2	0	2
chr7:150802179:C:A	0	0	0	0	0	0	0	0
chr7:150804547:C:T	0	0	0	0	0	0	0	0
chr7:150857799:G:A	0	0	0	0	0	0	0	0
chr7:150858827:A:G	1	0	1	1	0	1	1	0
chr7:150858914:T:C	1	0	1	1	0	1	1	0
chr7:150860534:G:A	1	0	1	1	0	1	1	0
chr7:150860577:C:G	1	0	1	1	0	1	1	0
chr7:150951110:A:G	9	0	10	10	0	1	1	0
chr7:150951701:T:C	5	0	6	6	0	1	1	0
chr7:150952443:G:A	5	0	6	6	0	1	1	0
chr7:150952515:G:A	4	0	5	5	0	1.0	1.0	0.0
chr7:150998638:T:C	0	0	0	0	0	0	0	0
chr7:150999023:T:G	0	0	0	0	0	0	0	0
chr7:151007162:C:G	0	0	0	0	0	0	0	0
chr7:151012483:G:T	14	2	16	12	4	1.0	1.0	0.0
chr7:151018730:A:G	0	0	0	0	0	0	0	0
chr7:151050850:C:A	11	5	16	6	10	1	1	0
chr7:151052599:A:T	30	15	49	15	34	1.5	0.5	1.0
chr7:151064593:C:A	7	4	11	3	8	2	0	2
chr7:151066568:T:A	5	2	7	3	4	1	1	0
chr7:151071699:G:A	16	10	26	6	20	2.0	0.0	2.0
chr7:151075985:G:C	6	2	8	4	4	1.0	1.0	0.0
chr7:151076720:A:T	483	252	804	261	543	2	1	2
chr7:151191701:A:G	1	1	2	0	2	2	0	2
chr7:151351398:G:A	2	2	4	0	4	2.0	0.0	2.0
chr7:151366978:C:T	525	247	841	317	524	2	1	0
chr7:151376929:G:C	10	4	14	6	8	1.0	1.0	0.0
chr7:151381382:C:T	10	8	20	2	18	2.0	0.0	2.0
chr7:151439903:C:T	0	0	0	0	0	0	0	0
chr7:151807413:G:A	3	2	5	1	4	2	0	2
chr7:152154307:C:T	28	15	43	13	30	2.0	0.0	2.0
chr7:152176768:C:T	23	11	34	12	22	1	1	0
chr7:152229941:T:C	64	0	64	64	0	1.0	1.0	0.0
chr7:152273771:T:A	46	0	48	48	0	1.0	1.0	0.0
chr7:152648641:A:G	3	2	5	1	4	2	0	2
chr7:152814513:C:T	0	0	0	0	0	0	0	0
chr7:154875933:G:A	0	0	0	0	0	0	0	0
chr7:154876132:G:A	0	0	0	0	0	0	0	0
chr7:154880936:T:C	0	0	0	0	0	0	0	0
chr7:154880969:A:T	0	0	0	0	0	0	0	0
chr7:154881007:G:A	0	0	0	0	0	0	0	0
chr7:154892443:T:C	0	0	0	0	0	0	0	0
chr7:154944127:A:G	139	69	224	76	148	2	1	0
chr7:155070881:G:C	0	0	0	0	0	0	0	0
chr7:155070911:T:A	0	0	0	0	0	0	0	0
chr7:155302462:C:T	34	19	60	18	42	2.0	0.0	2.0
chr7:155462637:T:C	0	0	0	0	0	0	0	0
chr7:155711226:A:T	155	64	233	99	134	1	1	0
chr7:155738260:T:C	20	9	30	12	18	1.5	1.0	0.0
chr7:155738386:A:G	26	10	37	17	20	1.0	1.0	0.0
chr7:155739667:G:A	6	1	7	5	2	1.0	1.0	0.0
chr7:155741959:C:G	62	32	94	30	64	2.0	0.0	2.0
chr7:155766709:A:G	24	15	39	9	30	2.0	0.0	2.0
chr7:155806606:C:T	1	0	1	1	0	1	1	0
chr7:155963132:A:G	0	0	0	0	0	0	0	0
chr7:156676402:C:T	7	4	11	3	8	2	0	2
chr7:156676439:C:G	20	10	29	10	19	1.0	0.5	0.5
chr7:156676485:C:T	20	10	30	10	20	1.5	0.5	1.0
chr7:156676496:A:G	20	10	30	10	20	1.5	0.5	1.0
chr7:156725501:G:A	7	4	11	3	8	2	0	2
chr7:156796455:A:G	56	22	80	34	46	1.0	1.0	0.0
chr7:156954196:C:T	15	8	23	7	16	2	0	2
chr7:157197860:C:T	9	6	15	3	12	2	0	2
chr7:157410131:G:A	1	1	2	0	2	2	0	2
chr7:157595307:G:A	0	0	0	0	0	0	0	0
chr7:157604005:G:A	0	0	0	0	0	0	0	0
chr7:158110846:A:G	0	0	0	0	0	0	0	0
chr7:158138427:A:G	0	0	0	0	0	0	0	0
chr7:158138452:C:T	0	0	0	0	0	0	0	0
chr7:158701913:G:A	39	17	58	22	36	1	1	0
chr7:158741681:G:A	8	3	12	6	6	1.5	1.0	0.0
chr7:158741690:G:C	7	3	11	5	6	2	1	0
chr7:158798049:A:T	179	66	263	123	140	1	1	0
chr8:10610095:C:T	0	0	0	0	0	0	0	0
chr8:12415267:C:T	0	0	0	0	0	0	0	0
chr8:41937416:C:T	52	26	86	28	58	2.0	0.5	1.0
chr8:41947731:C:T	2	1	3	1	2	1.5	0.5	1.0
chr8:42697490:G:A	0	0	0	0	0	0	0	0
chr8:47826744:G:A	15	7	24	8	16	1	1	0
chr8:47972876:T:A	8	4	12	4	8	1.5	0.5	1.0
chr8:49075351:G:A	0	0	0	0	0	0	0	0
chr8:51319927:G:T	20	3	24	18	6	1.0	1.0	0.0
chr8:51320848:C:T	30	4	37	27	10	1.0	1.0	0.0
chr8:51339760:A:G	1	0	1	1	0	1	1	0
chr8:51345869:A:T	18	17	35	1	34	2.0	0.0	2.0
chr8:51372000:A:T	14	1	16	14	2	1.0	1.0	0.0
chr8:51408272:G:C	0	0	0	0	0	0	0	0
chr8:51408683:T:C	0	0	0	0	0	0	0	0
chr8:51809398:T:C	24	15	41	9	32	2.0	0.0	2.0
chr8:51820490:T:A	607	323	1005	321	684	2	1	2
chr8:52642509:A:G	197	91	302	114	188	1	1	0
chr8:53251002:C:A	0	0	0	0	0	0	0	0
chr8:54626497:G:A	0	0	0	0	0	0	0	0
chr8:54628890:G:A	0	0	0	0	0	0	0	0
chr8:56113670:C:A	0	0	0	0	0	0	0	0
chr8:56166374:G:T	1	0	1	1	0	1	1	0
chr8:58588724:C:A	14	7	24	8	16	2.0	0.5	1.0
chr8:58939348:T:C	499	281	898	272	626	2	0	2
chr8:60853007:A:G	10	7	17	3	14	2.0	0.0	2.0
chr8:61651205:A:G	0	0	0	0	0	0	0	0
chr8:62747051:G:A	0	0	0	0	0	0	0	0
chr8:65613313:T:C	66	29	97	37	60	1.0	1.0	0.0
chr8:65708124:G:A	1	0	1	1	0	1	1	0
chr8:66505483:G:T	0	0	0	0	0	0	0	0
chr8:66664826:T:C	22	11	33	11	22	1.5	0.5	1.0
chr8:67301242:T:G	357	172	575	201	374	1	1	0
chr8:67952493:G:A	0	0	0	0	0	0	0	0
chr8:68108261:T:C	0	0	0	0	0	0	0	0
chr8:68231354:A:G	0	0	0	0	0	0	0	0
chr8:70126883:C:G	13	10	23	3	20	2	0	2
chr8:70138137:C:A	19	9	28	10	18	1	1	0
chr8:70156712:C:T	23	14	39	9	30	2	0	2
chr8:70608316:C:T	818	408	1410	504	906	2.0	1.0	0.0
chr8:70681190:G:A	10	10	20	0	20	2.0	0.0	2.0
chr8:72053767:G:A	0	0	0	0	0	0	0	0
chr8:72053889:A:G	0	0	0	0	0	0	0	0
chr8:72063566:T:G	0	0	0	0	0	0	0	0
chr8:72069092:A:G	0	0	0	0	0	0	0	0
chr8:72075403:G:A	0	0	0	0	0	0	0	0
chr8:72937968:G:A	0	0	0	0	0	0	0	0
chr8:73069926:A:G	0	0	0	0	0	0	0	0
chr8:73297511:T:C	0	0	0	0	0	0	0	0
chr8:73615761:C:T	119	51	176	70	106	1	1	0
chr8:73976259:C:T	210	93	330	130	200	1.0	1.0	0.0
chr8:73984613:G:A	5	3	8	2	6	2	0	2
chr8:75564161:G:A	0	0	0	0	0	0	0	0
chr8:76833399:G:A	0	0	0	0	0	0	0	0
chr8:80993162:A:G	0	0	0	0	0	0	0	0
chr8:81694547:A:G	1	0	1	1	0	1	1	0
chr8:86472440:C:T	83	45	134	40	94	2	0	2
chr8:86508665:C:A	294	136	465	181	284	2.0	1.0	0.0
chr8:86558437:A:C	26	15	42	12	30	2.0	0.0	2.0
chr8:89946302:T:C	3	1	4	2	2	1	1	0
chr8:89955483:A:G	156	83	262	82	180	2.0	0.0	2.0
chr8:89982791:C:T	311	156	502	170	332	2	1	2
chr8:90082755:G:A	0	0	0	0	0	0	0	0
chr8:93134427:G:T	0	0	0	0	0	0	0	0
chr8:93923709:T:C	55	30	95	29	66	2	0	2
chr8:94407470:A:G	7	5	15	3	12	2	0	2
chr8:94519191:T:C	12	7	19	5	14	2.0	0.0	2.0
chr8:94678351:T:C	0	0	0	0	0	0	0	0
chr8:94865559:T:C	26	13	41	13	28	1.5	0.5	1.0
chr8:96593572:C:T	0	0	0	0	0	0	0	0
chr8:97277758:C:T	0	0	0	0	0	0	0	0
chr8:97931218:T:C	0	0	0	0	0	0	0	0
chr8:97931317:A:G	0	0	0	0	0	0	0	0
chr8:97978993:A:G	0	0	0	0	0	0	0	0
chr8:97978995:A:G	0	0	0	0	0	0	0	0
chr8:97994520:C:T	0	0	0	0	0	0	0	0
chr8:98883712:G:A	0	0	0	0	0	0	0	0
chr8:99121478:T:G	8	7	15	1	14	2.0	0.0	2.0
chr8:99136732:T:C	25	11	37	15	22	1	1	0
chr8:99467484:A:G	65	25	91	41	50	1	1	0
chr8:99832530:T:C	38	13	53	27	26	1.0	1.0	0.0
chr8:100140796:G:A	1	1	2	0	2	2	0	2
chr8:100240452:T:C	58	27	93	34	59	1.0	1.0	0.0
chr8:100895858:G:A	0	0	0	0	0	0	0	0
chr8:101666744:G:A	0	0	0	0	0	0	0	0
chr8:102238702:C:T	244	151	423	105	318	2.0	0.0	2.0
chr8:102293805:T:C	11	1	12	10	2	1	1	0
chr8:102551679:G:T	0	0	0	0	0	0	0	0
chr8:103324868:A:G	7	1	8	6	2	1	1	0
chr8:103325139:A:C	8	3	11	5	6	1.0	1.0	0.0
chr8:103331458:G:A	11	1	12	10	2	1	1	0
chr8:103415313:C:T	49	23	78	28	50	1	1	0
chr8:103420403:T:C	330	184	544	162	382	2.0	0.0	2.0
chr8:103975543:G:A	0	0	0	0	0	0	0	0
chr8:104251751:C:T	0	0	0	0	0	0	0	0
chr8:104348867:C:T	1	1	2	0	2	2	0	2
chr8:104349126:G:C	1	1	2	0	2	2	0	2
chr8:104466705:G:A	0	0	0	0	0	0	0	0
chr8:105802428:G:C	0	0	0	0	0	0	0	0
chr8:106697617:C:A	1	0	1	1	0	1	1	0
chr8:106742355:T:G	29	14	46	16	30	1	1	0
chr8:106770107:G:A	3	2	5	1	4	2	0	2
chr8:106770167:G:A	3	2	5	1	4	2	0	2
chr8:107958139:A:G	0	0	0	0	0	0	0	0
chr8:108443634:C:T	160	58	236	112	124	1.0	1.0	0.0
chr8:109400290:G:A	0	0	0	0	0	0	0	0
chr8:109404584:C:T	0	0	0	0	0	0	0	0
chr8:109412284:A:C	0	0	0	0	0	0	0	0
chr8:109445517:G:T	0	0	0	0	0	0	0	0
chr8:109448259:G:T	0	0	0	0	0	0	0	0
chr8:109464764:A:G	0	0	0	0	0	0	0	0
chr8:109477391:A:T	0	0	0	0	0	0	0	0
chr8:113376716:G:A	0	0	0	0	0	0	0	0
chr8:117819781:G:A	3	2	5	1	4	2	0	2
chr8:117835543:G:A	1	0	1	1	0	1	1	0
chr8:118951813:G:C	0	0	0	0	0	0	0	0
chr8:119778064:T:C	20	13	33	7	26	2.0	0.0	2.0
chr8:119928412:C:T	0	0	0	0	0	0	0	0
chr8:120049640:G:A	2	1	3	1	2	1.5	0.5	1.0
chr8:120470956:G:A	0	0	0	0	0	0	0	0
chr8:120517950:A:G	4	2	6	2	4	1.5	0.5	1.0
chr8:122951633:C:T	227	100	342	140	202	1	1	0
chr8:123109558:A:G	3	2	5	1	4	2	0	2
chr8:123126615:G:A	5	1	10	4	6	1	1	0
chr8:123130249:T:C	2	0	2	2	0	1.0	1.0	0.0
chr8:123194084:G:A	2	1	3	1	2	1.5	0.5	1.0
chr8:123202334:C:T	1	0	2	2	0	2	2	0
chr8:123513243:C:T	194	98	314	110	204	2.0	1.0	2.0
chr8:123698489:C:T	0	0	0	0	0	0	0	0
chr8:123975238:T:C	0	0	0	0	0	0	0	0
chr8:124049654:G:A	0	0	0	0	0	0	0	0
chr8:124727963:G:A	76	48	143	33	110	2.0	0.0	2.0
chr8:127086921:C:T	3	3	6	0	6	2	0	2
chr8:127086997:C:A	2	0	2	2	0	1.0	1.0	0.0
chr8:127087024:A:G	2	2	4	0	4	2.0	0.0	2.0
chr8:127416393:G:A	0	0	0	0	0	0	0	0
chr8:127738955:G:A	16	8	25	9	16	2.0	0.5	1.0
chr8:129748528:C:T	0	0	0	0	0	0	0	0
chr8:129748604:A:G	0	0	0	0	0	0	0	0
chr8:129777521:G:A	0	0	0	0	0	0	0	0
chr8:131970577:A:G	227	119	357	115	242	2	1	2
chr8:132034824:G:A	0	0	0	0	0	0	0	0
chr8:132888007:T:G	0	0	0	0	0	0	0	0
chr8:132888141:T:C	0	0	0	0	0	0	0	0
chr8:132897729:A:G	0	0	0	0	0	0	0	0
chr8:133096209:C:T	1	1	2	0	2	2	0	2
chr8:133102527:C:T	0	0	0	0	0	0	0	0
chr8:133113438:G:A	1	1	2	0	2	2	0	2
chr8:133131869:C:T	1	0	1	1	0	1	1	0
chr8:133227527:T:C	0	0	0	0	0	0	0	0
chr8:134512554:G:T	37	24	63	13	50	2	0	2
chr8:134602462:A:G	4	1	5	3	2	1.0	1.0	0.0
chr8:135542622:A:C	0	0	0	0	0	0	0	0
chr8:138630731:T:C	0	0	0	0	0	0	0	0
chr8:138685235:T:C	0	0	0	0	0	0	0	0
chr8:138811814:G:A	0	0	0	0	0	0	0	0
chr8:139732033:G:A	15	5	20	10	10	1	1	0
chr8:140450963:G:A	200	114	330	91	239	2.0	0.0	2.0
chr8:140451086:A:G	201	115	333	91	242	2	0	2
chr8:140451167:A:G	204	119	341	91	250	2.0	0.0	2.0
chr8:140515288:T:C	488	256	823	271	552	2.0	1.0	2.0
chr8:140515296:C:T	491	257	827	272	555	2	1	2
chr8:140770719:T:C	0	0	0	0	0	0	0	0
chr8:141144192:G:A	0	0	0	0	0	0	0	0
chr8:141150933:A:C	0	0	0	0	0	0	0	0
chr8:141160785:C:T	0	0	0	0	0	0	0	0
chr8:141178060:G:A	0	0	0	0	0	0	0	0
chr8:141188853:C:T	1	1	2	0	2	2	0	2
chr8:141192757:C:T	1	1	2	0	2	2	0	2
chr8:141194227:C:G	1	1	2	0	2	2	0	2
chr8:141211700:A:G	3	1	4	2	2	1	1	0
chr8:141212275:A:G	2	1	3	1	2	1.5	0.5	1.0
chr8:141212346:T:C	2	1	3	1	2	1.5	0.5	1.0
chr8:141215891:G:A	2	1	3	1	2	1.5	0.5	1.0
chr8:141218710:T:C	1	1	2	0	2	2	0	2
chr8:141219792:A:G	1	1	2	0	2	2	0	2
chr8:141254271:T:C	2	1	3	1	2	1.5	0.5	1.0
chr8:141356971:C:T	0	0	0	0	0	0	0	0
chr8:141434680:G:C	0	0	0	0	0	0	0	0
chr8:141434688:C:A	0	0	0	0	0	0	0	0
chr8:141434800:T:C	0	0	0	0	0	0	0	0
chr8:141436904:C:T	0	0	0	0	0	0	0	0
chr8:141447953:A:G	0	0	0	0	0	0	0	0
chr8:141466429:G:A	0	0	0	0	0	0	0	0
chr8:141478737:G:A	0	0	0	0	0	0	0	0
chr8:141495478:C:A	0	0	0	0	0	0	0	0
chr8:141496446:G:T	0	0	0	0	0	0	0	0
chr8:141507122:A:G	0	0	0	0	0	0	0	0
chr8:141507127:C:T	0	0	0	0	0	0	0	0
chr8:142271677:C:T	2	0	2	2	0	1.0	1.0	0.0
chr8:142300449:T:C	4	4	8	0	8	2.0	0.0	2.0
chr8:142331775:C:T	16	8	24	8	16	1.5	0.5	1.0
chr8:142344359:T:C	17	9	27	9	18	2	0	2
chr8:142345817:C:G	14	7	22	8	14	2.0	0.5	1.0
chr8:142354673:A:G	20	11	32	10	22	2.0	0.0	2.0
chr8:142464954:C:G	0	0	0	0	0	0	0	0
chr8:142522057:G:C	1	1	2	0	2	2	0	2
chr8:142613414:G:C	0	0	0	0	0	0	0	0
chr8:142613783:G:A	0	0	0	0	0	0	0	0
chr8:142680513:C:T	0	0	0	0	0	0	0	0
chr8:142681514:G:A	0	0	0	0	0	0	0	0
chr8:142681625:A:G	0	0	0	0	0	0	0	0
chr8:142682072:T:C	1	0	1	1	0	1	1	0
chr8:142682129:C:A	1	0	1	1	0	1	1	0
chr8:142701697:C:T	0	0	0	0	0	0	0	0
chr8:142752432:G:A	0	0	0	0	0	0	0	0
chr8:142752438:C:T	0	0	0	0	0	0	0	0
chr8:142764532:AGCT:GGCC	0	0	0	0	0	0	0	0
chr8:142764564:T:C	0	0	0	0	0	0	0	0
chr8:142765107:G:A	0	0	0	0	0	0	0	0
chr8:142879589:T:C	0	0	0	0	0	0	0	0
chr8:142913286:G:T	0	0	0	0	0	0	0	0
chr8:142914327:C:T	0	0	0	0	0	0	0	0
chr8:143043095:T:C	0	0	0	0	0	0	0	0
chr8:143158442:A:G	0	0	0	0	0	0	0	0
chr8:143215394:C:T	0	0	0	0	0	0	0	0
chr8:143249912:T:C	8	5	13	3	10	2.0	0.0	2.0
chr8:143275822:A:G	15	9	24	6	18	2	0	2
chr8:143296014:C:G	6	3	9	3	6	1.5	0.5	1.0
chr8:143310198:G:A	314	116	459	213	246	1.0	1.0	0.0
chr8:143321315:G:C	233	151	402	91	311	2	0	2
chr8:143324535:C:T	229	146	396	92	304	2	0	2
chr8:143379999:A:G	2	0	2	2	0	1.0	1.0	0.0
chr8:143440077:C:A	55	32	92	24	68	2	0	2
chr8:143440107:A:C	55	23	80	34	46	1	1	0
chr8:143538685:C:A	21	13	34	8	26	2	0	2
chr8:143559583:A:C	2	0	2	2	0	1.0	1.0	0.0
chr8:143560684:G:A	426	155	621	307	314	1.0	1.0	0.0
chr8:143560999:C:T	54	25	83	31	52	1.0	1.0	0.0
chr8:143568333:G:A	0	0	0	0	0	0	0	0
chr8:143568340:G:A	0	0	0	0	0	0	0	0
chr8:143568755:A:T	2	1	3	1	2	1.5	0.5	1.0
chr8:143575099:G:C	36	11	50	26	24	1.0	1.0	0.0
chr8:143575631:G:A	154	147	314	10	304	2.0	0.0	2.0
chr8:143576200:C:T	12	2	16	10	6	1.0	1.0	0.0
chr8:143577779:C:A	1	0	1	1	0	1	1	0
chr8:143577876:G:A	127	126	269	2	267	2	0	2
chr8:143589074:C:A	216	116	341	105	236	2.0	0.0	2.0
chr8:143589752:G:A	177	91	274	90	184	2	1	2
chr8:143599607:G:T	15	9	24	6	18	2	0	2
chr8:143606976:C:T	35	16	50	19	31	1	1	0
chr8:143612834:T:C	723	368	1252	445	807	2	1	2
chr8:143613006:C:T	18	8	29	11	18	1.5	1.0	0.0
chr8:143613329:C:A	17	9	27	9	18	2	0	2
chr8:143649856:G:A	0	0	0	0	0	0	0	0
chr8:143691126:G:A	10	6	16	4	12	2.0	0.0	2.0
chr8:143693701:C:A	19	7	26	12	14	1	1	0
chr8:143694543:A:C	20	7	28	14	14	1.0	1.0	0.0
chr8:143719133:G:A	0	0	0	0	0	0	0	0
chr8:143719423:C:A	0	0	0	0	0	0	0	0
chr8:143720565:AG:CC	0	0	0	0	0	0	0	0
chr8:143721446:C:T	0	0	0	0	0	0	0	0
chr8:143810533:C:A	1	1	2	0	2	2	0	2
chr8:143810914:G:A	2	1	3	1	2	1.5	0.5	1.0
chr8:143837112:A:G	0	0	0	0	0	0	0	0
chr8:143867013:G:C	2	2	4	0	4	2.0	0.0	2.0
chr8:143868735:T:C	2	1	3	1	2	1.5	0.5	1.0
chr8:143872084:C:T	0	0	0	0	0	0	0	0
chr8:143916360:A:G	64	32	98	32	66	1.5	0.5	1.0
chr8:143917008:T:C	14	6	21	9	12	1.5	1.0	0.0
chr8:143918694:A:G	4	2	6	2	4	1.5	0.5	1.0
chr8:143918732:G:A	4	2	6	2	4	1.5	0.5	1.0
chr8:143919209:A:G	9	5	14	4	10	2	0	2
chr8:143920044:A:T	7	5	12	2	10	2	0	2
chr8:143921861:A:G	6	4	10	2	8	2.0	0.0	2.0
chr8:143922662:C:T	6	2	8	4	4	1.0	1.0	0.0
chr8:143925075:G:A	8	4	13	5	8	2.0	0.5	1.0
chr8:143926863:T:C	9	5	14	4	10	2	0	2
chr8:143932901:C:A	25	12	37	13	24	1	1	0
chr8:143983869:A:G	8	4	12	4	8	1.5	0.5	1.0
chr8:143984818:A:G	6	4	10	2	8	2.0	0.0	2.0
chr8:143985257:T:C	19	10	29	9	20	2	0	2
chr8:143985944:G:A	31	17	48	14	34	2	0	2
chr8:143991836:C:G	1	0	1	1	0	1	1	0
chr8:144012708:T:C	2	0	2	2	0	1.0	1.0	0.0
chr8:144051279:T:C	3	3	6	0	6	2	0	2
chr8:144056626:A:G	0	0	0	0	0	0	0	0
chr8:144058338:T:G	0	0	0	0	0	0	0	0
chr8:144059740:G:A	0	0	0	0	0	0	0	0
chr8:144059941:C:T	0	0	0	0	0	0	0	0
chr8:144060021:G:C	1	1	2	0	2	2	0	2
chr8:144083160:G:A	285	141	443	155	288	2	1	0
chr8:144084824:C:T	361	188	586	195	391	2	1	2
chr8:144085569:A:G	33	18	53	15	38	2	0	2
chr8:144103600:G:T	650	321	1050	376	674	2.0	1.0	0.0
chr8:144106920:G:A	1246	687	2284	771	1513	2.0	1.0	2.0
chr8:144106993:T:C	178	90	279	95	184	2.0	1.0	2.0
chr8:144108511:C:G	0	0	0	0	0	0	0	0
chr8:144108744:T:C	0	0	0	0	0	0	0	0
chr8:144109944:A:G	0	0	0	0	0	0	0	0
chr8:144111743:G:C	5	2	7	3	4	1	1	0
chr8:144115450:T:A	8	2	11	7	4	1.0	1.0	0.0
chr8:144115537:A:C	9	7	18	2	16	2	0	2
chr8:144139629:G:A	9	6	15	3	12	2	0	2
chr8:144168366:C:T	23	11	34	12	22	1	1	0
chr8:144168385:C:T	23	12	35	11	24	2	0	2
chr8:144242318:G:A	0	0	0	0	0	0	0	0
chr8:144243893:T:C	3	1	4	2	2	1	1	0
chr8:144247668:A:G	2	1	3	1	2	1.5	0.5	1.0
chr8:144260823:C:T	25	21	46	4	42	2	0	2
chr8:144263177:G:A	0	0	0	0	0	0	0	0
chr8:144289233:T:C	54	32	86	22	64	2.0	0.0	2.0
chr8:144353861:G:A	4	3	7	1	6	2.0	0.0	2.0
chr8:144379425:C:A	48	22	71	27	44	1.0	1.0	0.0
chr8:144396341:G:A	1	1	2	0	2	2	0	2
chr8:144399768:A:G	0	0	0	0	0	0	0	0
chr8:144414297:C:G	0	0	0	0	0	0	0	0
chr8:144414342:T:C	0	0	0	0	0	0	0	0
chr8:144415944:C:T	0	0	0	0	0	0	0	0
chr8:144416180:T:G	0	0	0	0	0	0	0	0
chr8:144416618:C:T	1	0	1	1	0	1	1	0
chr8:144424239:A:G	2281	1455	5632	1815	3817	2	1	2
chr8:144425879:T:C	82	27	110	56	54	1.0	1.0	0.0
chr8:144432575:C:T	1	0	1	1	0	1	1	0
chr8:144434854:C:T	3	2	5	1	4	2	0	2
chr8:144435937:G:A	2	2	4	0	4	2.0	0.0	2.0
chr8:144440024:C:T	1	1	2	0	2	2	0	2
chr8:144440039:C:T	1	0	1	1	0	1	1	0
chr8:144440378:G:A	2	2	4	0	4	2.0	0.0	2.0
chr8:144441195:T:C	2	1	3	1	2	1.5	0.5	1.0
chr8:144441971:C:A	0	0	0	0	0	0	0	0
chr8:144442659:G:A	0	0	0	0	0	0	0	0
chr8:144466980:G:A	13	8	21	5	16	2	0	2
chr8:144468681:C:A	0	0	0	0	0	0	0	0
chr8:144474259:C:T	0	0	0	0	0	0	0	0
chr8:144523369:A:C	19	13	32	6	26	2	0	2
chr8:144524754:T:C	197	100	312	104	208	2	1	2
chr8:144530786:G:A	1	1	2	0	2	2	0	2
chr8:144773695:G:A	41	19	64	22	42	1	1	0
chr8:144778182:A:G	7	6	13	1	12	2	0	2
chr8:144790364:C:T	4398	4335	133603	43799	89804	27.0	9.0	18.0
chr8:144790601:T:C	33	6	39	27	12	1	1	0
chr8:144791795:C:T	4379	4321	131675	43082	88593	27	9	18
chr8:144802998:A:G	2	1	3	1	2	1.5	0.5	1.0
chr8:144808269:A:G	3	3	6	0	6	2	0	2
chr8:144829318:C:T	23	13	38	10	28	2	0	2
chr8:144842937:C:T	41	20	61	21	40	1	1	0
chr8:144851323:C:T	276	158	457	129	328	2.0	0.0	2.0
chr8:145054093:C:G	78	37	118	44	74	2.0	1.0	0.0
chr9:116800:C:G	0	0	0	0	0	0	0	0
chr9:116832:T:C	0	0	0	0	0	0	0	0
chr9:117268:C:T	0	0	0	0	0	0	0	0
chr9:117428:G:C	0	0	0	0	0	0	0	0
chr9:117696:G:A	1	0	1	1	0	1	1	0
chr9:117713:T:C	1	0	1	1	0	1	1	0
chr9:117934:C:G	1	1	2	0	2	2	0	2
chr9:214706:G:C	66	40	108	27	81	2.0	0.0	2.0
chr9:215057:TGCG:CGCT	203	141	352	64	288	2	0	2
chr9:215269:A:C	211	151	375	63	312	2	0	2
chr9:271638:C:T	90	39	133	53	80	1.0	1.0	0.0
chr9:334337:A:G	101	48	153	53	100	1	1	0
chr9:377111:G:C	39	20	61	19	42	2	0	2
chr9:390512:C:T	46	18	68	28	40	1.0	1.0	0.0
chr9:421032:C:G	38	22	61	17	44	2.0	0.0	2.0
chr9:449798:G:A	52	32	87	21	66	2.0	0.0	2.0
chr9:676954:T:C	57	33	91	26	65	2	0	2
chr9:712060:G:C	13	7	20	6	14	2	0	2
chr9:712599:C:T	9	5	14	4	10	2	0	2
chr9:732302:T:C	2	2	4	0	4	2.0	0.0	2.0
chr9:732704:T:A	7	2	9	5	4	1	1	0
chr9:841825:C:T	0	0	0	0	0	0	0	0
chr9:841971:T:A	0	0	0	0	0	0	0	0
chr9:989943:T:C	0	0	0	0	0	0	0	0
chr9:2033182:A:C	26	17	43	9	34	2.0	0.0	2.0
chr9:2191309:C:G	100	48	153	53	100	1.0	1.0	0.0
chr9:2648773:A:G	1	1	2	0	2	2	0	2
chr9:4118111:G:T	0	0	0	0	0	0	0	0
chr9:4564432:G:A	0	0	0	0	0	0	0	0
chr9:4860300:A:G	158	66	236	100	136	1.0	1.0	0.0
chr9:5231712:T:A	0	0	0	0	0	0	0	0
chr9:5467955:G:A	2	1	3	1	2	1.5	0.5	1.0
chr9:5774225:T:G	10	5	15	5	10	1.5	0.5	1.0
chr9:5921844:G:T	16	8	24	8	16	1.5	0.5	1.0
chr9:6007500:G:A	258	112	388	155	233	1.0	1.0	0.0
chr9:6533010:C:G	20	10	30	10	20	1.5	0.5	1.0
chr9:6588403:C:T	0	0	0	0	0	0	0	0
chr9:6610326:C:T	0	0	0	0	0	0	0	0
chr9:6645251:C:T	0	0	0	0	0	0	0	0
chr9:6984236:G:A	32	12	45	21	24	1.0	1.0	0.0
chr9:6986464:G:C	32	18	56	14	42	2.0	0.0	2.0
chr9:7799606:C:A	717	381	1359	475	884	2	1	2
chr9:7799653:G:T	716	379	1363	478	885	2.0	1.0	2.0
chr9:17135117:C:T	164	163	355	1	354	2.0	0.0	2.0
chr9:18684833:T:G	0	0	0	0	0	0	0	0
chr9:18706651:G:A	0	0	0	0	0	0	0	0
chr9:18777370:T:C	0	0	0	0	0	0	0	0
chr9:18928041:A:G	0	0	0	0	0	0	0	0
chr9:19032909:A:G	1	0	1	1	0	1	1	0
chr9:19058485:C:A	1	1	2	0	2	2	0	2
chr9:19063110:T:C	7	1	8	6	2	1	1	0
chr9:19346712:A:G	2	1	3	1	2	1.5	0.5	1.0
chr9:19376257:AGAG:CGAC	4330	656	36930	35424	1506	8.0	7.0	0.0
chr9:19379369:G:A	227	102	346	132	214	1	1	0
chr9:19516092:C:G	0	0	0	0	0	0	0	0
chr9:19576951:T:G	0	0	0	0	0	0	0	0
chr9:20764871:T:C	3	2	5	1	4	2	0	2
chr9:20988427:A:G	9	8	17	1	16	2	0	2
chr9:21077717:G:A	5	1	6	4	2	1	1	0
chr9:21186959:G:A	0	0	0	0	0	0	0	0
chr9:21187312:C:T	0	0	0	0	0	0	0	0
chr9:21409584:C:T	0	0	0	0	0	0	0	0
chr9:21440491:T:C	0	0	0	0	0	0	0	0
chr9:25677590:A:C	0	0	0	0	0	0	0	0
chr9:27062723:C:T	38	15	55	23	32	1.0	1.0	0.0
chr9:27202872:A:G	0	0	0	0	0	0	0	0
chr9:27330516:G:A	2	2	4	0	4	2.0	0.0	2.0
chr9:27567147:C:T	239	127	399	131	268	2	1	2
chr9:28148702:C:T	0	0	0	0	0	0	0	0
chr9:28149106:G:A	0	0	0	0	0	0	0	0
chr9:32450189:T:C	8	4	12	4	8	1.5	0.5	1.0
chr9:32459452:T:G	65	36	104	30	74	2	0	2
chr9:32480253:A:T	38	20	58	18	40	2.0	0.0	2.0
chr9:32526148:G:A	162	78	248	86	162	1.0	1.0	0.0
chr9:32634469:T:C	0	0	0	0	0	0	0	0
chr9:32784840:T:C	0	0	0	0	0	0	0	0
chr9:33001451:C:A	271	141	424	139	285	2	0	2
chr9:33026574:T:C	2047	1306	5022	1556	3466	2	1	2
chr9:33240167:G:C	2	0	2	2	0	1.0	1.0	0.0
chr9:33240227:G:A	2	0	2	2	0	1.0	1.0	0.0
chr9:33290534:A:G	370	189	598	204	394	2.0	1.0	2.0
chr9:33442954:G:A	89	42	132	48	84	1	1	0
chr9:33442988:A:C	0	0	0	0	0	0	0	0
chr9:33447426:C:G	78	36	115	43	72	1.0	1.0	0.0
chr9:33465184:G:A	0	0	0	0	0	0	0	0
chr9:33469408:C:T	3	2	5	1	4	2	0	2
chr9:33473895:T:G	23	11	38	14	24	2	1	0
chr9:33568689:T:A	0	0	0	0	0	0	0	0
chr9:34257981:C:T	1	0	1	1	0	1	1	0
chr9:34310929:T:C	1	0	1	1	0	1	1	0
chr9:34371790:A:T	1	1	2	0	2	2	0	2
chr9:34397547:A:G	2	1	3	1	2	1.5	0.5	1.0
chr9:34552020:G:C	0	0	0	0	0	0	0	0
chr9:34622392:A:C	0	0	0	0	0	0	0	0
chr9:34627943:C:T	0	0	0	0	0	0	0	0
chr9:34648421:C:T	131	64	199	67	132	1	1	0
chr9:34649445:A:G	184	96	286	90	196	2.0	0.0	2.0
chr9:34655737:G:T	5	2	7	3	4	1	1	0
chr9:34661983:C:T	0	0	0	0	0	0	0	0
chr9:34832922:C:T	0	0	0	0	0	0	0	0
chr9:34833353:T:A	0	0	0	0	0	0	0	0
chr9:34835276:A:C	0	0	0	0	0	0	0	0
chr9:35075025:C:T	18	7	25	11	14	1.0	1.0	0.0
chr9:35079505:G:A	31	16	47	15	32	2	0	2
chr9:35657841:G:A	34	10	44	24	20	1.0	1.0	0.0
chr9:35657862:C:G	34	11	45	23	22	1.0	1.0	0.0
chr9:35660904:C:T	713	325	1164	474	690	2	1	0
chr9:35661060:C:G	1041	502	1842	733	1109	2	1	0
chr9:35661091:G:A	1043	502	1853	739	1114	2	1	0
chr9:35663231:G:C	2	2	4	0	4	2.0	0.0	2.0
chr9:35674056:G:A	0	0	0	0	0	0	0	0
chr9:35674104:T:C	0	0	0	0	0	0	0	0
chr9:35674350:A:T	0	0	0	0	0	0	0	0
chr9:35675855:C:G	6	5	12	2	10	2.0	0.0	2.0
chr9:35749848:G:C	57	31	93	27	66	2	0	2
chr9:35753901:G:A	7	4	13	3	10	2	0	2
chr9:35792426:T:C	0	0	0	0	0	0	0	0
chr9:35802586:C:T	0	0	0	0	0	0	0	0
chr9:35818999:G:A	0	0	0	0	0	0	0	0
chr9:35826041:T:C	0	0	0	0	0	0	0	0
chr9:35826061:T:C	0	0	0	0	0	0	0	0
chr9:35870004:T:C	0	0	0	0	0	0	0	0
chr9:35910693:G:A	0	0	0	0	0	0	0	0
chr9:36105267:A:G	0	0	0	0	0	0	0	0
chr9:36110066:T:A	0	0	0	0	0	0	0	0
chr9:36112429:C:T	0	0	0	0	0	0	0	0
chr9:36169497:G:A	0	0	0	0	0	0	0	0
chr9:36169601:T:C	0	0	0	0	0	0	0	0
chr9:36191007:C:T	1521	859	3004	994	2010	2	1	2
chr9:36191152:T:C	1530	863	3015	1000	2015	2.0	1.0	2.0
chr9:36219884:G:A	15	10	25	5	20	2	0	2
chr9:37532032:G:A	109	60	194	58	136	2	0	2
chr9:37537560:G:A	7	3	10	4	6	1	1	0
chr9:37692657:A:C	7	4	11	3	8	2	0	2
chr9:37729789:C:T	4	3	7	1	6	2.0	0.0	2.0
chr9:37740640:T:C	1	0	1	1	0	1	1	0
chr9:38396068:G:T	10	6	17	5	12	2.0	0.0	2.0
chr9:38397358:G:C	9	4	13	5	8	1	1	0
chr9:39078846:A:G	0	0	0	0	0	0	0	0
chr9:41044583:T:C	13	7	20	6	14	2	0	2
chr9:41074407:C:T	0	0	0	0	0	0	0	0
chr9:41923878:C:T	0	0	0	0	0	0	0	0
chr9:42852838:A:G	0	0	0	0	0	0	0	0
chr9:63379956:G:A	0	0	0	0	0	0	0	0
chr9:63379977:T:C	0	0	0	0	0	0	0	0
chr9:67082705:C:T	0	0	0	0	0	0	0	0
chr9:69236961:G:A	3	3	8	0	8	2	0	2
chr9:69247901:C:A	0	0	0	0	0	0	0	0
chr9:69252945:A:G	0	0	0	0	0	0	0	0
chr9:69516661:A:C	0	0	0	0	0	0	0	0
chr9:69857915:C:T	0	0	0	0	0	0	0	0
chr9:70175789:C:T	0	0	0	0	0	0	0	0
chr9:70282524:T:C	290	136	457	173	284	2.0	1.0	0.0
chr9:70535957:T:G	1	1	2	0	2	2	0	2
chr9:70536002:C:T	1	1	2	0	2	2	0	2
chr9:70536068:C:T	0	0	0	0	0	0	0	0
chr9:70537054:C:T	0	0	0	0	0	0	0	0
chr9:72008025:G:T	0	0	0	0	0	0	0	0
chr9:72360576:T:C	187	100	310	96	214	2	0	2
chr9:72792243:T:C	0	0	0	0	0	0	0	0
chr9:73160319:A:G	11	9	64	21	43	3	1	2
chr9:74642430:G:A	0	0	0	0	0	0	0	0
chr9:74761717:A:G	0	0	0	0	0	0	0	0
chr9:74761731:T:C	0	0	0	0	0	0	0	0
chr9:74800368:A:C	0	0	0	0	0	0	0	0
chr9:74827700:C:T	0	0	0	0	0	0	0	0
chr9:74887244:G:A	0	0	0	0	0	0	0	0
chr9:75137594:C:T	1265	726	2462	800	1662	2	1	2
chr9:75891271:T:C	0	0	0	0	0	0	0	0
chr9:76159037:G:A	0	0	0	0	0	0	0	0
chr9:76188596:C:T	0	0	0	0	0	0	0	0
chr9:76354143:C:A	0	0	0	0	0	0	0	0
chr9:76394223:A:G	136	68	215	73	142	2.0	1.0	1.0
chr9:76644676:C:T	0	0	0	0	0	0	0	0
chr9:76644934:A:G	0	0	0	0	0	0	0	0
chr9:76692003:G:A	0	0	0	0	0	0	0	0
chr9:76703555:C:T	0	0	0	0	0	0	0	0
chr9:76703761:T:C	0	0	0	0	0	0	0	0
chr9:76705724:C:T	0	0	0	0	0	0	0	0
chr9:76706360:T:C	0	0	0	0	0	0	0	0
chr9:76707152:G:T	0	0	0	0	0	0	0	0
chr9:76707758:A:G	0	0	0	0	0	0	0	0
chr9:76709263:G:A	0	0	0	0	0	0	0	0
chr9:76709825:T:C	0	0	0	0	0	0	0	0
chr9:76710642:G:C	0	0	0	0	0	0	0	0
chr9:76710699:A:G	0	0	0	0	0	0	0	0
chr9:77434382:C:T	0	0	0	0	0	0	0	0
chr9:79708750:C:T	41	16	57	25	32	1	1	0
chr9:81585614:T:C	112	48	166	66	100	1.0	1.0	0.0
chr9:81991056:C:A	0	0	0	0	0	0	0	0
chr9:82059881:A:G	0	0	0	0	0	0	0	0
chr9:83248176:A:G	1	1	2	0	2	2	0	2
chr9:83538244:T:G	0	0	0	0	0	0	0	0
chr9:84285454:T:A	0	0	0	0	0	0	0	0
chr9:84302386:T:C	0	0	0	0	0	0	0	0
chr9:84305321:T:C	0	0	0	0	0	0	0	0
chr9:84670680:C:G	0	0	0	0	0	0	0	0
chr9:84948545:C:A	0	0	0	0	0	0	0	0
chr9:87012454:A:C	0	0	0	0	0	0	0	0
chr9:87638051:C:T	0	0	0	0	0	0	0	0
chr9:87706668:C:T	0	0	0	0	0	0	0	0
chr9:87707108:G:A	0	0	0	0	0	0	0	0
chr9:87921037:C:G	0	0	0	0	0	0	0	0
chr9:87969963:G:A	0	0	0	0	0	0	0	0
chr9:87971128:G:A	0	0	0	0	0	0	0	0
chr9:87974101:A:G	0	0	0	0	0	0	0	0
chr9:89339933:C:G	66	30	101	40	61	1.0	1.0	0.0
chr9:91724039:C:T	0	0	0	0	0	0	0	0
chr9:91724340:G:A	0	0	0	0	0	0	0	0
chr9:91724406:G:A	0	0	0	0	0	0	0	0
chr9:92223355:T:C	53	17	72	38	34	1	1	0
chr9:93230888:A:G	0	0	0	0	0	0	0	0
chr9:93247754:G:A	0	0	0	0	0	0	0	0
chr9:93252974:C:T	0	0	0	0	0	0	0	0
chr9:93259030:G:A	0	0	0	0	0	0	0	0
chr9:93259141:C:T	0	0	0	0	0	0	0	0
chr9:93292781:C:T	0	0	0	0	0	0	0	0
chr9:95447312:G:A	0	0	0	0	0	0	0	0
chr9:95468802:T:C	0	0	0	0	0	0	0	0
chr9:95476097:A:G	0	0	0	0	0	0	0	0
chr9:95876006:A:G	219	119	358	112	246	2	0	2
chr9:95876024:C:T	184	105	308	84	224	2.0	0.0	2.0
chr9:96013177:G:A	16	7	23	9	14	1.0	1.0	0.0
chr9:97308069:G:C	3	2	5	1	4	2	0	2
chr9:97325063:A:G	6	4	12	2	10	2.0	0.0	2.0
chr9:97369912:C:A	3	1	4	2	2	1	1	0
chr9:97432124:T:C	116	51	168	66	102	1.0	1.0	0.0
chr9:97524149:C:A	1	1	3	1	2	3	1	2
chr9:97913534:A:G	262	181	476	87	389	2.0	0.0	2.0
chr9:98005248:C:T	75	43	122	34	88	2	0	2
chr9:98844267:G:T	0	0	0	0	0	0	0	0
chr9:99016064:C:G	0	0	0	0	0	0	0	0
chr9:99069713:G:A	0	0	0	0	0	0	0	0
chr9:99222654:C:G	1250	696	2323	747	1576	2.0	1.0	2.0
chr9:100442295:C:G	114	53	174	64	110	1.0	1.0	0.0
chr9:101421740:G:A	7	0	9	9	0	1	1	0
chr9:101623430:A:G	0	0	0	0	0	0	0	0
chr9:101670591:T:G	0	0	0	0	0	0	0	0
chr9:101670752:A:G	0	0	0	0	0	0	0	0
chr9:101670953:C:T	0	0	0	0	0	0	0	0
chr9:101671065:G:A	0	0	0	0	0	0	0	0
chr9:101686781:C:T	0	0	0	0	0	0	0	0
chr9:101737335:G:A	0	0	0	0	0	0	0	0
chr9:104505023:C:T	0	0	0	0	0	0	0	0
chr9:104505071:T:C	0	0	0	0	0	0	0	0
chr9:104569223:C:A	0	0	0	0	0	0	0	0
chr9:104598641:A:G	1	1	4	0	4	4	0	4
chr9:104599031:T:C	1	1	4	0	4	4	0	4
chr9:104604851:G:A	0	0	0	0	0	0	0	0
chr9:104617614:G:T	0	0	0	0	0	0	0	0
chr9:104618115:T:G	0	0	0	0	0	0	0	0
chr9:104694994:A:C	1	0	1	1	0	1	1	0
chr9:104695478:C:T	2	0	2	2	0	1.0	1.0	0.0
chr9:104840385:C:T	0	0	0	0	0	0	0	0
chr9:104858586:C:T	22	5	27	17	10	1.0	1.0	0.0
chr9:105520574:A:G	3	2	5	1	4	2	0	2
chr9:105521374:C:T	5	2	10	4	6	2	1	0
chr9:105521784:A:G	5	2	7	3	4	1	1	0
chr9:105525779:T:G	1	1	2	0	2	2	0	2
chr9:106927578:T:C	0	0	0	0	0	0	0	0
chr9:106928301:C:T	0	0	0	0	0	0	0	0
chr9:106929395:A:G	0	0	0	0	0	0	0	0
chr9:107487224:C:T	0	0	0	0	0	0	0	0
chr9:108855061:A:G	0	0	0	0	0	0	0	0
chr9:108855370:G:A	0	0	0	0	0	0	0	0
chr9:108855883:G:A	0	0	0	0	0	0	0	0
chr9:108879545:G:A	16	12	31	5	26	2.0	0.0	2.0
chr9:108889340:A:T	7	3	11	5	6	2	1	0
chr9:108891294:C:G	10	6	18	4	14	2.0	0.0	2.0
chr9:108897203:T:G	7	6	13	1	12	2	0	2
chr9:108965390:C:G	5	1	6	4	2	1	1	0
chr9:108992728:C:T	36	16	56	22	34	1.5	1.0	0.0
chr9:109020390:G:A	12	5	17	7	10	1.0	1.0	0.0
chr9:109119647:T:C	95	50	149	46	103	2	0	2
chr9:109457194:C:G	0	0	0	0	0	0	0	0
chr9:110244140:A:G	1169	769	2916	761	2155	2	0	2
chr9:110256475:T:C	1110	531	2426	1044	1382	2.0	1.0	0.0
chr9:110377209:C:G	0	0	0	0	0	0	0	0
chr9:110404417:T:A	0	0	0	0	0	0	0	0
chr9:110407350:T:C	0	0	0	0	0	0	0	0
chr9:110434394:G:A	0	0	0	0	0	0	0	0
chr9:110434453:A:C	0	0	0	0	0	0	0	0
chr9:110445970:T:G	0	0	0	0	0	0	0	0
chr9:110458967:T:C	0	0	0	0	0	0	0	0
chr9:110472227:T:C	0	0	0	0	0	0	0	0
chr9:110499203:C:T	0	0	0	0	0	0	0	0
chr9:111597344:C:A	0	0	0	0	0	0	0	0
chr9:111649665:G:T	34	17	53	19	34	2.0	0.5	1.0
chr9:111718282:A:G	3	2	5	1	4	2	0	2
chr9:111748193:G:C	4	3	7	1	6	2.0	0.0	2.0
chr9:112890556:G:A	0	0	0	0	0	0	0	0
chr9:112997239:G:A	0	0	0	0	0	0	0	0
chr9:113165995:T:C	58	27	86	32	54	1.0	1.0	0.0
chr9:113169423:G:A	28	12	40	16	24	1.0	1.0	0.0
chr9:113188426:A:C	30	16	46	14	32	2.0	0.0	2.0
chr9:113373918:C:T	186	120	320	72	248	2.0	0.0	2.0
chr9:113479427:T:C	0	0	0	0	0	0	0	0
chr9:113517600:T:C	1	1	2	0	2	2	0	2
chr9:113583838:G:A	1	1	2	0	2	2	0	2
chr9:113583956:G:A	2	1	3	1	2	1.5	0.5	1.0
chr9:113594236:A:G	1	0	1	1	0	1	1	0
chr9:113594496:C:T	6	1	7	5	2	1.0	1.0	0.0
chr9:114094201:C:A	0	0	0	0	0	0	0	0
chr9:114097572:C:T	0	0	0	0	0	0	0	0
chr9:114169386:A:T	0	0	0	0	0	0	0	0
chr9:114270742:T:C	0	0	0	0	0	0	0	0
chr9:114310726:C:T	0	0	0	0	0	0	0	0
chr9:114345842:C:T	28	16	46	12	34	2.0	0.0	2.0
chr9:114377000:T:C	36	21	60	17	43	2.0	0.0	2.0
chr9:114403966:A:G	75	51	127	25	102	2	0	2
chr9:114423425:C:T	39	14	55	27	28	1	1	0
chr9:114504685:C:T	260	131	419	143	276	2.0	1.0	2.0
chr9:115035318:T:C	0	0	0	0	0	0	0	0
chr9:115042265:T:C	0	0	0	0	0	0	0	0
chr9:115046506:T:A	0	0	0	0	0	0	0	0
chr9:115084291:C:T	0	0	0	0	0	0	0	0
chr9:115084301:T:C	0	0	0	0	0	0	0	0
chr9:115087035:T:C	0	0	0	0	0	0	0	0
chr9:115087362:T:G	0	0	0	0	0	0	0	0
chr9:115090743:C:T	0	0	0	0	0	0	0	0
chr9:115401284:C:T	0	0	0	0	0	0	0	0
chr9:116344602:C:A	0	0	0	0	0	0	0	0
chr9:116698641:C:T	7	2	9	5	4	1	1	0
chr9:117008201:C:T	0	0	0	0	0	0	0	0
chr9:117713024:A:G	0	0	0	0	0	0	0	0
chr9:117713324:C:T	0	0	0	0	0	0	0	0
chr9:119168029:G:A	0	0	0	0	0	0	0	0
chr9:120458551:A:G	9	2	12	8	4	1	1	0
chr9:120528758:C:G	207	109	344	108	236	2	0	2
chr9:120539068:T:G	217	109	352	118	234	2	1	2
chr9:121017727:G:A	2	2	4	0	4	2.0	0.0	2.0
chr9:121021656:T:C	2	1	3	1	2	1.5	0.5	1.0
chr9:121098411:C:T	542	327	953	253	700	2.0	0.0	2.0
chr9:121154742:T:A	133	68	212	70	142	2	1	2
chr9:121312513:T:G	1	1	2	0	2	2	0	2
chr9:122092932:C:T	11	7	18	4	14	2	0	2
chr9:122144177:C:T	558	283	944	330	614	2.0	1.0	2.0
chr9:122381513:C:A	0	0	0	0	0	0	0	0
chr9:122628595:A:C	0	0	0	0	0	0	0	0
chr9:122628747:A:C	0	0	0	0	0	0	0	0
chr9:122629090:A:G	0	0	0	0	0	0	0	0
chr9:122629130:A:G	0	0	0	0	0	0	0	0
chr9:123365932:T:C	2	2	4	0	4	2.0	0.0	2.0
chr9:123365974:G:C	2	2	4	0	4	2.0	0.0	2.0
chr9:123370640:G:A	0	0	0	0	0	0	0	0
chr9:123371218:C:T	0	0	0	0	0	0	0	0
chr9:124021154:G:C	0	0	0	0	0	0	0	0
chr9:124414882:A:G	1077	578	1971	690	1281	2	1	2
chr9:124854258:A:G	0	0	0	0	0	0	0	0
chr9:124857862:A:G	1	0	1	1	0	1	1	0
chr9:124881177:T:C	1	0	1	1	0	1	1	0
chr9:124899366:G:A	9	5	14	4	10	2	0	2
chr9:125213375:C:T	79	45	129	37	92	2	0	2
chr9:125484507:G:A	87	39	131	49	82	1	1	0
chr9:126833616:T:C	538	302	910	274	636	2.0	0.0	2.0
chr9:127091920:G:A	14	10	25	5	20	2.0	0.0	2.0
chr9:127313393:C:T	2	1	3	1	2	1.5	0.5	1.0
chr9:127402539:T:C	1	0	1	1	0	1	1	0
chr9:127403650:G:A	1	0	1	1	0	1	1	0
chr9:127404103:C:G	0	0	0	0	0	0	0	0
chr9:127435135:A:G	13	9	22	4	18	2	0	2
chr9:127444483:C:T	7	3	10	4	6	1	1	0
chr9:127447832:T:C	55	27	84	30	54	2	1	0
chr9:127451229:A:G	805	340	1421	623	798	2	1	0
chr9:127457390:C:T	79	34	118	46	72	1	1	0
chr9:127479887:A:G	52	25	81	29	52	1.5	1.0	0.0
chr9:127525008:C:A	0	0	0	0	0	0	0	0
chr9:127712732:T:C	1	0	1	1	0	1	1	0
chr9:127713163:A:C	4	2	6	2	4	1.5	0.5	1.0
chr9:127715489:G:A	12	2	16	10	6	1.0	1.0	0.0
chr9:127727279:A:G	2	2	6	0	6	3.0	0.0	3.0
chr9:127727464:A:G	0	0	0	0	0	0	0	0
chr9:127729719:A:G	0	0	0	0	0	0	0	0
chr9:127729760:G:A	0	0	0	0	0	0	0	0
chr9:127731234:A:G	0	0	0	0	0	0	0	0
chr9:127731445:C:T	0	0	0	0	0	0	0	0
chr9:127732532:T:C	11	4	17	7	10	1	1	0
chr9:127733354:C:G	3	2	5	1	4	2	0	2
chr9:127733611:A:C	1	0	1	1	0	1	1	0
chr9:127741791:G:A	65	44	111	23	88	2	0	2
chr9:127771215:G:A	11	6	17	5	12	2	0	2
chr9:127774438:G:A	93	45	143	52	91	1	1	0
chr9:127816125:A:G	0	0	0	0	0	0	0	0
chr9:127854367:G:A	23	8	32	16	16	1	1	0
chr9:128166354:C:T	274	137	428	150	278	2.0	1.0	0.5
chr9:128176382:C:T	119	59	182	62	120	2	1	0
chr9:128222476:C:T	0	0	0	0	0	0	0	0
chr9:129612425:C:A	0	0	0	0	0	0	0	0
chr9:129807253:C:T	31	9	40	22	18	1	1	0
chr9:129807274:C:T	31	22	53	9	44	2	0	2
chr9:129822779:G:A	253	121	392	144	248	1	1	0
chr9:129828152:C:G	722	336	1196	463	733	2.0	1.0	0.0
chr9:129829230:A:G	642	299	1048	400	648	2.0	1.0	0.0
chr9:129834742:C:T	1233	660	2287	797	1490	2	1	2
chr9:130200522:A:T	0	0	0	0	0	0	0	0
chr9:130200537:T:C	0	0	0	0	0	0	0	0
chr9:130226430:T:G	0	0	0	0	0	0	0	0
chr9:130360514:C:A	0	0	0	0	0	0	0	0
chr9:130360540:C:T	0	0	0	0	0	0	0	0
chr9:130365940:G:T	0	0	0	0	0	0	0	0
chr9:130369761:C:T	0	0	0	0	0	0	0	0
chr9:130429625:G:A	0	0	0	0	0	0	0	0
chr9:130432597:C:T	0	0	0	0	0	0	0	0
chr9:130433627:T:C	0	0	0	0	0	0	0	0
chr9:130884159:G:A	2	1	3	1	2	1.5	0.5	1.0
chr9:130885205:C:T	2	1	3	1	2	1.5	0.5	1.0
chr9:130893782:G:A	0	0	0	0	0	0	0	0
chr9:131036211:A:G	0	0	0	0	0	0	0	0
chr9:131036319:C:T	0	0	0	0	0	0	0	0
chr9:131039183:G:A	0	0	0	0	0	0	0	0
chr9:131052958:C:T	0	0	0	0	0	0	0	0
chr9:131087543:C:T	0	0	0	0	0	0	0	0
chr9:131091853:T:C	0	0	0	0	0	0	0	0
chr9:131120242:A:G	0	0	0	0	0	0	0	0
chr9:131187346:T:C	8	5	13	3	10	2.0	0.0	2.0
chr9:131198420:A:G	22	11	34	12	22	2.0	0.5	1.0
chr9:131222712:G:C	8	3	11	5	6	1.0	1.0	0.0
chr9:131260777:C:T	187	98	308	92	216	2	0	2
chr9:131289981:G:C	0	0	0	0	0	0	0	0
chr9:131308257:C:T	0	0	0	0	0	0	0	0
chr9:131432739:G:A	302	142	486	178	308	1.5	1.0	0.0
chr9:131598268:C:T	93	43	139	51	88	1	1	0
chr9:132198580:C:T	0	0	0	0	0	0	0	0
chr9:132499511:T:C	0	0	0	0	0	0	0	0
chr9:132595027:T:C	22	9	31	13	18	1.0	1.0	0.0
chr9:132645916:C:T	11	3	14	8	6	1	1	0
chr9:132679179:G:A	38	14	52	24	28	1.0	1.0	0.0
chr9:132900647:C:T	1	0	1	1	0	1	1	0
chr9:133019798:G:T	751	0	871	871	0	1	1	0
chr9:133020529:C:A	202	0	211	211	0	1.0	1.0	0.0
chr9:133098692:G:C	62	25	92	38	54	1.0	1.0	0.0
chr9:133104364:C:G	3	2	5	1	4	2	0	2
chr9:133106701:A:C	17	9	27	9	18	2	0	2
chr9:133108117:T:C	6	4	10	2	8	2.0	0.0	2.0
chr9:133129383:C:T	2	1	3	1	2	1.5	0.5	1.0
chr9:133155959:A:G	5	3	8	2	6	2	0	2
chr9:133318380:T:C	1	0	1	1	0	1	1	0
chr9:133332630:G:A	48	27	78	22	56	2.0	0.0	2.0
chr9:133332667:G:A	50	28	81	23	58	2.0	0.0	2.0
chr9:133346666:C:T	71	23	97	51	46	1	1	0
chr9:133360384:G:A	536	267	862	300	562	2.0	1.0	0.0
chr9:133402909:T:C	1	0	1	1	0	1	1	0
chr9:133402955:G:A	1	1	2	0	2	2	0	2
chr9:133405414:T:G	2	2	4	0	4	2.0	0.0	2.0
chr9:133412360:G:A	75	44	123	33	90	2	0	2
chr9:133425943:T:C	3	2	5	1	4	2	0	2
chr9:133436862:C:G	1	1	2	0	2	2	0	2
chr9:133439376:G:A	0	0	0	0	0	0	0	0
chr9:133443421:T:C	0	0	0	0	0	0	0	0
chr9:133459117:C:A	13	7	20	6	14	2	0	2
chr9:133463535:T:C	23	7	32	18	14	1	1	0
chr9:133475078:T:G	31	11	44	20	24	1	1	0
chr9:133514768:A:G	0	0	0	0	0	0	0	0
chr9:133642455:C:T	0	0	0	0	0	0	0	0
chr9:133658327:C:T	0	0	0	0	0	0	0	0
chr9:133671671:C:G	0	0	0	0	0	0	0	0
chr9:133763952:G:C	4	0	4	4	0	1.0	1.0	0.0
chr9:134033505:A:G	67	38	106	29	77	2	0	2
chr9:134041883:G:A	73	37	113	37	76	2	0	2
chr9:134053540:C:A	66	30	103	37	66	1.0	1.0	0.0
chr9:134436596:G:A	20	10	33	11	22	2.0	0.5	1.0
chr9:134727349:C:T	0	0	0	0	0	0	0	0
chr9:134810349:C:T	0	0	0	0	0	0	0	0
chr9:134842386:C:T	0	0	0	0	0	0	0	0
chr9:134880818:A:G	0	0	0	0	0	0	0	0
chr9:134887180:C:T	0	0	0	0	0	0	0	0
chr9:134887460:T:G	0	0	0	0	0	0	0	0
chr9:134909954:T:C	0	0	0	0	0	0	0	0
chr9:134912514:A:G	0	0	0	0	0	0	0	0
chr9:134917839:C:A	0	0	0	0	0	0	0	0
chr9:135484803:T:C	1	0	1	1	0	1	1	0
chr9:135485126:A:G	2	1	3	1	2	1.5	0.5	1.0
chr9:135485587:G:A	1	0	1	1	0	1	1	0
chr9:135485652:G:T	1	1	2	0	2	2	0	2
chr9:135485811:T:C	0	0	0	0	0	0	0	0
chr9:135486007:A:G	0	0	0	0	0	0	0	0
chr9:135504123:A:G	250	131	402	130	272	2.0	1.0	2.0
chr9:135547946:G:A	0	0	0	0	0	0	0	0
chr9:135547960:CGCT:TGCC	0	0	0	0	0	0	0	0
chr9:135695094:C:A	0	0	0	0	0	0	0	0
chr9:135753870:C:T	0	0	0	0	0	0	0	0
chr9:135791729:T:C	0	0	0	0	0	0	0	0
chr9:135850231:C:G	4	3	7	1	6	2.0	0.0	2.0
chr9:136011825:A:G	0	0	0	0	0	0	0	0
chr9:136013290:C:T	0	0	0	0	0	0	0	0
chr9:136208959:T:C	6	4	10	2	8	2.0	0.0	2.0
chr9:136286167:G:C	5	3	8	2	6	2	0	2
chr9:136286366:A:G	3	3	6	0	6	2	0	2
chr9:136286383:C:A	3	3	6	0	6	2	0	2
chr9:136286509:T:C	3	3	6	0	6	2	0	2
chr9:136291438:C:T	0	0	0	0	0	0	0	0
chr9:136300266:G:A	9	5	15	5	10	2	0	2
chr9:136303170:T:G	11	7	21	5	16	2	0	2
chr9:136340958:C:T	1	0	1	1	0	1	1	0
chr9:136358043:G:A	0	0	0	0	0	0	0	0
chr9:136364010:A:G	63	28	98	38	60	1	1	0
chr9:136371953:G:A	7	3	11	5	6	1	1	0
chr9:136372044:C:T	6	3	10	4	6	1.5	1.0	1.0
chr9:136377606:A:G	42	25	69	19	50	2.0	0.0	2.0
chr9:136378950:C:T	3	2	5	1	4	2	0	2
chr9:136380752:A:C	4	3	7	1	6	2.0	0.0	2.0
chr9:136380842:G:C	3	3	6	0	6	2	0	2
chr9:136395373:A:G	59	36	95	23	72	2	0	2
chr9:136404141:A:G	95	52	148	44	104	2	0	2
chr9:136405221:G:C	10	6	16	4	12	2.0	0.0	2.0
chr9:136407131:T:C	54	26	82	28	54	1.0	1.0	0.0
chr9:136417019:C:T	105	58	169	51	118	2	0	2
chr9:136429577:C:T	12	4	16	8	8	1.0	1.0	0.0
chr9:136430285:C:A	8	2	10	6	4	1.0	1.0	0.0
chr9:136432582:A:G	2	1	3	1	2	1.5	0.5	1.0
chr9:136432987:A:G	2	1	3	1	2	1.5	0.5	1.0
chr9:136474501:G:A	3	1	4	2	2	1	1	0
chr9:136474610:C:T	1	0	1	1	0	1	1	0
chr9:136476890:G:A	46	28	78	18	60	2.0	0.0	2.0
chr9:136476953:G:C	45	27	76	18	58	2	0	2
chr9:136477334:A:C	56	32	92	24	68	2.0	0.0	2.0
chr9:136670216:G:A	6	5	22	10	12	2.0	0.0	2.0
chr9:136755715:G:A	80	19	106	66	40	1.0	1.0	0.0
chr9:136756451:A:G	22	8	30	14	16	1.0	1.0	0.0
chr9:136833601:G:A	14	7	22	8	14	2.0	0.5	1.0
chr9:136854031:G:A	1	1	2	0	2	2	0	2
chr9:136854615:C:T	1	1	2	0	2	2	0	2
chr9:136858447:T:G	4	1	5	3	2	1.0	1.0	0.0
chr9:136925911:A:G	55	32	87	23	64	2	0	2
chr9:136925969:G:A	58	24	82	34	48	1.0	1.0	0.0
chr9:136946091:A:G	7	4	11	3	8	2	0	2
chr9:136977596:A:G	0	0	0	0	0	0	0	0
chr9:136984718:G:A	0	0	0	0	0	0	0	0
chr9:137008334:G:C	0	0	0	0	0	0	0	0
chr9:137008345:C:G	0	0	0	0	0	0	0	0
chr9:137011907:G:A	1	1	2	0	2	2	0	2
chr9:137017726:G:A	0	0	0	0	0	0	0	0
chr9:137028813:A:G	0	0	0	0	0	0	0	0
chr9:137048977:G:A	0	0	0	0	0	0	0	0
chr9:137050911:G:A	0	0	0	0	0	0	0	0
chr9:137078448:T:C	2	1	3	1	2	1.5	0.5	1.0
chr9:137107684:G:A	7	3	10	4	6	1	1	0
chr9:137107735:C:T	7	3	10	4	6	1	1	0
chr9:137108537:T:C	93	51	146	44	102	2	0	2
chr9:137111973:C:G	1407	725	2555	967	1588	2	1	2
chr9:137156786:A:G	0	0	0	0	0	0	0	0
chr9:137156924:G:A	0	0	0	0	0	0	0	0
chr9:137183187:G:A	7	6	13	1	12	2	0	2
chr9:137183277:G:A	0	0	0	0	0	0	0	0
chr9:137185070:G:A	7	3	10	4	6	1	1	0
chr9:137189924:G:A	1325	790	2611	833	1778	2	1	2
chr9:137199854:G:A	7	5	12	2	10	2	0	2
chr9:137205772:A:G	247	112	379	146	233	1	1	0
chr9:137225944:C:T	3	3	5	0	5	2	0	2
chr9:137236154:A:T	0	0	0	0	0	0	0	0
chr9:137236430:A:C	0	0	0	0	0	0	0	0
chr9:137252700:C:G	1	1	4	0	4	4	0	4
chr9:137272570:G:A	136	77	218	63	155	2.0	0.0	2.0
chr9:137349428:G:A	2	1	3	1	2	1.5	0.5	1.0
chr9:137373594:C:T	106	55	164	52	112	2.0	0.0	2.0
chr9:137383374:C:T	111	55	169	57	112	1	1	0
chr9:137433211:C:T	15	6	21	9	12	1	1	0
chr9:137437096:G:A	0	0	0	0	0	0	0	0
chr9:137461970:G:C	31	11	43	21	22	1	1	0
chr9:137462390:G:A	16	8	24	8	16	1.5	0.5	1.0
chr9:137464129:C:T	19	13	34	6	28	2	0	2
chr9:137498164:G:A	8	3	13	5	8	1.0	1.0	0.0
chr9:137500894:G:A	4	2	6	2	4	1.5	0.5	1.0
chr9:137519958:C:T	23	14	37	9	28	2	0	2
chr9:137612856:C:T	4	2	6	2	4	1.5	0.5	1.0
chr9:137716984:T:C	737	359	1187	442	745	2	1	0
chr9:137743964:G:A	151	68	224	88	136	1	1	0
chr9:137744009:T:C	150	66	221	89	132	1.0	1.0	0.0
chr9:137762898:C:T	11	8	19	3	16	2	0	2
chr9:137814316:T:G	1	0	1	1	0	1	1	0
chr9:137882918:A:C	0	0	0	0	0	0	0	0
chr9:138175392:T:C	0	0	0	0	0	0	0	0
chr9:138175453:C:T	0	0	0	0	0	0	0	0
chr10:47663:C:T	0	0	0	0	0	0	0	0
chr10:48605:C:T	0	0	0	0	0	0	0	0
chr10:384037:G:A	16	9	25	7	18	2.0	0.0	2.0
chr10:441043:G:A	0	0	0	0	0	0	0	0
chr10:650297:G:A	0	0	0	0	0	0	0	0
chr10:988472:C:T	462	223	731	266	465	1.5	1.0	0.0
chr10:1000772:G:A	309	158	496	164	332	2	1	2
chr10:1019466:G:T	25	10	35	15	20	1	1	0
chr10:1019770:C:T	31	19	50	12	38	2	0	2
chr10:1022699:C:T	6	4	11	3	8	2.0	0.0	2.0
chr10:1737155:G:A	1	0	1	1	0	1	1	0
chr10:3138035:T:C	137	79	226	62	164	2	0	2
chr10:3138106:C:T	133	55	197	84	113	1	1	0
chr10:3138811:A:G	8	2	12	6	6	1.0	1.0	0.0
chr10:3145557:A:G	2	1	3	1	2	1.5	0.5	1.0
chr10:3145732:T:C	3	3	6	0	6	2	0	2
chr10:3148073:A:G	4	1	5	3	2	1.0	1.0	0.0
chr10:3148106:C:T	2	0	2	2	0	1.0	1.0	0.0
chr10:3163659:C:G	15	10	25	5	20	2	0	2
chr10:5096415:G:A	3	3	7	1	6	2	0	2
chr10:5162965:C:T	0	0	0	0	0	0	0	0
chr10:5393955:G:A	0	0	0	0	0	0	0	0
chr10:5394297:A:G	0	0	0	0	0	0	0	0
chr10:5395402:A:G	0	0	0	0	0	0	0	0
chr10:5456285:G:T	0	0	0	0	0	0	0	0
chr10:5953089:C:T	45	16	61	29	32	1	1	0
chr10:6026014:C:G	334	304	713	37	676	2.0	0.0	2.0
chr10:6146375:A:G	1	0	1	1	0	1	1	0
chr10:6430929:G:T	0	0	0	0	0	0	0	0
chr10:6456761:G:A	1	0	1	1	0	1	1	0
chr10:7171965:C:T	3	0	3	3	0	1	1	0
chr10:7579808:A:G	0	0	0	0	0	0	0	0
chr10:7580046:G:A	0	0	0	0	0	0	0	0
chr10:7717632:C:T	0	0	0	0	0	0	0	0
chr10:7807725:T:C	1543	903	3134	1039	2095	2	1	2
chr10:11314358:C:T	51	20	72	32	40	1	1	0
chr10:12089082:T:G	29	13	42	16	26	1	1	0
chr10:12097885:C:T	24	7	32	18	14	1.0	1.0	0.0
chr10:12101106:C:G	29	10	40	20	20	1	1	0
chr10:12149934:C:T	52	27	83	27	56	2.0	0.5	2.0
chr10:12158126:C:T	19	10	29	9	20	2	0	2
chr10:12167753:T:C	967	498	1702	598	1104	2	1	2
chr10:13333906:T:C	91	47	144	46	98	2	0	2
chr10:14934415:G:A	76	36	116	44	72	1.0	1.0	0.0
chr10:17114152:A:G	2	1	3	1	2	1.5	0.5	1.0
chr10:17229401:G:C	3340	2497	18152	5921	12231	4.0	1.0	2.0
chr10:17714597:T:C	125	57	190	74	116	1	1	0
chr10:17796225:C:A	0	0	0	0	0	0	0	0
chr10:17823255:G:A	140	80	242	66	176	2.0	0.0	2.0
chr10:17827578:C:T	40	18	58	22	36	1.0	1.0	0.0
chr10:17833763:G:A	40	21	62	20	42	2.0	0.0	2.0
chr10:17870917:T:C	29	10	41	19	22	1	1	0
chr10:19136602:A:G	0	0	0	0	0	0	0	0
chr10:19387624:A:G	0	0	0	0	0	0	0	0
chr10:19387632:G:A	0	0	0	0	0	0	0	0
chr10:19389568:G:A	0	0	0	0	0	0	0	0
chr10:20217489:G:A	0	0	0	0	0	0	0	0
chr10:20245404:A:G	0	0	0	0	0	0	0	0
chr10:20831187:A:G	0	0	0	0	0	0	0	0
chr10:21029528:C:A	0	0	0	0	0	0	0	0
chr10:21517903:A:C	0	0	0	0	0	0	0	0
chr10:21538867:G:A	266	126	418	148	270	1.0	1.0	0.0
chr10:22537164:A:C	53	30	83	23	60	2	0	2
chr10:23002023:C:T	0	0	0	0	0	0	0	0
chr10:23193706:T:C	0	0	0	0	0	0	0	0
chr10:24524353:G:C	0	0	0	0	0	0	0	0
chr10:24524398:A:G	0	0	0	0	0	0	0	0
chr10:24543956:C:T	0	0	0	0	0	0	0	0
chr10:24584440:C:G	8	3	11	5	6	1.0	1.0	0.0
chr10:24619757:T:C	8	4	11	4	7	1.0	0.5	0.5
chr10:25023760:A:G	11	7	20	4	16	2	0	2
chr10:25061196:G:A	1	0	1	1	0	1	1	0
chr10:26021668:G:A	62	62	128	0	128	2.0	0.0	2.0
chr10:26173861:G:A	30	0	32	32	0	1.0	1.0	0.0
chr10:26270642:G:C	0	0	0	0	0	0	0	0
chr10:27170787:G:A	51	27	83	25	58	2	0	2
chr10:27413240:C:T	0	0	0	0	0	0	0	0
chr10:27414305:A:G	0	0	0	0	0	0	0	0
chr10:27675541:G:A	0	0	0	0	0	0	0	0
chr10:29292564:A:C	0	0	0	0	0	0	0	0
chr10:29465746:A:G	7	4	11	3	8	2	0	2
chr10:29480660:C:T	0	0	0	0	0	0	0	0
chr10:29523673:G:T	0	0	0	0	0	0	0	0
chr10:29550869:A:G	0	0	0	0	0	0	0	0
chr10:30028144:G:A	0	0	0	0	0	0	0	0
chr10:30340207:G:A	240	124	373	121	252	2.0	0.0	2.0
chr10:30340297:G:A	346	168	530	190	340	2.0	1.0	0.0
chr10:30612827:G:A	0	0	0	0	0	0	0	0
chr10:30845285:A:G	6	4	12	2	10	2.0	0.0	2.0
chr10:30849888:G:A	13	7	20	6	14	2	0	2
chr10:32286865:A:G	19	11	31	9	22	2	0	2
chr10:33213312:C:T	0	0	0	0	0	0	0	0
chr10:33334323:G:A	1	0	1	1	0	1	1	0
chr10:35032486:C:T	18	10	30	10	20	2.0	0.0	2.0
chr10:35137827:A:G	16	11	29	5	24	2.0	0.0	2.0
chr10:35196021:T:G	33	17	50	16	34	2	0	2
chr10:35607772:C:T	0	0	0	0	0	0	0	0
chr10:36523434:C:T	1	0	1	1	0	1	1	0
chr10:37130290:C:T	0	0	0	0	0	0	0	0
chr10:37219522:A:C	0	0	0	0	0	0	0	0
chr10:38118591:A:G	33	16	50	18	32	2	1	0
chr10:38356475:T:C	178	77	267	107	160	1.0	1.0	0.0
chr10:42593708:C:T	16	7	23	9	14	1.0	1.0	0.0
chr10:42785641:T:C	166	79	258	94	164	1.0	1.0	0.0
chr10:43102379:C:A	0	0	0	0	0	0	0	0
chr10:43111239:A:G	0	0	0	0	0	0	0	0
chr10:43375710:G:A	0	0	0	0	0	0	0	0
chr10:43387894:T:A	528	279	924	310	614	2.0	1.0	2.0
chr10:43476131:T:G	36	7	45	31	14	1.0	1.0	0.0
chr10:43616352:T:C	18	9	29	9	20	1.5	0.5	1.0
chr10:44375898:G:A	0	0	0	0	0	0	0	0
chr10:44935014:C:T	0	0	0	0	0	0	0	0
chr10:44978104:C:T	1	1	2	0	2	2	0	2
chr10:45000672:A:T	5	4	9	1	8	2	0	2
chr10:45443298:C:T	64	22	89	45	44	1.0	1.0	0.0
chr10:45648510:T:G	22	15	37	7	30	2.0	0.0	2.0
chr10:45678964:G:A	0	0	0	0	0	0	0	0
chr10:45788964:G:A	42	16	59	27	32	1.0	1.0	0.0
chr10:46012928:G:A	168	101	278	72	206	2.0	0.0	2.0
chr10:46046326:A:G	0	0	0	0	0	0	0	0
chr10:46330039:G:A	0	0	0	0	0	0	0	0
chr10:46330066:C:G	0	0	0	0	0	0	0	0
chr10:46549296:C:T	0	0	0	0	0	0	0	0
chr10:46549378:G:A	0	0	0	0	0	0	0	0
chr10:46549471:G:A	0	0	0	0	0	0	0	0
chr10:46549538:A:G	0	0	0	0	0	0	0	0
chr10:46549546:C:T	0	0	0	0	0	0	0	0
chr10:46549695:C:A	0	0	0	0	0	0	0	0
chr10:46550419:C:A	0	0	0	0	0	0	0	0
chr10:46550466:A:G	0	0	0	0	0	0	0	0
chr10:46550587:G:A	0	0	0	0	0	0	0	0
chr10:46550598:C:T	0	0	0	0	0	0	0	0
chr10:46550618:C:T	0	0	0	0	0	0	0	0
chr10:46550622:G:C	0	0	0	0	0	0	0	0
chr10:46550723:C:T	0	0	0	0	0	0	0	0
chr10:48010528:C:T	9	0	9	9	0	1	1	0
chr10:48010536:C:G	9	0	9	9	0	1	1	0
chr10:48031495:A:C	1	0	2	2	0	2	2	0
chr10:48479757:G:A	1	1	2	0	2	2	0	2
chr10:48604872:T:C	0	0	0	0	0	0	0	0
chr10:48970205:T:C	295	147	470	166	304	2	1	0
chr10:49131709:G:T	0	0	0	0	0	0	0	0
chr10:49131917:A:T	0	0	0	0	0	0	0	0
chr10:49166774:T:C	0	0	0	0	0	0	0	0
chr10:49323504:G:T	0	0	0	0	0	0	0	0
chr10:49323927:A:C	0	0	0	0	0	0	0	0
chr10:49324543:C:G	0	0	0	0	0	0	0	0
chr10:49324767:A:G	0	0	0	0	0	0	0	0
chr10:49325192:G:A	0	0	0	0	0	0	0	0
chr10:49325418:T:A	0	0	0	0	0	0	0	0
chr10:49325796:G:C	0	0	0	0	0	0	0	0
chr10:49326305:G:A	0	0	0	0	0	0	0	0
chr10:49326817:T:C	0	0	0	0	0	0	0	0
chr10:49458762:A:G	7	3	10	4	6	1	1	0
chr10:49459059:T:C	8	4	12	4	8	1.5	0.5	1.0
chr10:49470323:T:C	7	4	11	3	8	2	0	2
chr10:49470671:T:C	11	6	17	5	12	2	0	2
chr10:49616573:G:A	0	0	0	0	0	0	0	0
chr10:49648597:C:T	0	0	0	0	0	0	0	0
chr10:49693892:C:T	0	0	0	0	0	0	0	0
chr10:49694638:C:T	0	0	0	0	0	0	0	0
chr10:49708496:C:T	0	0	0	0	0	0	0	0
chr10:49752163:G:A	0	0	0	0	0	0	0	0
chr10:50061509:C:A	1	0	1	1	0	1	1	0
chr10:50068003:A:G	564	286	932	325	607	2.0	1.0	2.0
chr10:50129923:C:A	165	76	268	98	170	1	1	0
chr10:50343947:A:G	33	13	46	20	26	1	1	0
chr10:50683558:A:C	0	0	0	0	0	0	0	0
chr10:52771475:C:T	0	0	0	0	0	0	0	0
chr10:52771482:G:A	0	0	0	0	0	0	0	0
chr10:53806646:T:G	0	0	0	0	0	0	0	0
chr10:54664208:A:C	0	0	0	0	0	0	0	0
chr10:56358869:T:C	4	0	5	5	0	1.0	1.0	0.0
chr10:60042792:A:T	0	0	0	0	0	0	0	0
chr10:60071532:T:C	0	0	0	0	0	0	0	0
chr10:60072226:G:T	0	0	0	0	0	0	0	0
chr10:60911547:G:A	0	0	0	0	0	0	0	0
chr10:62198353:T:C	1	1	2	0	2	2	0	2
chr10:62399574:G:T	1	0	1	1	0	1	1	0
chr10:62805132:G:T	34	18	51	16	35	1.5	0.0	1.5
chr10:62805174:C:G	34	18	52	16	36	2.0	0.0	2.0
chr10:63185604:G:A	135	67	216	72	144	2	1	0
chr10:63213588:T:C	109	53	169	59	110	1	1	0
chr10:63214777:A:T	204	95	320	124	196	2.0	1.0	0.0
chr10:68166340:T:C	0	0	0	0	0	0	0	0
chr10:68166577:C:G	0	0	0	0	0	0	0	0
chr10:68174164:G:A	0	0	0	0	0	0	0	0
chr10:68174212:G:A	0	0	0	0	0	0	0	0
chr10:68174501:C:G	0	0	0	0	0	0	0	0
chr10:68199485:C:A	0	0	0	0	0	0	0	0
chr10:68288455:C:T	5	4	9	1	8	2	0	2
chr10:68885620:A:C	0	0	0	0	0	0	0	0
chr10:68946686:C:T	118	67	200	58	142	2.0	0.0	2.0
chr10:69195300:A:G	47	20	67	27	40	1	1	0
chr10:69232908:C:T	0	0	0	0	0	0	0	0
chr10:69483873:A:T	0	0	0	0	0	0	0	0
chr10:69572448:A:G	0	0	0	0	0	0	0	0
chr10:69632801:C:T	0	0	0	0	0	0	0	0
chr10:69632936:T:C	0	0	0	0	0	0	0	0
chr10:69918302:C:G	0	0	0	0	0	0	0	0
chr10:70114292:G:A	48	24	85	27	58	2.0	1.0	1.0
chr10:70116626:C:T	44	22	74	28	46	2.0	1.0	1.0
chr10:70209261:A:T	915	547	1810	542	1268	2	0	2
chr10:70301261:C:T	1	1	2	0	2	2	0	2
chr10:70323903:C:T	1	1	2	0	2	2	0	2
chr10:70529945:G:A	0	0	0	0	0	0	0	0
chr10:70538924:C:T	0	0	0	0	0	0	0	0
chr10:70547345:C:T	0	0	0	0	0	0	0	0
chr10:70598899:G:A	26	25	51	1	50	2.0	0.0	2.0
chr10:70743588:G:A	0	0	0	0	0	0	0	0
chr10:70753926:C:T	0	0	0	0	0	0	0	0
chr10:70760498:C:T	0	0	0	0	0	0	0	0
chr10:70760574:A:G	0	0	0	0	0	0	0	0
chr10:70760811:A:G	0	0	0	0	0	0	0	0
chr10:70777180:A:G	0	0	0	0	0	0	0	0
chr10:70869926:G:A	17	7	25	11	14	1	1	0
chr10:71322806:A:G	102	54	170	50	120	2.0	0.0	2.0
chr10:71356184:TG:CA	18	11	33	7	26	2.0	0.0	2.0
chr10:71509957:T:C	0	0	0	0	0	0	0	0
chr10:71511149:T:C	0	0	0	0	0	0	0	0
chr10:71675149:G:A	0	0	0	0	0	0	0	0
chr10:71695444:T:C	2	0	3	3	0	1.5	1.5	0.0
chr10:71695516:T:C	2	0	3	3	0	1.5	1.5	0.0
chr10:71695519:G:A	2	2	6	0	6	3.0	0.0	3.0
chr10:71773420:A:G	84	37	131	54	77	1.0	1.0	0.0
chr10:71777857:G:A	0	0	0	0	0	0	0	0
chr10:71790360:C:G	0	0	0	0	0	0	0	0
chr10:72008459:C:T	0	0	0	0	0	0	0	0
chr10:72354778:C:G	676	365	1150	374	776	2.0	1.0	2.0
chr10:72355020:C:T	22	8	32	14	18	1.0	1.0	0.0
chr10:73647154:G:T	0	0	0	0	0	0	0	0
chr10:73647532:G:A	0	0	0	0	0	0	0	0
chr10:73647891:A:C	0	0	0	0	0	0	0	0
chr10:73655919:C:T	3	1	4	2	2	1	1	0
chr10:73746916:T:C	181	84	280	104	176	1	1	0
chr10:73767950:A:G	99	42	143	59	84	1	1	0
chr10:73770255:C:T	9	3	13	7	6	1	1	0
chr10:73771204:C:T	60	30	87	31	56	1.0	0.5	0.5
chr10:73799109:G:A	19	7	26	12	14	1	1	0
chr10:73799319:G:A	35	17	54	18	36	1	1	0
chr10:73807071:A:G	6	4	10	2	8	2.0	0.0	2.0
chr10:73914121:C:T	0	0	0	0	0	0	0	0
chr10:74111977:C:G	6	3	9	3	6	1.5	0.5	1.0
chr10:74176853:C:T	1532	878	3081	991	2090	2.0	1.0	2.0
chr10:75094806:C:T	0	0	0	0	0	0	0	0
chr10:75095663:G:A	0	0	0	0	0	0	0	0
chr10:75101922:T:C	0	0	0	0	0	0	0	0
chr10:76047269:T:C	3	3	7	1	6	2	0	2
chr10:77090562:C:G	0	0	0	0	0	0	0	0
chr10:77792393:T:C	0	0	0	0	0	0	0	0
chr10:77811115:G:T	0	0	0	0	0	0	0	0
chr10:77820072:G:A	0	0	0	0	0	0	0	0
chr10:77869117:A:G	0	0	0	0	0	0	0	0
chr10:77869203:G:A	0	0	0	0	0	0	0	0
chr10:79386335:G:A	0	0	0	0	0	0	0	0
chr10:79558907:C:G	0	0	0	0	0	0	0	0
chr10:79559598:C:T	0	0	0	0	0	0	0	0
chr10:79559644:A:T	0	0	0	0	0	0	0	0
chr10:79611585:G:T	0	0	0	0	0	0	0	0
chr10:79611881:T:C	0	0	0	0	0	0	0	0
chr10:79611973:C:G	0	0	0	0	0	0	0	0
chr10:79612325:A:G	0	0	0	0	0	0	0	0
chr10:79613765:A:G	0	0	0	0	0	0	0	0
chr10:79938062:A:G	0	0	0	0	0	0	0	0
chr10:79938112:A:T	0	0	0	0	0	0	0	0
chr10:80166946:G:A	949	486	1621	586	1035	2	1	2
chr10:80166962:A:G	934	523	1661	513	1148	2.0	1.0	2.0
chr10:80172924:C:T	0	0	0	0	0	0	0	0
chr10:80247462:C:T	0	0	0	0	0	0	0	0
chr10:80509482:C:T	1	0	1	1	0	1	1	0
chr10:84212287:A:G	1	1	4	0	4	4	0	4
chr10:84222045:T:G	0	0	0	0	0	0	0	0
chr10:84225575:C:T	0	0	0	0	0	0	0	0
chr10:84232634:G:T	0	0	0	0	0	0	0	0
chr10:84252957:C:T	0	0	0	0	0	0	0	0
chr10:84258704:A:G	0	0	0	0	0	0	0	0
chr10:84513493:T:C	30	10	40	20	20	1.0	1.0	0.0
chr10:86443451:T:C	3	0	3	3	0	1	1	0
chr10:86662271:C:G	0	0	0	0	0	0	0	0
chr10:86970349:C:T	13	7	20	6	14	2	0	2
chr10:86970420:A:G	17	9	26	8	18	2	0	2
chr10:87008666:A:G	1	0	1	1	0	1	1	0
chr10:87961150:T:G	75	38	119	39	80	2	0	2
chr10:88678450:A:G	0	0	0	0	0	0	0	0
chr10:89010682:C:G	7	6	13	1	12	2	0	2
chr10:89247603:T:G	167	68	244	106	138	1	1	0
chr10:89307012:C:A	82	37	130	50	80	1.5	1.0	0.0
chr10:89378069:T:C	1	1	2	0	2	2	0	2
chr10:89383772:T:A	1	0	1	1	0	1	1	0
chr10:89418243:C:T	87	41	135	47	88	1	1	0
chr10:89644691:C:G	8	5	13	3	10	2.0	0.0	2.0
chr10:89725023:G:A	72	33	108	40	68	1.0	1.0	0.0
chr10:90912807:T:C	0	0	0	0	0	0	0	0
chr10:91807332:C:A	28	15	45	13	32	2.0	0.0	2.0
chr10:92240093:A:G	24	13	37	11	26	2.0	0.0	2.0
chr10:92574070:G:A	48	33	84	15	69	2.0	0.0	2.0
chr10:92834808:G:A	110	76	220	42	178	2.0	0.0	2.0
chr10:93062929:C:T	1	0	1	1	0	1	1	0
chr10:93313149:T:C	0	0	0	0	0	0	0	0
chr10:93698384:A:G	421	222	726	236	490	2	1	2
chr10:93960733:C:T	0	0	0	0	0	0	0	0
chr10:93960744:T:C	0	0	0	0	0	0	0	0
chr10:94171330:G:T	0	0	0	0	0	0	0	0
chr10:94252351:C:T	0	0	0	0	0	0	0	0
chr10:94265940:G:A	0	0	0	0	0	0	0	0
chr10:94298541:CC:TT	0	0	0	0	0	0	0	0
chr10:94306584:A:G	2	0	2	2	0	1.0	1.0	0.0
chr10:94338616:C:T	221	152	389	75	314	2	0	2
chr10:94344908:T:G	84	16	103	71	32	1.0	1.0	0.0
chr10:95037104:G:A	7	7	14	0	14	2	0	2
chr10:95058349:T:A	0	0	0	0	0	0	0	0
chr10:95067393:C:T	0	0	0	0	0	0	0	0
chr10:95687616:A:T	41	17	58	24	34	1	1	0
chr10:96373726:G:A	0	0	0	0	0	0	0	0
chr10:96413242:C:T	2	1	3	1	2	1.5	0.5	1.0
chr10:96626801:G:A	158	71	246	94	152	1.0	1.0	0.0
chr10:97452116:G:C	78	35	113	43	70	1.0	1.0	0.0
chr10:97744873:G:T	62	30	95	33	62	1.5	1.0	0.0
chr10:97750311:G:T	2	0	2	2	0	1.0	1.0	0.0
chr10:97865562:C:T	0	0	0	0	0	0	0	0
chr10:97895891:G:T	0	0	0	0	0	0	0	0
chr10:98209811:A:G	24	14	42	12	30	2.0	0.0	2.0
chr10:98257696:T:G	0	0	0	0	0	0	0	0
chr10:98259087:G:A	0	0	0	0	0	0	0	0
chr10:98261123:C:T	0	0	0	0	0	0	0	0
chr10:99533278:C:A	0	0	0	0	0	0	0	0
chr10:99535179:C:T	0	0	0	0	0	0	0	0
chr10:99732484:G:A	111	53	171	61	110	1	1	0
chr10:99804058:G:A	1	1	2	0	2	2	0	2
chr10:99830729:G:A	1	0	1	1	0	1	1	0
chr10:99836239:T:A	0	0	0	0	0	0	0	0
chr10:99843765:T:C	0	0	0	0	0	0	0	0
chr10:99847104:G:T	0	0	0	0	0	0	0	0
chr10:99850776:C:T	1	1	2	0	2	2	0	2
chr10:99851537:G:A	3	1	4	2	2	1	1	0
chr10:99880039:G:A	33	18	52	16	36	2	0	2
chr10:99885741:T:C	32	21	54	12	42	2.0	0.0	2.0
chr10:99929621:G:C	15	7	24	8	16	1	1	0
chr10:99930622:A:G	24	14	42	10	32	2.0	0.0	2.0
chr10:99956142:G:A	97	52	157	49	108	2	0	2
chr10:100329906:C:T	0	0	0	0	0	0	0	0
chr10:100347494:C:G	1	1	2	0	2	2	0	2
chr10:100356554:A:C	0	0	0	0	0	0	0	0
chr10:100913306:G:T	163	81	265	93	172	2	1	0
chr10:100979009:T:C	12	6	20	6	14	1.5	0.5	1.0
chr10:100984574:A:T	1	0	1	1	0	1	1	0
chr10:100984619:T:C	2	1	3	1	2	1.5	0.5	1.0
chr10:100986474:C:T	1283	722	2366	777	1589	2	1	2
chr10:101002499:C:T	21	16	37	5	32	2	0	2
chr10:101228588:G:A	0	0	0	0	0	0	0	0
chr10:101526143:C:T	73	36	111	37	74	1	1	0
chr10:101579385:G:A	104	54	158	50	108	2.0	0.0	2.0
chr10:101580387:A:G	52	29	80	23	57	2.0	0.0	2.0
chr10:101580422:A:G	0	0	0	0	0	0	0	0
chr10:101584832:T:G	32	15	47	17	30	1.0	1.0	0.0
chr10:102399939:G:A	3	1	4	2	2	1	1	0
chr10:102404731:G:A	0	0	0	0	0	0	0	0
chr10:102470680:C:G	8	5	15	3	12	2.0	0.0	2.0
chr10:102483129:G:A	7	4	11	3	8	2	0	2
chr10:102484126:C:T	4	2	6	2	4	1.5	0.5	1.0
chr10:102644578:A:T	36	22	60	14	46	2.0	0.0	2.0
chr10:103445545:A:C	47	25	74	22	52	2	0	2
chr10:103447117:T:C	57	33	95	25	70	2	0	2
chr10:103602347:G:A	96	53	149	43	106	2.0	0.0	2.0
chr10:103603532:T:C	9	2	11	7	4	1	1	0
chr10:104002833:G:A	80	43	128	40	88	2.0	0.0	2.0
chr10:104003214:T:C	73	36	111	39	72	2	1	0
chr10:104032171:C:G	1	1	2	0	2	2	0	2
chr10:104039114:T:C	2	1	3	1	2	1.5	0.5	1.0
chr10:104039458:G:T	0	0	0	0	0	0	0	0
chr10:104060198:G:A	0	0	0	0	0	0	0	0
chr10:104064575:G:A	0	0	0	0	0	0	0	0
chr10:104167702:C:T	0	0	0	0	0	0	0	0
chr10:105147682:C:T	0	0	0	0	0	0	0	0
chr10:106620345:A:G	0	0	0	0	0	0	0	0
chr10:109870973:G:C	2	1	3	1	2	1.5	0.5	1.0
chr10:112153464:T:C	4	2	6	2	4	1.5	0.5	1.0
chr10:112157327:T:A	1	0	1	1	0	1	1	0
chr10:112160707:G:A	1	0	1	1	0	1	1	0
chr10:112175621:T:C	29	12	43	19	24	1	1	0
chr10:112180571:T:C	33	15	50	20	30	2	1	0
chr10:112440597:G:A	76	34	113	43	70	1.0	1.0	0.0
chr10:113581994:G:A	0	0	0	0	0	0	0	0
chr10:113582087:G:A	0	0	0	0	0	0	0	0
chr10:113612397:G:A	0	0	0	0	0	0	0	0
chr10:113679771:G:C	0	0	0	0	0	0	0	0
chr10:113729393:C:G	41	14	55	27	28	1	1	0
chr10:113729408:G:A	42	14	56	28	28	1.0	1.0	0.0
chr10:113755361:G:A	0	0	0	0	0	0	0	0
chr10:113780652:T:C	0	0	0	0	0	0	0	0
chr10:114313937:C:T	0	0	0	0	0	0	0	0
chr10:114314042:T:C	0	0	0	0	0	0	0	0
chr10:115727253:G:T	0	0	0	0	0	0	0	0
chr10:116089842:T:C	0	0	0	0	0	0	0	0
chr10:116125439:G:A	0	0	0	0	0	0	0	0
chr10:116604130:T:C	0	0	0	0	0	0	0	0
chr10:116627771:A:G	0	0	0	0	0	0	0	0
chr10:116645109:A:G	0	0	0	0	0	0	0	0
chr10:119123533:A:G	42	27	74	16	58	2.0	0.0	2.0
chr10:119136515:G:A	45	16	62	30	32	1	1	0
chr10:119161076:T:C	153	90	251	65	186	2	0	2
chr10:119669882:G:A	18	11	29	7	22	2.0	0.0	2.0
chr10:119676850:A:G	67	39	112	28	84	2	0	2
chr10:119792069:A:C	229	100	367	151	216	1	1	0
chr10:119827315:A:G	87	41	136	48	88	1	1	0
chr10:119827370:A:G	67	36	106	34	72	2	0	2
chr10:119843220:C:T	19	10	29	9	20	2	0	2
chr10:119912139:T:C	14	4	19	11	8	1.0	1.0	0.0
chr10:119919501:A:G	36	13	52	24	28	1.0	1.0	0.0
chr10:119926047:G:A	29	9	39	21	18	1	1	0
chr10:120905947:C:G	43	28	72	16	56	2	0	2
chr10:121743672:T:C	27	15	43	13	30	2	0	2
chr10:121790176:T:G	26	10	38	16	22	1.0	1.0	0.0
chr10:121913824:T:C	319	196	547	139	408	2	0	2
chr10:122050545:G:A	0	0	0	0	0	0	0	0
chr10:122050600:C:T	0	0	0	0	0	0	0	0
chr10:122143618:G:A	0	0	0	0	0	0	0	0
chr10:122211015:T:C	0	0	0	0	0	0	0	0
chr10:122211054:C:T	0	0	0	0	0	0	0	0
chr10:122211207:T:A	0	0	0	0	0	0	0	0
chr10:122237455:G:A	0	0	0	0	0	0	0	0
chr10:122237461:G:A	0	0	0	0	0	0	0	0
chr10:122429681:A:G	18	15	34	4	30	2.0	0.0	2.0
chr10:122454839:C:T	0	0	0	0	0	0	0	0
chr10:122454932:G:T	0	0	0	0	0	0	0	0
chr10:122592438:G:A	0	0	0	0	0	0	0	0
chr10:122598982:T:G	0	0	0	0	0	0	0	0
chr10:122621353:CAC:AGT	0	0	0	0	0	0	0	0
chr10:122850511:G:A	89	0	96	96	0	1	1	0
chr10:123762017:G:A	0	0	0	0	0	0	0	0
chr10:123762074:G:A	0	0	0	0	0	0	0	0
chr10:123768491:A:G	0	0	0	0	0	0	0	0
chr10:123768532:G:A	0	0	0	0	0	0	0	0
chr10:123768553:G:A	0	0	0	0	0	0	0	0
chr10:123842459:G:A	0	0	0	0	0	0	0	0
chr10:125027123:C:T	0	0	0	0	0	0	0	0
chr10:125795004:G:A	6	2	8	4	4	1.0	1.0	0.0
chr10:125841756:T:C	21	10	31	11	20	1	1	0
chr10:125896581:C:A	4	0	4	4	0	1.0	1.0	0.0
chr10:125896610:G:C	4	0	4	4	0	1.0	1.0	0.0
chr10:126425756:G:A	0	0	0	0	0	0	0	0
chr10:128047746:G:A	29	13	44	16	28	1	1	0
chr10:128070969:A:G	6	2	8	4	4	1.0	1.0	0.0
chr10:128102594:C:T	1	1	2	0	2	2	0	2
chr10:128102802:C:A	2	0	3	3	0	1.5	1.5	0.0
chr10:128103129:T:C	1	0	2	2	0	2	2	0
chr10:128103237:G:C	1	1	4	0	4	4	0	4
chr10:128103458:GGCAC:AGCAT	1	0	2	2	0	2	2	0
chr10:128103483:C:T	1	1	4	0	4	4	0	4
chr10:128103561:T:C	1	0	2	2	0	2	2	0
chr10:128103682:T:G	0	0	0	0	0	0	0	0
chr10:128103894:C:T	0	0	0	0	0	0	0	0
chr10:128104104:T:A	1	1	2	0	2	2	0	2
chr10:128105201:A:G	1	1	3	1	2	3	1	2
chr10:128106213:C:T	0	0	0	0	0	0	0	0
chr10:128107632:T:A	0	0	0	0	0	0	0	0
chr10:128108204:C:T	0	0	0	0	0	0	0	0
chr10:128108716:C:T	0	0	0	0	0	0	0	0
chr10:128109280:G:C	1	1	2	0	2	2	0	2
chr10:128113592:C:G	0	0	0	0	0	0	0	0
chr10:128115696:A:T	1	1	2	0	2	2	0	2
chr10:130136483:G:C	628	363	1148	344	804	2.0	0.0	2.0
chr10:130160886:C:T	622	365	1146	342	804	2.0	0.0	2.0
chr10:131973082:T:C	320	165	531	182	349	2.0	1.0	2.0
chr10:132104916:G:A	0	0	0	0	0	0	0	0
chr10:132149995:C:T	0	0	0	0	0	0	0	0
chr10:132168178:G:A	0	0	0	0	0	0	0	0
chr10:132203884:C:G	0	0	0	0	0	0	0	0
chr10:132324273:A:G	53	43	103	11	92	2	0	2
chr10:132331632:ACC:GCG	211	31	266	204	62	1	1	0
chr10:132331649:G:A	210	31	265	203	62	1.0	1.0	0.0
chr10:132331662:T:C	215	35	274	204	70	1	1	0
chr10:132331789:G:T	213	36	273	201	72	1	1	0
chr10:132333668:G:A	59	13	74	48	26	1	1	0
chr10:132337627:G:T	49	34	87	15	72	2	0	2
chr10:132405862:G:A	23	8	32	16	16	1	1	0
chr10:133088810:A:G	0	0	0	0	0	0	0	0
chr10:133088892:CGC:GGT	0	0	0	0	0	0	0	0
chr10:133128662:A:G	0	0	0	0	0	0	0	0
chr10:133128836:C:T	0	0	0	0	0	0	0	0
chr10:133129581:G:A	0	0	0	0	0	0	0	0
chr10:133183976:C:T	0	0	0	0	0	0	0	0
chr10:133186644:T:C	0	0	0	0	0	0	0	0
chr10:133186655:A:G	0	0	0	0	0	0	0	0
chr10:133199148:T:C	0	0	0	0	0	0	0	0
chr10:133218872:A:G	0	0	0	0	0	0	0	0
chr10:133238058:A:G	0	0	0	0	0	0	0	0
chr10:133391446:C:G	108	69	192	44	148	2.0	0.0	2.0
chr10:133528431:C:T	0	0	0	0	0	0	0	0
chr10:133555236:C:T	0	0	0	0	0	0	0	0
chr10:133557962:T:C	1	1	2	0	2	2	0	2
chr10:133558073:G:A	1	0	1	1	0	1	1	0
chr11:214421:G:C	197	107	318	97	221	2	0	2
chr11:233067:C:T	51	36	87	15	72	2	0	2
chr11:233212:C:A	52	37	89	15	74	2.0	0.0	2.0
chr11:237087:A:G	1000	591	1851	563	1288	2.0	1.0	2.0
chr11:280221:A:C	2	1	3	1	2	1.5	0.5	1.0
chr11:280816:AT:TC	2	2	4	0	4	2.0	0.0	2.0
chr11:284257:G:A	9	2	11	7	4	1	1	0
chr11:308178:TCA:CCG	1686	1311	4363	798	3565	2.0	0.0	2.0
chr11:308290:T:C	2300	1840	7610	1518	6092	2.0	0.0	2.0
chr11:308314:T:C	2320	1860	7774	1560	6214	2.0	0.0	2.0
chr11:308363:G:C	2372	1917	8112	1604	6508	2.0	0.0	2.0
chr11:308426:G:C	2414	1933	8312	1730	6582	2.0	0.0	2.0
chr11:309127:A:G	2467	1972	8707	1858	6849	2	0	2
chr11:372157:C:T	0	0	0	0	0	0	0	0
chr11:372700:G:C	0	0	0	0	0	0	0	0
chr11:392634:T:C	0	0	0	0	0	0	0	0
chr11:397063:C:A	2	0	2	2	0	1.0	1.0	0.0
chr11:403764:C:T	2	1	3	1	2	1.5	0.5	1.0
chr11:404468:G:A	0	0	0	0	0	0	0	0
chr11:406954:G:A	417	292	765	144	621	2	0	2
chr11:409815:G:A	1	0	1	1	0	1	1	0
chr11:429659:C:T	6	4	10	2	8	2.0	0.0	2.0
chr11:490036:G:A	41	25	66	16	50	2	0	2
chr11:500725:G:A	16	3	20	14	6	1.0	1.0	0.0
chr11:554018:G:A	30	20	50	10	40	2.0	0.0	2.0
chr11:554166:C:G	32	10	42	22	20	1.0	1.0	0.0
chr11:557584:G:A	30	13	43	17	26	1.0	1.0	0.0
chr11:557989:C:T	28	16	44	12	32	2.0	0.0	2.0
chr11:558884:C:T	27	15	42	12	30	2	0	2
chr11:559016:C:T	4	2	6	2	4	1.5	0.5	1.0
chr11:559089:C:T	3	1	4	2	2	1	1	0
chr11:587425:C:A	64	38	102	26	76	2.0	0.0	2.0
chr11:606656:G:C	5	4	9	1	8	2	0	2
chr11:609068:G:A	3	2	5	1	4	2	0	2
chr11:609353:G:A	9	6	15	3	12	2	0	2
chr11:610277:T:C	21	15	36	6	30	2	0	2
chr11:611919:C:G	58	32	91	27	64	2.0	0.0	2.0
chr11:613165:G:C	134	82	223	53	170	2.0	0.0	2.0
chr11:613208:T:C	1593	906	3315	1129	2186	2	1	2
chr11:613297:T:G	1519	839	3094	1098	1996	2	1	2
chr11:614318:T:C	936	506	1693	587	1106	2.0	1.0	2.0
chr11:614864:C:T	1151	607	2153	781	1372	2	1	2
chr11:615010:GA:TT	101	59	164	44	120	2	0	2
chr11:617378:C:T	0	0	0	0	0	0	0	0
chr11:617420:A:G	0	0	0	0	0	0	0	0
chr11:617519:A:G	0	0	0	0	0	0	0	0
chr11:618013:C:T	1	0	1	1	0	1	1	0
chr11:621634:G:A	2	0	2	2	0	1.0	1.0	0.0
chr11:653968:T:C	75	41	118	34	84	2	0	2
chr11:654043:G:A	72	31	104	42	62	1.0	1.0	0.0
chr11:674499:G:A	21	7	28	14	14	1	1	0
chr11:700025:A:G	13	7	20	6	14	2	0	2
chr11:704583:A:G	0	0	0	0	0	0	0	0
chr11:709401:A:G	5	5	10	0	10	2	0	2
chr11:709680:T:C	1	1	2	0	2	2	0	2
chr11:720197:C:T	5	0	5	5	0	1	1	0
chr11:797659:C:T	20	10	30	10	20	1.5	0.5	1.0
chr11:862439:C:T	2	1	3	1	2	1.5	0.5	1.0
chr11:862505:T:C	2	1	3	1	2	1.5	0.5	1.0
chr11:985547:C:T	41	11	52	30	22	1	1	0
chr11:1008161:C:T	3	0	3	3	0	1	1	0
chr11:1009890:T:C	7	2	9	5	4	1	1	0
chr11:1010649:C:T	153	107	265	49	216	2	0	2
chr11:1010694:C:T	154	45	205	111	94	1.0	1.0	0.0
chr11:1026048:G:A	0	0	0	0	0	0	0	0
chr11:1027811:C:T	0	0	0	0	0	0	0	0
chr11:1051715:T:C	0	0	0	0	0	0	0	0
chr11:1054434:T:C	0	0	0	0	0	0	0	0
chr11:1095032:C:T	0	0	0	0	0	0	0	0
chr11:1107741:T:C	0	0	0	0	0	0	0	0
chr11:1167980:C:T	0	0	0	0	0	0	0	0
chr11:1196002:T:C	0	0	0	0	0	0	0	0
chr11:1197926:GC:AA	0	0	0	0	0	0	0	0
chr11:1242953:G:A	0	0	0	0	0	0	0	0
chr11:1243660:A:G	0	0	0	0	0	0	0	0
chr11:1247985:C:T	0	0	0	0	0	0	0	0
chr11:1835812:G:T	0	0	0	0	0	0	0	0
chr11:1835882:C:A	0	0	0	0	0	0	0	0
chr11:1836517:TCTGC:CCTGG	0	0	0	0	0	0	0	0
chr11:1836700:G:A	0	0	0	0	0	0	0	0
chr11:1837032:C:T	0	0	0	0	0	0	0	0
chr11:1837342:C:T	0	0	0	0	0	0	0	0
chr11:1840358:C:T	84	25	116	62	54	1.0	1.0	0.0
chr11:2167008:C:T	0	0	0	0	0	0	0	0
chr11:2411436:C:T	0	0	0	0	0	0	0	0
chr11:2411734:T:C	0	0	0	0	0	0	0	0
chr11:2414726:C:T	0	0	0	0	0	0	0	0
chr11:2417733:C:A	0	0	0	0	0	0	0	0
chr11:2418537:T:C	0	0	0	0	0	0	0	0
chr11:2661922:T:G	1	1	1	0	1	1	0	1
chr11:2662127:A:G	1	1	2	0	2	2	0	2
chr11:2847958:C:T	0	0	0	0	0	0	0	0
chr11:2902537:A:G	6	4	10	2	8	2.0	0.0	2.0
chr11:2902595:GA:GG	7	0	8	8	0	1	1	0
chr11:2903361:G:A	39	16	55	23	32	1	1	0
chr11:2922441:G:C	50	24	74	26	48	1.0	1.0	0.0
chr11:2958568:G:T	16	6	24	10	14	1.0	1.0	0.0
chr11:3006910:G:A	92	45	145	47	98	1.0	1.0	0.0
chr11:3007040:A:G	8	5	13	3	10	2.0	0.0	2.0
chr11:3028980:A:G	18	10	29	9	20	2.0	0.5	2.0
chr11:3228023:G:A	0	0	0	0	0	0	0	0
chr11:3413899:A:G	0	0	0	0	0	0	0	0
chr11:3413910:G:A	0	0	0	0	0	0	0	0
chr11:3659821:C:G	0	0	0	0	0	0	0	0
chr11:3659885:A:G	0	0	0	0	0	0	0	0
chr11:3666396:T:G	8	6	14	2	12	2.0	0.0	2.0
chr11:3666421:C:T	7	5	12	2	10	2	0	2
chr11:3808189:G:C	0	0	0	0	0	0	0	0
chr11:4082294:A:G	62	29	95	35	60	1.0	1.0	0.0
chr11:4368357:G:C	0	0	0	0	0	0	0	0
chr11:4489055:A:G	0	0	0	0	0	0	0	0
chr11:4489357:C:T	0	0	0	0	0	0	0	0
chr11:4545955:T:C	0	0	0	0	0	0	0	0
chr11:4573315:A:G	0	0	0	0	0	0	0	0
chr11:4587012:T:C	0	0	0	0	0	0	0	0
chr11:4594004:A:G	0	0	0	0	0	0	0	0
chr11:4594278:C:G	0	0	0	0	0	0	0	0
chr11:4600409:C:T	14	4	18	10	8	1.0	1.0	0.0
chr11:4602085:C:T	0	0	0	0	0	0	0	0
chr11:4653345:G:A	0	0	0	0	0	0	0	0
chr11:4769180:A:G	0	0	0	0	0	0	0	0
chr11:4769241:GAGT:AAGC	0	0	0	0	0	0	0	0
chr11:4769441:C:T	0	0	0	0	0	0	0	0
chr11:4803780:T:A	0	0	0	0	0	0	0	0
chr11:4803995:A:G	0	0	0	0	0	0	0	0
chr11:4848419:G:A	0	0	0	0	0	0	0	0
chr11:4848676:A:C	0	0	0	0	0	0	0	0
chr11:4848909:G:A	0	0	0	0	0	0	0	0
chr11:4849031:G:C	0	0	0	0	0	0	0	0
chr11:4849068:T:G	0	0	0	0	0	0	0	0
chr11:4923966:T:G	0	0	0	0	0	0	0	0
chr11:4924003:CCAT:TCAC	0	0	0	0	0	0	0	0
chr11:4999279:C:T	0	0	0	0	0	0	0	0
chr11:4999569:C:T	0	0	0	0	0	0	0	0
chr11:4999602:C:T	0	0	0	0	0	0	0	0
chr11:4999825:C:G	0	0	0	0	0	0	0	0
chr11:5046754:A:G	0	0	0	0	0	0	0	0
chr11:5046907:G:A	0	0	0	0	0	0	0	0
chr11:5046947:A:T	0	0	0	0	0	0	0	0
chr11:5059004:T:C	0	0	0	0	0	0	0	0
chr11:5059129:G:A	0	0	0	0	0	0	0	0
chr11:5070102:C:T	0	0	0	0	0	0	0	0
chr11:5131690:G:A	0	0	0	0	0	0	0	0
chr11:5132031:A:G	0	0	0	0	0	0	0	0
chr11:5301290:G:A	2	2	4	0	4	2.0	0.0	2.0
chr11:5301841:C:T	2	1	3	1	2	1.5	0.5	1.0
chr11:5323898:G:A	0	0	0	0	0	0	0	0
chr11:5389784:T:C	0	0	0	0	0	0	0	0
chr11:5453940:G:C	0	0	0	0	0	0	0	0
chr11:5509588:G:T	0	0	0	0	0	0	0	0
chr11:5515185:C:T	4	3	7	1	6	2.0	0.0	2.0
chr11:5515618:G:A	0	0	0	0	0	0	0	0
chr11:5515622:A:G	0	0	0	0	0	0	0	0
chr11:5515815:T:G	1	0	1	1	0	1	1	0
chr11:5515931:A:G	1	0	1	1	0	1	1	0
chr11:5581045:A:G	1	0	1	1	0	1	1	0
chr11:5581208:T:A	1	0	1	1	0	1	1	0
chr11:5604617:A:G	0	0	0	0	0	0	0	0
chr11:5679771:C:T	262	140	426	134	292	2.0	0.0	2.0
chr11:5680179:G:C	256	129	404	138	266	2.0	1.0	2.0
chr11:5696532:T:C	1895	1105	4288	1460	2828	2	1	2
chr11:5697287:G:A	1278	701	2486	858	1628	2.0	1.0	2.0
chr11:5698520:G:C	1000	558	1856	620	1236	2.0	1.0	2.0
chr11:5736832:T:C	13	6	19	7	12	1	1	0
chr11:5737167:G:A	15	9	24	6	18	2	0	2
chr11:5820626:C:T	0	0	0	0	0	0	0	0
chr11:5856749:T:A	0	0	0	0	0	0	0	0
chr11:5884818:G:A	0	0	0	0	0	0	0	0
chr11:5900992:T:C	0	0	0	0	0	0	0	0
chr11:5901270:T:C	0	0	0	0	0	0	0	0
chr11:5947498:T:C	0	0	0	0	0	0	0	0
chr11:5986042:G:A	0	0	0	0	0	0	0	0
chr11:5986166:C:T	0	0	0	0	0	0	0	0
chr11:5986383:G:T	0	0	0	0	0	0	0	0
chr11:5986820:A:G	0	0	0	0	0	0	0	0
chr11:6026826:T:C	0	0	0	0	0	0	0	0
chr11:6199146:G:C	0	0	0	0	0	0	0	0
chr11:6210501:C:T	0	0	0	0	0	0	0	0
chr11:6218114:G:A	7	2	10	6	4	1	1	0
chr11:6222574:A:G	6	4	10	2	8	2.0	0.0	2.0
chr11:6241485:G:A	0	0	0	0	0	0	0	0
chr11:6270835:C:A	0	0	0	0	0	0	0	0
chr11:6319295:A:T	0	0	0	0	0	0	0	0
chr11:6319476:A:G	0	0	0	0	0	0	0	0
chr11:6320518:C:T	0	0	0	0	0	0	0	0
chr11:6394233:G:A	33	19	53	15	38	2	0	2
chr11:6440857:G:A	0	0	0	0	0	0	0	0
chr11:6479480:A:G	5	1	6	4	2	1	1	0
chr11:6481406:G:C	6	1	7	5	2	1.0	1.0	0.0
chr11:6481497:C:G	163	74	249	94	155	1	1	0
chr11:6481550:C:A	621	301	1055	393	662	2	1	0
chr11:6502842:A:C	12	5	17	7	10	1.0	1.0	0.0
chr11:6508876:A:G	8	3	12	6	6	1.5	1.0	0.0
chr11:6509048:C:T	12	6	17	6	11	1.0	0.5	0.5
chr11:6511289:C:T	4	0	4	4	0	1.0	1.0	0.0
chr11:6519995:C:G	14	8	24	6	18	2.0	0.0	2.0
chr11:6528549:A:C	5	5	12	0	12	2	0	2
chr11:6529079:G:A	11	7	20	4	16	2	0	2
chr11:6533711:C:A	7	3	11	5	6	2	1	0
chr11:6540040:A:G	4	2	6	2	4	1.5	0.5	1.0
chr11:6545866:C:T	6	2	8	4	4	1.0	1.0	0.0
chr11:6546983:T:C	3	2	5	1	4	2	0	2
chr11:6548666:G:A	15	6	21	9	12	1	1	0
chr11:6556774:G:A	4	3	7	1	6	2.0	0.0	2.0
chr11:6558124:G:C	4	2	6	2	4	1.5	0.5	1.0
chr11:6559265:G:A	5	3	8	2	6	2	0	2
chr11:6608652:G:A	8	3	11	5	6	1.0	1.0	0.0
chr11:6641235:C:T	0	0	0	0	0	0	0	0
chr11:6768698:C:A	0	0	0	0	0	0	0	0
chr11:6768797:C:G	0	0	0	0	0	0	0	0
chr11:6785265:T:C	0	0	0	0	0	0	0	0
chr11:6785596:G:T	0	0	0	0	0	0	0	0
chr11:6795547:A:G	0	0	0	0	0	0	0	0
chr11:6869708:C:T	0	0	0	0	0	0	0	0
chr11:6869715:A:G	0	0	0	0	0	0	0	0
chr11:6869882:A:G	0	0	0	0	0	0	0	0
chr11:6870154:G:A	0	0	0	0	0	0	0	0
chr11:6870297:C:G	0	0	0	0	0	0	0	0
chr11:6870374:A:G	0	0	0	0	0	0	0	0
chr11:6870527:A:C	0	0	0	0	0	0	0	0
chr11:6877527:A:C	0	0	0	0	0	0	0	0
chr11:6892059:A:G	0	0	0	0	0	0	0	0
chr11:7000807:A:G	0	0	0	0	0	0	0	0
chr11:7001129:A:C	0	0	0	0	0	0	0	0
chr11:7001300:A:T	0	0	0	0	0	0	0	0
chr11:7057807:G:A	0	0	0	0	0	0	0	0
chr11:7597722:G:A	5	1	6	4	2	1	1	0
chr11:7665353:A:T	12	12	24	0	24	2.0	0.0	2.0
chr11:7665579:C:G	1	1	2	0	2	2	0	2
chr11:7665627:C:G	1	0	1	1	0	1	1	0
chr11:7666632:C:A	0	0	0	0	0	0	0	0
chr11:7928477:A:G	0	0	0	0	0	0	0	0
chr11:7939583:C:T	0	0	0	0	0	0	0	0
chr11:7960547:G:A	0	0	0	0	0	0	0	0
chr11:8094152:T:C	3	3	6	0	6	2	0	2
chr11:8128336:G:A	0	0	0	0	0	0	0	0
chr11:8625123:T:G	1	0	1	1	0	1	1	0
chr11:8625216:G:C	1	0	1	1	0	1	1	0
chr11:8640969:T:C	3	2	5	1	4	2	0	2
chr11:8911517:G:A	156	82	253	75	178	2.0	0.0	2.0
chr11:8937605:G:A	0	0	0	0	0	0	0	0
chr11:8937964:T:G	0	0	0	0	0	0	0	0
chr11:9203939:C:G	6	5	11	1	10	2.0	0.0	2.0
chr11:9780378:T:G	20	4	25	17	8	1.0	1.0	0.0
chr11:10482209:G:A	4	1	5	3	2	1.0	1.0	0.0
chr11:10500217:T:C	2	1	3	1	2	1.5	0.5	1.0
chr11:10534042:A:G	230	120	365	115	250	2.0	0.0	2.0
chr11:10593710:G:T	0	0	0	0	0	0	0	0
chr11:10626155:G:A	0	0	0	0	0	0	0	0
chr11:10628820:G:A	0	0	0	0	0	0	0	0
chr11:11964514:T:C	0	0	0	0	0	0	0	0
chr11:12224657:G:A	0	0	0	0	0	0	0	0
chr11:12224686:G:C	0	0	0	0	0	0	0	0
chr11:12243995:A:G	0	0	0	0	0	0	0	0
chr11:12293639:G:A	0	0	0	0	0	0	0	0
chr11:12294301:C:T	0	0	0	0	0	0	0	0
chr11:12294368:A:G	0	0	0	0	0	0	0	0
chr11:12881896:C:T	0	0	0	0	0	0	0	0
chr11:13378504:T:A	5	3	8	2	6	2	0	2
chr11:13419579:A:G	141	68	220	77	143	1	1	0
chr11:13421703:C:T	147	74	237	79	158	2	1	2
chr11:13963036:C:T	0	0	0	0	0	0	0	0
chr11:14243370:A:G	0	0	0	0	0	0	0	0
chr11:14789216:A:G	0	0	0	0	0	0	0	0
chr11:14892029:G:A	63	29	93	35	58	1	1	0
chr11:15149140:G:A	0	0	0	0	0	0	0	0
chr11:15221501:G:A	0	0	0	0	0	0	0	0
chr11:15643910:C:G	0	0	0	0	0	0	0	0
chr11:17089725:A:G	19	12	37	7	30	2	0	2
chr11:17169472:A:G	162	83	251	83	168	2.0	0.0	2.0
chr11:17372097:A:G	0	0	0	0	0	0	0	0
chr11:17372526:C:G	0	0	0	0	0	0	0	0
chr11:17386857:C:T	10	4	14	6	8	1.0	1.0	0.0
chr11:17387083:C:T	9	4	13	5	8	1	1	0
chr11:17388025:T:C	3	1	4	2	2	1	1	0
chr11:17395957:A:G	0	0	0	0	0	0	0	0
chr11:17396823:C:A	0	0	0	0	0	0	0	0
chr11:17396930:C:A	3	3	6	0	6	2	0	2
chr11:17397732:C:T	3	3	6	0	6	2	0	2
chr11:17461491:C:T	0	0	0	0	0	0	0	0
chr11:17520892:T:C	0	0	0	0	0	0	0	0
chr11:17533383:T:C	0	0	0	0	0	0	0	0
chr11:17558503:A:C	0	0	0	0	0	0	0	0
chr11:17558628:A:T	0	0	0	0	0	0	0	0
chr11:17606066:G:C	0	0	0	0	0	0	0	0
chr11:17959500:C:T	177	98	287	81	206	2	0	2
chr11:18137446:T:C	0	0	0	0	0	0	0	0
chr11:18138121:TG:CA	0	0	0	0	0	0	0	0
chr11:18173280:C:G	2	0	2	2	0	1.0	1.0	0.0
chr11:18173331:T:G	2	0	2	2	0	1.0	1.0	0.0
chr11:18173417:A:G	2	0	2	2	0	1.0	1.0	0.0
chr11:18173801:C:T	2	0	2	2	0	1.0	1.0	0.0
chr11:18173901:C:T	2	2	4	0	4	2.0	0.0	2.0
chr11:18245414:T:C	2	1	3	1	2	1.5	0.5	1.0
chr11:18245480:C:T	2	1	3	1	2	1.5	0.5	1.0
chr11:18269774:T:C	3	1	4	2	2	1	1	0
chr11:18306137:G:T	53	28	83	25	58	2	0	2
chr11:18358082:C:A	0	0	0	0	0	0	0	0
chr11:18400979:G:A	670	369	1334	436	898	2.0	1.0	2.0
chr11:18707820:G:T	0	0	0	0	0	0	0	0
chr11:18713933:G:A	0	0	0	0	0	0	0	0
chr11:18714130:G:A	0	0	0	0	0	0	0	0
chr11:18714400:T:C	0	0	0	0	0	0	0	0
chr11:18715548:C:T	0	0	0	0	0	0	0	0
chr11:18716734:C:T	0	0	0	0	0	0	0	0
chr11:18721633:C:G	1	0	1	1	0	1	1	0
chr11:18729494:C:T	0	0	0	0	0	0	0	0
chr11:18742479:G:C	0	0	0	0	0	0	0	0
chr11:19056218:T:C	0	0	0	0	0	0	0	0
chr11:19186294:C:T	0	0	0	0	0	0	0	0
chr11:20044127:G:T	0	0	0	0	0	0	0	0
chr11:20077566:A:T	0	0	0	0	0	0	0	0
chr11:20077995:C:T	0	0	0	0	0	0	0	0
chr11:20083123:G:A	0	0	0	0	0	0	0	0
chr11:20090946:G:A	0	0	0	0	0	0	0	0
chr11:20103261:C:T	0	0	0	0	0	0	0	0
chr11:20601429:G:A	0	0	0	0	0	0	0	0
chr11:20601477:C:T	0	0	0	0	0	0	0	0
chr11:20607618:G:A	0	0	0	0	0	0	0	0
chr11:20626834:G:A	0	0	0	0	0	0	0	0
chr11:20652321:G:A	0	0	0	0	0	0	0	0
chr11:20783740:G:A	0	0	0	0	0	0	0	0
chr11:20783789:C:T	0	0	0	0	0	0	0	0
chr11:22193357:G:C	0	0	0	0	0	0	0	0
chr11:25078683:G:A	0	0	0	0	0	0	0	0
chr11:26563078:C:A	0	0	0	0	0	0	0	0
chr11:26683763:A:G	0	0	0	0	0	0	0	0
chr11:27055430:C:T	0	0	0	0	0	0	0	0
chr11:27340812:T:G	37	14	55	23	32	1	1	0
chr11:27367856:C:T	0	0	0	0	0	0	0	0
chr11:27658369:C:T	16	7	23	9	14	1.0	1.0	0.0
chr11:30011644:G:A	0	0	0	0	0	0	0	0
chr11:32389048:G:A	0	0	0	0	0	0	0	0
chr11:32396416:A:G	0	0	0	0	0	0	0	0
chr11:32933576:A:G	14	5	19	9	10	1.0	1.0	0.0
chr11:33085070:C:T	61	29	92	32	60	1	1	0
chr11:33286743:G:A	363	196	592	179	413	2	0	2
chr11:33542577:T:C	0	0	0	0	0	0	0	0
chr11:33668166:C:T	0	0	0	0	0	0	0	0
chr11:33859470:T:C	1	0	1	1	0	1	1	0
chr11:33864748:A:G	1	1	2	0	2	2	0	2
chr11:34438994:T:C	124	66	202	63	139	2.0	0.0	2.0
chr11:34461361:C:T	154	65	231	98	133	1.0	1.0	0.0
chr11:34916266:G:A	233	130	400	116	284	2	0	2
chr11:34916337:G:A	207	115	355	103	252	2	0	2
chr11:34916652:C:G	110	45	159	67	92	1.0	1.0	0.0
chr11:34916763:T:C	123	53	182	72	110	1	1	0
chr11:34970180:T:C	33	15	51	19	32	1	1	0
chr11:35180295:C:T	875	449	1605	595	1010	2	1	2
chr11:36574050:A:G	0	0	0	0	0	0	0	0
chr11:36648228:C:T	0	0	0	0	0	0	0	0
chr11:36659215:T:C	1	0	2	2	0	2	2	0
chr11:40115993:T:C	0	0	0	0	0	0	0	0
chr11:44058660:T:C	0	0	0	0	0	0	0	0
chr11:44077435:G:A	2	0	2	2	0	1.0	1.0	0.0
chr11:44083431:C:T	45	20	67	25	42	1	1	0
chr11:44309959:C:G	0	0	0	0	0	0	0	0
chr11:44938373:G:A	0	0	0	0	0	0	0	0
chr11:45224227:G:T	4	3	7	1	6	2.0	0.0	2.0
chr11:45225019:C:T	17	8	27	11	16	2	1	0
chr11:45650711:A:G	0	0	0	0	0	0	0	0
chr11:45810958:A:G	56	24	84	32	52	1.0	1.0	0.0
chr11:45856137:C:G	24	11	39	15	24	1.5	1.0	0.0
chr11:46310953:T:C	0	0	0	0	0	0	0	0
chr11:46428851:C:G	52	11	69	43	26	1.0	1.0	0.0
chr11:46783211:C:T	1	1	2	0	2	2	0	2
chr11:47281724:T:C	10	3	13	7	6	1.0	1.0	0.0
chr11:47358789:G:T	7	6	13	1	12	2	0	2
chr11:47438755:A:G	4	1	5	3	2	1.0	1.0	0.0
chr11:47447887:A:G	2	0	2	2	0	1.0	1.0	0.0
chr11:47448793:G:A	0	0	0	0	0	0	0	0
chr11:48978970:C:T	0	0	0	0	0	0	0	0
chr11:49037810:C:A	0	0	0	0	0	0	0	0
chr11:49054053:G:A	0	0	0	0	0	0	0	0
chr11:49174938:T:C	0	0	0	0	0	0	0	0
chr11:49175864:A:G	0	0	0	0	0	0	0	0
chr11:49185763:A:G	0	0	0	0	0	0	0	0
chr11:49200333:T:A	0	0	0	0	0	0	0	0
chr11:49872038:G:A	0	0	0	0	0	0	0	0
chr11:49953118:C:T	0	0	0	0	0	0	0	0
chr11:49981655:C:A	0	0	0	0	0	0	0	0
chr11:50033053:G:T	0	0	0	0	0	0	0	0
chr11:54603280:G:A	0	0	0	0	0	0	0	0
chr11:54603368:G:A	0	0	0	0	0	0	0	0
chr11:54603640:T:C	0	0	0	0	0	0	0	0
chr11:54706901:A:G	0	0	0	0	0	0	0	0
chr11:55344024:T:C	0	0	0	0	0	0	0	0
chr11:55344108:A:T	0	0	0	0	0	0	0	0
chr11:55491609:T:C	0	0	0	0	0	0	0	0
chr11:55554735:A:G	0	0	0	0	0	0	0	0
chr11:55554822:C:T	0	0	0	0	0	0	0	0
chr11:55555162:C:T	0	0	0	0	0	0	0	0
chr11:55665564:T:C	0	0	0	0	0	0	0	0
chr11:55795860:A:T	0	0	0	0	0	0	0	0
chr11:55820438:A:G	0	0	0	0	0	0	0	0
chr11:55886141:A:C	0	0	0	0	0	0	0	0
chr11:56122511:C:A	0	0	0	0	0	0	0	0
chr11:56160108:A:T	0	0	0	0	0	0	0	0
chr11:56232451:G:A	0	0	0	0	0	0	0	0
chr11:56291059:C:T	0	0	0	0	0	0	0	0
chr11:56376058:AGCAGTTCCTT:GGCTGCTCCCC	0	0	0	0	0	0	0	0
chr11:56376080:TTCCTAATG:ATCTTGGTT	0	0	0	0	0	0	0	0
chr11:56612658:C:G	0	0	0	0	0	0	0	0
chr11:56743147:A:G	0	0	0	0	0	0	0	0
chr11:56743218:T:C	0	0	0	0	0	0	0	0
chr11:57312629:C:T	0	0	0	0	0	0	0	0
chr11:57378729:G:A	0	0	0	0	0	0	0	0
chr11:57388965:A:G	0	0	0	0	0	0	0	0
chr11:57410120:A:G	13	5	18	8	10	1	1	0
chr11:57426180:A:G	16	5	21	11	10	1.0	1.0	0.0
chr11:57542834:A:G	3	2	5	1	4	2	0	2
chr11:57550167:C:T	20	8	29	13	16	1.0	1.0	0.0
chr11:57614516:G:A	1	1	2	0	2	2	0	2
chr11:57646914:A:G	1	0	1	1	0	1	1	0
chr11:57696028:T:C	27	14	41	13	28	2	0	2
chr11:57741967:C:G	248	134	405	121	284	2.0	0.0	2.0
chr11:58191303:C:T	0	0	0	0	0	0	0	0
chr11:58203723:G:A	0	0	0	0	0	0	0	0
chr11:58203729:G:A	0	0	0	0	0	0	0	0
chr11:58214757:A:G	0	0	0	0	0	0	0	0
chr11:58215722:A:G	0	0	0	0	0	0	0	0
chr11:58228612:G:A	0	0	0	0	0	0	0	0
chr11:58267071:C:T	0	0	0	0	0	0	0	0
chr11:58358832:A:T	0	0	0	0	0	0	0	0
chr11:58710566:T:C	0	0	0	0	0	0	0	0
chr11:58947812:C:T	6	1	7	5	2	1.0	1.0	0.0
chr11:59050152:A:G	7	4	11	3	8	2	0	2
chr11:59211467:C:T	15	4	20	12	8	1	1	0
chr11:59422647:A:G	0	0	0	0	0	0	0	0
chr11:59443288:C:G	0	0	0	0	0	0	0	0
chr11:59443948:C:T	0	0	0	0	0	0	0	0
chr11:59504164:T:C	0	0	0	0	0	0	0	0
chr11:59639387:C:T	25	8	34	18	16	1	1	0
chr11:60173126:T:A	49	18	77	39	38	1	1	0
chr11:60179779:C:T	36	22	66	18	48	2.0	0.0	2.0
chr11:60335034:G:T	0	0	0	0	0	0	0	0
chr11:60385090:T:A	5	0	5	5	0	1	1	0
chr11:60416718:G:A	0	0	0	0	0	0	0	0
chr11:60763791:A:G	0	0	0	0	0	0	0	0
chr11:60763873:T:G	0	0	0	0	0	0	0	0
chr11:60842499:A:G	46	29	83	21	62	2.0	0.0	2.0
chr11:60850361:C:A	45	25	75	23	52	2	0	2
chr11:60853219:C:A	1	0	1	1	0	1	1	0
chr11:60906396:T:C	80	41	131	45	86	2.0	1.0	2.0
chr11:60921973:T:C	202	92	310	118	192	1.0	1.0	0.0
chr11:60927829:C:A	0	0	0	0	0	0	0	0
chr11:60930582:G:A	0	0	0	0	0	0	0	0
chr11:60933478:C:G	8	4	12	4	8	1.5	0.5	1.0
chr11:60933519:A:G	8	4	12	4	8	1.5	0.5	1.0
chr11:60933664:C:G	7	3	10	4	6	1	1	0
chr11:60935788:A:G	0	0	0	0	0	0	0	0
chr11:60936741:C:T	1	1	2	0	2	2	0	2
chr11:61015636:C:T	1	0	1	1	0	1	1	0
chr11:61017462:A:G	0	0	0	0	0	0	0	0
chr11:61017566:A:G	0	0	0	0	0	0	0	0
chr11:61017791:A:G	18	7	25	11	14	1.0	1.0	0.0
chr11:61017880:A:G	18	9	27	9	18	1.5	0.5	1.0
chr11:61125763:C:T	58	36	100	24	76	2.0	0.0	2.0
chr11:61251383:A:G	1	0	1	1	0	1	1	0
chr11:61291395:T:C	5	3	9	3	6	2	0	2
chr11:61343874:C:G	89	48	139	41	98	2	0	2
chr11:61397808:G:A	306	125	461	203	258	1.0	1.0	0.0
chr11:61411813:G:A	37	22	59	15	44	2	0	2
chr11:61481911:C:A	4	3	7	1	6	2.0	0.0	2.0
chr11:61743661:G:A	0	0	0	0	0	0	0	0
chr11:62243391:C:T	0	0	0	0	0	0	0	0
chr11:62337969:T:C	1	1	3	1	2	3	1	2
chr11:62523404:G:A	89	44	136	48	88	2	1	0
chr11:62796537:T:C	137	63	207	77	130	1	1	0
chr11:62885307:C:T	809	465	1478	447	1031	2	0	2
chr11:63014806:C:T	0	0	0	0	0	0	0	0
chr11:63096046:A:G	0	0	0	0	0	0	0	0
chr11:63408121:C:T	0	0	0	0	0	0	0	0
chr11:63719914:T:C	1	1	2	0	2	2	0	2
chr11:64116555:C:T	1	0	1	1	0	1	1	0
chr11:64117815:C:T	1	1	2	0	2	2	0	2
chr11:64118232:C:T	2	0	2	2	0	1.0	1.0	0.0
chr11:64219867:C:T	4	1	5	3	2	1.0	1.0	0.0
chr11:64231768:G:C	80	39	122	44	78	2.0	1.0	0.0
chr11:64232057:C:T	28	16	44	12	32	2.0	0.0	2.0
chr11:64255798:C:T	8	4	13	5	8	2.0	0.5	1.0
chr11:64256499:G:A	8	4	14	4	10	1.5	0.5	1.0
chr11:64259167:G:A	5	2	7	3	4	1	1	0
chr11:64259213:C:T	5	3	8	2	6	2	0	2
chr11:64271703:G:A	843	443	1458	492	966	2	1	2
chr11:64340263:G:A	29	13	42	16	26	1	1	0
chr11:64341646:T:G	10	5	15	5	10	1.5	0.5	1.0
chr11:64343196:G:A	7	2	9	5	4	1	1	0
chr11:64343211:G:C	7	2	9	5	4	1	1	0
chr11:64357043:T:C	121	45	176	82	94	1	1	0
chr11:64360272:A:G	10	5	15	5	10	1.5	0.5	1.0
chr11:64371333:T:C	24	15	39	9	30	2.0	0.0	2.0
chr11:64591814:C:T	0	0	0	0	0	0	0	0
chr11:64592802:T:C	0	0	0	0	0	0	0	0
chr11:64600390:T:C	0	0	0	0	0	0	0	0
chr11:64600763:G:A	0	0	0	0	0	0	0	0
chr11:64648295:G:A	0	0	0	0	0	0	0	0
chr11:64651428:G:A	0	0	0	0	0	0	0	0
chr11:64829733:G:T	1	1	2	0	2	2	0	2
chr11:64830034:T:C	1	1	2	0	2	2	0	2
chr11:64834461:T:C	0	0	0	0	0	0	0	0
chr11:64855397:G:C	128	55	194	78	116	1.0	1.0	0.0
chr11:64878399:A:G	226	102	349	133	216	1.0	1.0	0.0
chr11:64895353:G:A	47	27	74	20	54	2	0	2
chr11:64895377:A:G	46	27	73	19	54	2.0	0.0	2.0
chr11:64897886:T:G	30	15	47	15	32	1.5	0.5	1.0
chr11:64911859:G:A	3	1	4	2	2	1	1	0
chr11:64911890:G:A	3	1	4	2	2	1	1	0
chr11:64934728:C:T	0	0	0	0	0	0	0	0
chr11:64990032:G:C	1	0	1	1	0	1	1	0
chr11:65046213:G:C	316	249	605	78	527	2.0	0.0	2.0
chr11:65109268:C:T	0	0	0	0	0	0	0	0
chr11:65130754:C:T	26	14	42	12	30	2.0	0.0	2.0
chr11:65170212:C:T	0	0	0	0	0	0	0	0
chr11:65183499:C:T	189	86	285	109	176	1	1	0
chr11:65209953:C:T	0	0	0	0	0	0	0	0
chr11:65214001:G:C	0	0	0	0	0	0	0	0
chr11:65214051:C:A	0	0	0	0	0	0	0	0
chr11:65214116:G:A	0	0	0	0	0	0	0	0
chr11:65214366:C:T	2	1	3	1	2	1.5	0.5	1.0
chr11:65214382:G:T	2	1	3	1	2	1.5	0.5	1.0
chr11:65379823:G:A	3	3	6	0	6	2	0	2
chr11:65393658:C:T	71	39	115	33	82	2	0	2
chr11:65396886:C:T	46	23	72	24	48	2.0	0.5	1.0
chr11:65535422:G:A	0	0	0	0	0	0	0	0
chr11:65570563:A:G	110	65	191	55	136	2.0	0.0	2.0
chr11:65617256:C:T	13	5	18	8	10	1	1	0
chr11:65618735:C:G	0	0	0	0	0	0	0	0
chr11:65625224:C:T	3	3	6	0	6	2	0	2
chr11:65641466:C:T	57	30	87	27	60	2	0	2
chr11:65659875:G:A	20	9	32	12	20	1.5	1.0	0.0
chr11:65713297:A:G	29	17	46	12	34	2	0	2
chr11:65779862:G:A	6	2	8	4	4	1.0	1.0	0.0
chr11:65779984:C:A	6	2	8	4	4	1.0	1.0	0.0
chr11:65834089:G:C	1	0	1	1	0	1	1	0
chr11:65855876:G:A	180	131	332	52	280	2.0	0.0	2.0
chr11:65856048:G:A	3733	2952	17931	5819	12112	4	1	2
chr11:65856268:A:G	34	28	64	6	58	2.0	0.0	2.0
chr11:65860863:G:A	38	21	59	17	42	2.0	0.0	2.0
chr11:65863696:C:T	29	15	45	15	30	2	0	2
chr11:65864408:CCG:ACA	1	0	1	1	0	1	1	0
chr11:65864502:G:A	33	18	54	16	38	2	0	2
chr11:65864791:G:T	35	22	60	14	46	2	0	2
chr11:65870513:C:G	0	0	0	0	0	0	0	0
chr11:65882513:T:C	9	6	22	4	18	2	0	2
chr11:65884359:A:G	23	15	39	9	30	2	0	2
chr11:65887922:G:C	11	3	15	9	6	1	1	0
chr11:66020195:G:A	2	2	4	0	4	2.0	0.0	2.0
chr11:66023056:G:T	0	0	0	0	0	0	0	0
chr11:66043737:G:T	0	0	0	0	0	0	0	0
chr11:66332516:C:T	3	0	3	3	0	1	1	0
chr11:66335336:G:A	0	0	0	0	0	0	0	0
chr11:66337522:C:T	816	424	1370	472	898	2.0	1.0	2.0
chr11:66341189:C:T	26	16	42	10	32	2.0	0.0	2.0
chr11:66341562:T:C	748	394	1257	409	848	2.0	1.0	2.0
chr11:66438698:C:T	904	458	1618	608	1010	2.0	1.0	2.0
chr11:66504671:A:G	44	21	67	25	42	1.5	1.0	0.0
chr11:66532044:A:G	3	2	5	1	4	2	0	2
chr11:66560202:G:A	0	0	0	0	0	0	0	0
chr11:66560624:C:T	0	0	0	0	0	0	0	0
chr11:66561248:T:C	0	0	0	0	0	0	0	0
chr11:66562261:A:G	0	0	0	0	0	0	0	0
chr11:66563987:A:G	165	110	282	60	222	2	0	2
chr11:66566127:C:T	126	81	211	47	164	2.0	0.0	2.0
chr11:66568077:A:G	112	74	188	40	148	2.0	0.0	2.0
chr11:66590655:C:T	0	0	0	0	0	0	0	0
chr11:66843174:G:C	546	269	912	331	581	2.0	1.0	0.0
chr11:66849260:G:C	2	0	2	2	0	1.0	1.0	0.0
chr11:66850319:G:A	0	0	0	0	0	0	0	0
chr11:66858763:T:C	1	1	2	0	2	2	0	2
chr11:67039968:G:A	0	0	0	0	0	0	0	0
chr11:67066781:C:T	243	119	395	135	260	2	1	0
chr11:67302343:C:T	305	154	474	161	313	2	1	2
chr11:67521123:C:T	0	0	0	0	0	0	0	0
chr11:67522571:C:T	0	0	0	0	0	0	0	0
chr11:67584785:C:A	34	20	54	14	40	2.0	0.0	2.0
chr11:67585218:A:G	2570	1749	8265	2636	5629	2.0	1.0	2.0
chr11:67586108:C:T	2556	1730	8195	2626	5569	2.0	1.0	2.0
chr11:67586373:C:T	41	13	55	29	26	1	1	0
chr11:67586499:T:C	2594	1761	8412	2676	5736	2.0	1.0	2.0
chr11:67607110:T:C	576	320	956	300	656	2.0	0.5	2.0
chr11:67628243:C:T	101	61	178	48	130	2	0	2
chr11:67634891:T:G	0	0	0	0	0	0	0	0
chr11:67796822:T:A	9	5	15	5	10	2	0	2
chr11:68262547:C:T	79	48	138	32	106	2	0	2
chr11:68590674:G:A	17	8	25	9	16	1	1	0
chr11:69295669:C:T	0	0	0	0	0	0	0	0
chr11:69295926:T:C	0	0	0	0	0	0	0	0
chr11:69296043:G:A	0	0	0	0	0	0	0	0
chr11:69296261:G:C	0	0	0	0	0	0	0	0
chr11:69296300:C:A	0	0	0	0	0	0	0	0
chr11:69667874:G:C	123	68	216	65	151	2	0	2
chr11:70087979:G:A	0	0	0	0	0	0	0	0
chr11:70161286:A:G	0	0	0	0	0	0	0	0
chr11:70187990:G:A	0	0	0	0	0	0	0	0
chr11:70407369:C:T	17	10	29	7	22	2	0	2
chr11:71435531:G:A	17	9	26	8	18	2	0	2
chr11:71444125:C:T	16	8	24	8	16	1.5	0.5	1.0
chr11:71458501:G:C	372	204	616	186	430	2.0	0.0	2.0
chr11:71458602:A:G	3	3	6	0	6	2	0	2
chr11:71527407:G:C	0	0	0	0	0	0	0	0
chr11:71793429:T:C	10	7	18	4	14	2.0	0.0	2.0
chr11:71795075:T:G	0	0	0	0	0	0	0	0
chr11:71796265:T:A	7	4	11	3	8	2	0	2
chr11:71800823:C:T	8	3	11	5	6	1.0	1.0	0.0
chr11:71816650:C:A	0	0	0	0	0	0	0	0
chr11:71816746:T:C	0	0	0	0	0	0	0	0
chr11:71816849:CG:TA	1	1	2	0	2	2	0	2
chr11:72230168:A:G	2	1	3	1	2	1.5	0.5	1.0
chr11:72230768:C:T	2	1	3	1	2	1.5	0.5	1.0
chr11:72685964:A:G	3	3	6	0	6	2	0	2
chr11:73234975:C:T	0	0	0	0	0	0	0	0
chr11:73235095:G:C	0	0	0	0	0	0	0	0
chr11:73787888:T:G	127	62	194	70	124	2	1	0
chr11:73864454:G:A	292	188	552	127	425	2.0	0.0	2.0
chr11:73864459:A:G	293	189	556	128	428	2	0	2
chr11:73959600:T:C	1	1	2	0	2	2	0	2
chr11:74004497:G:A	8	2	10	6	4	1.0	1.0	0.0
chr11:74006209:A:G	3	0	3	3	0	1	1	0
chr11:74085872:C:T	6	3	9	3	6	1.5	0.5	1.0
chr11:74095398:C:T	4	2	6	2	4	1.5	0.5	1.0
chr11:74098233:G:A	7	2	9	5	4	1	1	0
chr11:74114458:T:C	13	10	23	3	20	2	0	2
chr11:74253644:G:A	25	12	37	13	24	1	1	0
chr11:74267198:G:A	0	0	0	0	0	0	0	0
chr11:74277122:C:T	0	0	0	0	0	0	0	0
chr11:74311384:C:T	0	0	0	0	0	0	0	0
chr11:74336638:A:G	12	6	19	7	12	2.0	0.5	1.0
chr11:74338524:A:G	11	6	18	6	12	2	0	2
chr11:74342502:C:T	14	8	22	6	16	2.0	0.0	2.0
chr11:74398121:A:G	323	192	554	149	405	2	0	2
chr11:74457316:C:T	0	0	0	0	0	0	0	0
chr11:74492263:T:A	66	32	108	36	72	1.5	1.0	0.0
chr11:74496984:C:T	25	13	42	14	28	2	0	2
chr11:74497547:G:T	14	8	25	7	18	2.0	0.0	2.0
chr11:74708333:C:T	0	0	0	0	0	0	0	0
chr11:74718942:G:A	0	0	0	0	0	0	0	0
chr11:74835860:G:A	25	14	42	12	30	2	0	2
chr11:74843102:G:A	6	1	7	5	2	1.0	1.0	0.0
chr11:74949247:A:G	34	4	40	32	8	1.0	1.0	0.0
chr11:74994651:T:C	32	23	57	11	46	2.0	0.0	2.0
chr11:75089784:A:G	0	0	0	0	0	0	0	0
chr11:75283308:G:A	1	0	1	1	0	1	1	0
chr11:75284306:C:T	0	0	0	0	0	0	0	0
chr11:75566712:C:G	16	9	25	7	18	2.0	0.0	2.0
chr11:75566947:C:T	18	7	25	11	14	1.0	1.0	0.0
chr11:75568801:C:T	20	13	33	7	26	2.0	0.0	2.0
chr11:75571837:G:A	20	12	32	8	24	2.0	0.0	2.0
chr11:75717913:A:G	0	0	0	0	0	0	0	0
chr11:75719905:A:G	0	0	0	0	0	0	0	0
chr11:75731256:C:A	0	0	0	0	0	0	0	0
chr11:76544771:C:G	36	14	50	22	28	1.0	1.0	0.0
chr11:76546171:T:C	44	25	69	19	50	2.0	0.0	2.0
chr11:76796600:G:C	0	0	0	0	0	0	0	0
chr11:77190882:C:T	0	0	0	0	0	0	0	0
chr11:77190979:G:A	0	0	0	0	0	0	0	0
chr11:77199721:C:T	0	0	0	0	0	0	0	0
chr11:77201591:A:T	0	0	0	0	0	0	0	0
chr11:77205600:G:A	0	0	0	0	0	0	0	0
chr11:77206175:A:G	0	0	0	0	0	0	0	0
chr11:77207277:T:C	0	0	0	0	0	0	0	0
chr11:77208820:T:A	0	0	0	0	0	0	0	0
chr11:77211901:G:A	0	0	0	0	0	0	0	0
chr11:77211972:G:A	0	0	0	0	0	0	0	0
chr11:77701806:A:G	132	64	205	72	133	1.0	1.0	0.0
chr11:77872269:T:A	130	67	201	65	136	2.0	0.0	2.0
chr11:77872330:G:A	121	61	185	61	124	2	1	2
chr11:77924836:A:C	16	11	27	5	22	2.0	0.0	2.0
chr11:78112745:C:T	43	23	68	20	48	2	0	2
chr11:78200699:C:T	3	1	4	2	2	1	1	0
chr11:78209454:C:T	7	5	12	2	10	2	0	2
chr11:78574510:C:T	39	24	72	18	54	2	0	2
chr11:78658528:C:T	0	0	0	0	0	0	0	0
chr11:78661491:G:A	0	0	0	0	0	0	0	0
chr11:78732541:G:A	0	0	0	0	0	0	0	0
chr11:78771068:G:A	0	0	0	0	0	0	0	0
chr11:82689671:C:T	699	1	853	851	2	1	1	0
chr11:82932718:G:T	2	2	4	0	4	2.0	0.0	2.0
chr11:82933862:G:A	8	2	10	6	4	1.0	1.0	0.0
chr11:85745660:T:C	75	1	76	74	2	1	1	0
chr11:86412425:G:A	0	0	0	0	0	0	0	0
chr11:86422742:C:T	0	0	0	0	0	0	0	0
chr11:86450346:C:G	0	0	0	0	0	0	0	0
chr11:89178528:C:A	0	0	0	0	0	0	0	0
chr11:92840745:G:T	0	0	0	0	0	0	0	0
chr11:92886994:A:T	0	0	0	0	0	0	0	0
chr11:92890711:G:A	0	0	0	0	0	0	0	0
chr11:93667630:C:T	225	90	339	145	194	1	1	0
chr11:93729441:A:T	29	11	40	18	22	1	1	0
chr11:93784708:C:G	770	431	1344	422	922	2.0	0.0	2.0
chr11:93784720:G:C	768	430	1350	420	930	2.0	0.0	2.0
chr11:93801824:G:A	4	2	6	2	4	1.5	0.5	1.0
chr11:94179870:A:G	22	4	26	18	8	1.0	1.0	0.0
chr11:94180963:A:G	26	6	33	21	12	1.0	1.0	0.0
chr11:94492754:C:T	18	7	25	11	14	1.0	1.0	0.0
chr11:94498091:C:G	34	20	56	14	42	2.0	0.0	2.0
chr11:94587071:T:C	4	1	5	3	2	1.0	1.0	0.0
chr11:94593599:G:C	0	0	0	0	0	0	0	0
chr11:95025674:C:T	0	0	0	0	0	0	0	0
chr11:95067695:C:T	378	213	640	184	456	2.0	0.0	2.0
chr11:99819555:T:G	0	0	0	0	0	0	0	0
chr11:100356152:T:A	0	0	0	0	0	0	0	0
chr11:100356231:C:T	0	0	0	0	0	0	0	0
chr11:102702838:C:A	0	0	0	0	0	0	0	0
chr11:102713292:T:A	0	0	0	0	0	0	0	0
chr11:102724935:C:G	0	0	0	0	0	0	0	0
chr11:102779515:G:A	0	0	0	0	0	0	0	0
chr11:102779693:C:T	0	0	0	0	0	0	0	0
chr11:102790368:T:C	0	0	0	0	0	0	0	0
chr11:103156505:A:G	0	0	0	0	0	0	0	0
chr11:103253406:T:G	2	1	3	1	2	1.5	0.5	1.0
chr11:103282190:G:A	0	0	0	0	0	0	0	0
chr11:103287549:C:T	0	0	0	0	0	0	0	0
chr11:103455180:C:T	0	0	0	0	0	0	0	0
chr11:103468518:G:A	0	0	0	0	0	0	0	0
chr11:103909727:A:G	88	39	135	53	82	1.0	1.0	0.0
chr11:104038007:G:A	1	0	1	1	0	1	1	0
chr11:116763109:C:T	45	26	70	19	51	2	0	2
chr11:116782176:A:T	284	152	458	146	312	2.0	0.0	2.0
chr11:116790097:G:A	0	0	0	0	0	0	0	0
chr11:116820959:T:A	0	0	0	0	0	0	0	0
chr11:116821608:G:A	0	0	0	0	0	0	0	0
chr11:116832955:G:T	0	0	0	0	0	0	0	0
chr11:117181816:C:A	52	28	80	24	56	2.0	0.0	2.0
chr11:117182449:A:G	20	12	34	8	26	2.0	0.0	2.0
chr11:117189078:G:C	7	3	12	4	8	1	1	0
chr11:117190751:C:T	77	34	119	47	72	1	1	0
chr11:117191773:T:C	10	4	14	6	8	1.0	1.0	0.0
chr11:117193977:C:G	148	97	268	62	206	2.0	0.0	2.0
chr11:117203393:G:A	110	56	193	63	130	2.0	1.0	2.0
chr11:117206318:A:G	26	14	45	13	32	2.0	0.0	2.0
chr11:117219006:G:C	10	3	13	7	6	1.0	1.0	0.0
chr11:117219829:T:C	6	4	10	2	8	2.0	0.0	2.0
chr11:117225936:G:A	57	31	88	26	62	2	0	2
chr11:117229878:A:G	11	9	20	2	18	2	0	2
chr11:117381721:A:G	5	3	11	3	8	2	1	2
chr11:117381773:T:C	5	3	11	3	8	2	1	2
chr11:117387160:G:T	4	2	6	2	4	1.5	0.5	1.0
chr11:117412084:G:T	24	11	37	13	24	1.0	1.0	0.0
chr11:117902133:C:T	0	0	0	0	0	0	0	0
chr11:117989590:G:A	202	105	321	101	220	2.0	0.0	2.0
chr11:118094880:C:T	0	0	0	0	0	0	0	0
chr11:118094931:G:A	0	0	0	0	0	0	0	0
chr11:118118069:A:G	0	0	0	0	0	0	0	0
chr11:118141449:G:A	0	0	0	0	0	0	0	0
chr11:118145353:C:T	0	0	0	0	0	0	0	0
chr11:118350634:TG:CT	7	6	26	10	16	4	2	2
chr11:118350759:G:A	0	0	0	0	0	0	0	0
chr11:118534089:G:A	10	7	17	3	14	2.0	0.0	2.0
chr11:118631455:C:T	0	0	0	0	0	0	0	0
chr11:118643907:C:T	0	0	0	0	0	0	0	0
chr11:118658418:G:A	0	0	0	0	0	0	0	0
chr11:118659902:T:C	0	0	0	0	0	0	0	0
chr11:118663373:C:T	0	0	0	0	0	0	0	0
chr11:118883940:C:G	55	18	76	38	38	1	1	0
chr11:118894558:G:C	19	9	28	10	18	1	1	0
chr11:118898733:A:G	7	5	14	2	12	2	0	2
chr11:119029480:C:T	7	6	13	1	12	2	0	2
chr11:119048420:G:A	0	0	0	0	0	0	0	0
chr11:119049227:A:T	0	0	0	0	0	0	0	0
chr11:119054629:G:A	22	9	31	13	18	1.0	1.0	0.0
chr11:119070247:C:G	25	14	40	12	28	2	0	2
chr11:119076924:C:T	21	12	35	11	24	2	0	2
chr11:119078373:G:A	3	3	6	0	6	2	0	2
chr11:119078621:C:T	31	20	51	11	40	2	0	2
chr11:119081463:A:G	81	36	120	48	72	1	1	0
chr11:119081661:A:G	93	43	140	55	85	1	1	0
chr11:119084969:C:T	105	32	146	79	67	1	1	0
chr11:119089022:C:T	0	0	0	0	0	0	0	0
chr11:119097048:T:C	104	55	165	53	112	2.0	0.0	2.0
chr11:119100541:A:G	1	0	1	1	0	1	1	0
chr11:119112724:C:T	5	4	9	1	8	2	0	2
chr11:119116262:C:T	12	9	21	3	18	2.0	0.0	2.0
chr11:119127159:C:T	11	3	16	10	6	1	1	0
chr11:119131729:A:G	1	1	2	0	2	2	0	2
chr11:119132058:G:T	1	1	2	0	2	2	0	2
chr11:119172947:C:T	1	0	1	1	0	1	1	0
chr11:119182117:C:A	12	7	21	5	16	2.0	0.0	2.0
chr11:119185564:G:A	0	0	0	0	0	0	0	0
chr11:119188695:G:A	0	0	0	0	0	0	0	0
chr11:119190254:T:C	1	0	1	1	0	1	1	0
chr11:119335025:T:C	11	6	17	5	12	2	0	2
chr11:119335120:A:G	3	0	3	3	0	1	1	0
chr11:119339269:T:A	0	0	0	0	0	0	0	0
chr11:119345569:G:A	0	0	0	0	0	0	0	0
chr11:119345794:C:T	0	0	0	0	0	0	0	0
chr11:119346544:C:T	0	0	0	0	0	0	0	0
chr11:119346601:G:A	0	0	0	0	0	0	0	0
chr11:119359254:G:A	0	0	0	0	0	0	0	0
chr11:119419324:G:C	0	0	0	0	0	0	0	0
chr11:119420770:G:A	0	0	0	0	0	0	0	0
chr11:120115459:T:C	0	0	0	0	0	0	0	0
chr11:120115474:C:A	0	0	0	0	0	0	0	0
chr11:120137760:G:C	0	0	0	0	0	0	0	0
chr11:120327384:G:A	24	11	39	15	24	2.0	1.0	0.0
chr11:120407768:A:G	70	30	105	43	62	1.0	1.0	0.0
chr11:120952899:G:A	0	0	0	0	0	0	0	0
chr11:121118626:A:G	0	0	0	0	0	0	0	0
chr11:121125583:A:G	0	0	0	0	0	0	0	0
chr11:121130075:T:C	1	0	1	1	0	1	1	0
chr11:121146109:G:A	1	1	2	0	2	2	0	2
chr11:121146129:C:T	0	0	0	0	0	0	0	0
chr11:121362102:A:G	0	0	0	0	0	0	0	0
chr11:121496917:T:C	12	8	20	4	16	2.0	0.0	2.0
chr11:121555142:C:T	0	0	0	0	0	0	0	0
chr11:121586253:C:T	0	0	0	0	0	0	0	0
chr11:121605213:T:A	5	4	9	1	8	2	0	2
chr11:121608249:C:T	3	2	5	1	4	2	0	2
chr11:121612692:C:T	0	0	0	0	0	0	0	0
chr11:122809891:C:T	35	16	57	19	38	1	1	0
chr11:122867553:A:G	0	0	0	0	0	0	0	0
chr11:122871446:C:A	0	0	0	0	0	0	0	0
chr11:123606644:G:A	7	5	12	2	10	2	0	2
chr11:123610273:T:C	10	7	17	3	14	2.0	0.0	2.0
chr11:123725995:A:C	8	3	11	5	6	1.0	1.0	0.0
chr11:123805523:G:T	0	0	0	0	0	0	0	0
chr11:123994379:A:C	0	0	0	0	0	0	0	0
chr11:124015600:CA:TG	0	0	0	0	0	0	0	0
chr11:124015974:A:G	0	0	0	0	0	0	0	0
chr11:124016158:T:A	0	0	0	0	0	0	0	0
chr11:124016277:A:G	0	0	0	0	0	0	0	0
chr11:124145287:C:T	3	0	3	3	0	1	1	0
chr11:124146033:A:T	5	0	5	5	0	1	1	0
chr11:124185670:T:C	0	0	0	0	0	0	0	0
chr11:124185859:G:A	0	0	0	0	0	0	0	0
chr11:124186025:T:G	0	0	0	0	0	0	0	0
chr11:124186080:G:A	0	0	0	0	0	0	0	0
chr11:124207997:GT:AA	0	0	0	0	0	0	0	0
chr11:124224820:T:C	0	0	0	0	0	0	0	0
chr11:124225542:A:G	0	0	0	0	0	0	0	0
chr11:124250074:T:C	0	0	0	0	0	0	0	0
chr11:124250452:C:G	0	0	0	0	0	0	0	0
chr11:124264847:G:A	0	0	0	0	0	0	0	0
chr11:124265113:G:A	0	0	0	0	0	0	0	0
chr11:124265585:C:T	0	0	0	0	0	0	0	0
chr11:124309939:C:T	0	0	0	0	0	0	0	0
chr11:124310386:A:C	0	0	0	0	0	0	0	0
chr11:124382996:A:G	0	0	0	0	0	0	0	0
chr11:124383285:T:C	0	0	0	0	0	0	0	0
chr11:124397010:C:T	0	0	0	0	0	0	0	0
chr11:124424340:A:G	0	0	0	0	0	0	0	0
chr11:124424453:C:A	0	0	0	0	0	0	0	0
chr11:124424481:A:G	0	0	0	0	0	0	0	0
chr11:124570466:C:G	0	0	0	0	0	0	0	0
chr11:124923820:G:A	0	0	0	0	0	0	0	0
chr11:124987812:G:A	1	1	4	0	4	4	0	4
chr11:124993240:C:A	0	0	0	0	0	0	0	0
chr11:125088226:A:G	5	3	8	2	6	2	0	2
chr11:125102312:A:G	201	115	333	91	242	2	0	2
chr11:125456162:G:C	0	0	0	0	0	0	0	0
chr11:125481576:A:T	0	0	0	0	0	0	0	0
chr11:125495389:T:C	0	0	0	0	0	0	0	0
chr11:125747572:G:T	0	0	0	0	0	0	0	0
chr11:125981160:A:G	0	0	0	0	0	0	0	0
chr11:126211508:T:C	162	83	256	88	168	2.0	1.0	2.0
chr11:126269205:T:C	456	259	769	233	536	2.0	0.0	2.0
chr11:126293796:A:G	19	11	31	9	22	2	0	2
chr11:126304269:C:T	401	213	661	214	447	2	1	2
chr11:126306683:G:A	389	203	636	212	424	2	1	2
chr11:126424922:G:A	0	0	0	0	0	0	0	0
chr11:127940953:C:G	1	1	2	0	2	2	0	2
chr11:128463608:T:C	736	387	1292	458	834	2.0	1.0	2.0
chr11:128902557:C:T	0	0	0	0	0	0	0	0
chr11:128904579:T:C	0	0	0	0	0	0	0	0
chr11:129914869:C:T	2	1	3	1	2	1.5	0.5	1.0
chr11:129925055:T:C	1	0	1	1	0	1	1	0
chr11:129931148:C:T	0	0	0	0	0	0	0	0
chr11:130196440:C:T	10	3	13	7	6	1.0	1.0	0.0
chr11:130405451:G:A	0	0	0	0	0	0	0	0
chr11:130419222:T:C	0	0	0	0	0	0	0	0
chr11:130427853:G:C	0	0	0	0	0	0	0	0
chr11:130672987:C:T	0	0	0	0	0	0	0	0
chr11:130880747:A:C	9	5	14	4	10	2	0	2
chr11:130905793:C:T	23	12	35	11	24	2	0	2
chr11:130907991:G:A	53	23	79	32	47	1	1	0
chr11:130910120:C:T	116	50	169	70	99	1.0	1.0	0.0
chr11:130911580:C:G	52	26	79	27	52	2.0	0.5	1.0
chr11:130914501:G:A	24	16	41	9	32	2.0	0.0	2.0
chr11:130914593:A:G	22	16	39	7	32	2.0	0.0	2.0
chr11:130914721:T:C	21	14	36	8	28	2	0	2
chr11:130914859:C:G	19	12	32	8	24	2	0	2
chr11:130915076:C:G	25	14	39	11	28	2	0	2
chr11:130915310:G:A	25	13	38	12	26	2	0	2
chr11:130915409:T:C	22	10	32	12	20	1.0	1.0	0.0
chr11:131661106:T:C	0	0	0	0	0	0	0	0
chr11:131661121:T:G	0	0	0	0	0	0	0	0
chr11:131911020:A:C	0	0	0	0	0	0	0	0
chr11:132335114:C:T	0	0	0	0	0	0	0	0
chr11:133944296:A:G	0	0	0	0	0	0	0	0
chr11:134177348:T:C	2	1	3	1	2	1.5	0.5	1.0
chr11:134223994:G:C	43	17	65	27	38	1	1	0
chr11:134235136:A:G	1	0	1	1	0	1	1	0
chr11:134256718:T:C	1	0	1	1	0	1	1	0
chr11:134262665:G:A	2	1	3	1	2	1.5	0.5	1.0
chr11:134310481:C:T	0	0	0	0	0	0	0	0
chr11:134310508:G:A	0	0	0	0	0	0	0	0
chr11:134318648:T:C	0	0	0	0	0	0	0	0
chr12:14826:G:A	265	118	408	160	248	1	1	0
chr12:138989:C:T	0	0	0	0	0	0	0	0
chr12:141073:A:G	0	0	0	0	0	0	0	0
chr12:201735:T:C	0	0	0	0	0	0	0	0
chr12:202783:A:G	0	0	0	0	0	0	0	0
chr12:237069:G:A	0	0	0	0	0	0	0	0
chr12:297126:G:A	165	88	268	84	184	2	0	2
chr12:553282:T:C	0	0	0	0	0	0	0	0
chr12:865160:G:C	116	68	192	50	142	2.0	0.0	2.0
chr12:865238:T:C	64	30	98	36	62	1.0	1.0	0.0
chr12:1955500:T:C	4	2	6	2	4	1.5	0.5	1.0
chr12:2817377:A:G	9	5	14	4	10	2	0	2
chr12:2834858:G:C	0	0	0	0	0	0	0	0
chr12:2834951:C:T	0	0	0	0	0	0	0	0
chr12:2864381:G:T	14	4	19	11	8	1.0	1.0	0.0
chr12:2888231:G:A	274	131	419	151	268	1.0	1.0	0.0
chr12:3020766:C:T	0	0	0	0	0	0	0	0
chr12:3201169:C:T	0	0	0	0	0	0	0	0
chr12:3278531:T:C	0	0	0	0	0	0	0	0
chr12:3283185:A:G	1	0	1	1	0	1	1	0
chr12:3381380:T:C	0	0	0	0	0	0	0	0
chr12:3648382:T:C	3	0	3	3	0	1	1	0
chr12:4445247:C:T	0	0	0	0	0	0	0	0
chr12:4445464:A:G	0	0	0	0	0	0	0	0
chr12:4615829:C:T	3	0	3	3	0	1	1	0
chr12:4654971:G:A	20	10	32	10	22	1.5	0.5	1.0
chr12:4912062:T:C	0	0	0	0	0	0	0	0
chr12:4912182:G:C	0	0	0	0	0	0	0	0
chr12:5494466:G:A	0	0	0	0	0	0	0	0
chr12:5494769:C:T	0	0	0	0	0	0	0	0
chr12:5921135:G:A	0	0	0	0	0	0	0	0
chr12:5993928:C:A	0	0	0	0	0	0	0	0
chr12:5996221:G:A	0	0	0	0	0	0	0	0
chr12:6018777:A:G	0	0	0	0	0	0	0	0
chr12:6019277:T:C	0	0	0	0	0	0	0	0
chr12:6029429:C:T	0	0	0	0	0	0	0	0
chr12:6031493:C:T	0	0	0	0	0	0	0	0
chr12:6044348:A:G	0	0	0	0	0	0	0	0
chr12:6044368:T:C	0	0	0	0	0	0	0	0
chr12:6058030:A:G	0	0	0	0	0	0	0	0
chr12:6341779:T:C	73	43	117	31	86	2	0	2
chr12:6386109:C:A	8	4	13	5	8	1.5	1.0	1.0
chr12:6390939:T:G	28	8	38	22	16	1.0	1.0	0.0
chr12:6445462:G:A	2444	1654	7814	2559	5255	2.0	1.0	2.0
chr12:6451407:G:T	2480	1703	8043	2609	5434	2.0	1.0	2.0
chr12:6453587:A:G	127	60	193	67	126	1	1	0
chr12:6453644:A:G	130	60	196	70	126	1.0	1.0	0.0
chr12:6458741:C:T	110	53	173	59	114	1.5	1.0	0.0
chr12:6462882:A:G	213	101	340	120	220	2	1	0
chr12:6470646:T:C	219	116	351	111	240	2	0	2
chr12:6493201:C:T	873	444	1669	621	1048	2	1	2
chr12:6526108:G:A	9	2	11	7	4	1	1	0
chr12:6528775:C:T	24	9	33	15	18	1.0	1.0	0.0
chr12:6528950:C:T	27	18	45	9	36	2	0	2
chr12:6529500:C:T	1	0	1	1	0	1	1	0
chr12:6534825:C:G	3329	2453	15195	5139	10056	3	1	2
chr12:6598360:G:A	35	22	57	13	44	2	0	2
chr12:6599893:G:A	37	21	59	17	42	2	0	2
chr12:6601981:C:A	188	107	316	93	223	2.0	0.0	2.0
chr12:6606427:A:G	438	232	753	248	505	2.0	1.0	2.0
chr12:6731043:G:A	134	65	208	76	132	2.0	1.0	0.0
chr12:6748732:C:A	274	147	443	139	304	2.0	0.0	2.0
chr12:6750631:T:C	10	5	15	5	10	1.5	0.5	1.0
chr12:6751877:T:C	57	25	82	33	49	1	1	0
chr12:6815983:C:T	0	0	0	0	0	0	0	0
chr12:6817197:T:C	0	0	0	0	0	0	0	0
chr12:6818909:T:C	0	0	0	0	0	0	0	0
chr12:6824621:A:G	0	0	0	0	0	0	0	0
chr12:6826812:A:G	0	0	0	0	0	0	0	0
chr12:6830686:A:G	0	0	0	0	0	0	0	0
chr12:6831857:G:A	0	0	0	0	0	0	0	0
chr12:6833659:A:G	0	0	0	0	0	0	0	0
chr12:6837083:G:T	0	0	0	0	0	0	0	0
chr12:6837329:T:C	0	0	0	0	0	0	0	0
chr12:6837381:C:A	0	0	0	0	0	0	0	0
chr12:6839304:T:C	0	0	0	0	0	0	0	0
chr12:6839528:A:G	0	0	0	0	0	0	0	0
chr12:6944199:A:G	631	332	1383	471	912	2	1	2
chr12:6971024:C:G	384	178	593	227	366	1.0	1.0	0.0
chr12:7066589:G:A	1	0	1	1	0	1	1	0
chr12:7124640:T:A	1	1	2	0	2	2	0	2
chr12:7135836:A:G	8	3	11	5	6	1.0	1.0	0.0
chr12:7310645:A:T	0	0	0	0	0	0	0	0
chr12:7328322:T:A	0	0	0	0	0	0	0	0
chr12:7374528:A:G	0	0	0	0	0	0	0	0
chr12:7375875:G:A	0	0	0	0	0	0	0	0
chr12:7396400:C:G	0	0	0	0	0	0	0	0
chr12:7396413:C:T	0	0	0	0	0	0	0	0
chr12:7432651:T:C	0	0	0	0	0	0	0	0
chr12:7433375:A:G	0	0	0	0	0	0	0	0
chr12:7487740:G:A	0	0	0	0	0	0	0	0
chr12:7497057:T:C	0	0	0	0	0	0	0	0
chr12:7502541:A:G	0	0	0	0	0	0	0	0
chr12:7652640:C:G	0	0	0	0	0	0	0	0
chr12:7690336:C:T	0	0	0	0	0	0	0	0
chr12:7891092:G:C	0	0	0	0	0	0	0	0
chr12:7921596:G:A	0	0	0	0	0	0	0	0
chr12:8044828:C:G	3	2	6	2	4	2	0	2
chr12:8125585:A:T	3	1	4	2	2	1	1	0
chr12:8845245:G:T	0	0	0	0	0	0	0	0
chr12:8851916:G:A	0	0	0	0	0	0	0	0
chr12:8857183:C:T	2	2	4	0	4	2.0	0.0	2.0
chr12:8858075:G:A	1	0	1	1	0	1	1	0
chr12:8867893:A:G	0	0	0	0	0	0	0	0
chr12:8867967:T:C	0	0	0	0	0	0	0	0
chr12:8917770:T:A	2	1	3	1	2	1.5	0.5	1.0
chr12:8921663:C:T	1	1	2	0	2	2	0	2
chr12:8942386:A:G	35	22	58	14	44	2	0	2
chr12:8946438:G:A	1	0	1	1	0	1	1	0
chr12:8989701:T:C	6	3	10	4	6	2.0	0.5	1.0
chr12:8995174:A:G	16	11	30	6	24	2.0	0.0	2.0
chr12:9009052:T:C	43	24	70	22	48	2	0	2
chr12:9068133:G:A	4	3	7	1	6	2.0	0.0	2.0
chr12:9115877:A:C	0	0	0	0	0	0	0	0
chr12:10307944:A:T	2	1	6	2	4	3.0	1.0	2.0
chr12:10505908:G:A	1	0	2	2	0	2	2	0
chr12:10506629:A:T	0	0	0	0	0	0	0	0
chr12:10629516:T:C	1	0	2	2	0	2	2	0
chr12:10631130:A:G	1	1	4	0	4	4	0	4
chr12:10806432:C:T	1	1	2	0	2	2	0	2
chr12:10809516:A:G	0	0	0	0	0	0	0	0
chr12:10847181:C:T	117	56	183	69	114	2	1	0
chr12:10908523:T:C	0	0	0	0	0	0	0	0
chr12:10939094:T:A	19	5	26	14	12	1	1	0
chr12:10986084:C:T	2	0	2	2	0	1.0	1.0	0.0
chr12:10997641:T:C	5	2	7	3	4	1	1	0
chr12:11030687:G:C	21	4	26	18	8	1	1	0
chr12:11030913:A:G	17	7	24	10	14	1	1	0
chr12:11061546:C:T	11	5	16	6	10	1	1	0
chr12:11171340:GCGGC:CCGGT	1877	962	3866	1520	2346	2	1	2
chr12:11171395:G:A	1881	966	3878	1521	2357	2	1	2
chr12:11171577:C:A	2340	1361	5359	1911	3448	2.0	1.0	2.0
chr12:11891069:C:T	120	58	187	67	120	1.5	1.0	0.0
chr12:12094682:T:C	0	0	0	0	0	0	0	0
chr12:12148964:C:T	0	0	0	0	0	0	0	0
chr12:12357163:C:T	121	40	169	87	82	1	1	0
chr12:13563704:G:A	0	0	0	0	0	0	0	0
chr12:13564574:G:A	0	0	0	0	0	0	0	0
chr12:13567109:G:A	0	0	0	0	0	0	0	0
chr12:13611840:G:A	0	0	0	0	0	0	0	0
chr12:14503834:G:C	176	118	308	64	244	2.0	0.0	2.0
chr12:14771094:A:G	213	113	342	110	232	2	0	2
chr12:14942624:C:G	3285	2371	11609	3984	7625	3	1	2
chr12:15962872:T:C	478	237	748	262	486	2.0	1.0	0.0
chr12:16604929:T:C	0	0	0	0	0	0	0	0
chr12:18736192:G:A	0	0	0	0	0	0	0	0
chr12:20552606:C:T	0	0	0	0	0	0	0	0
chr12:20552813:G:C	0	0	0	0	0	0	0	0
chr12:21054455:T:C	0	0	0	0	0	0	0	0
chr12:21536948:T:A	0	0	0	0	0	0	0	0
chr12:23740819:G:A	0	0	0	0	0	0	0	0
chr12:23895898:A:G	0	0	0	0	0	0	0	0
chr12:25011397:A:G	29	16	48	14	34	2	0	2
chr12:25011432:A:G	28	13	44	16	28	1.5	1.0	0.0
chr12:25518825:T:A	0	0	0	0	0	0	0	0
chr12:25553200:G:A	0	0	0	0	0	0	0	0
chr12:25803324:C:T	1	1	2	0	2	2	0	2
chr12:26597012:G:A	72	41	115	31	84	2.0	0.0	2.0
chr12:26631917:G:A	151	94	254	59	195	2	0	2
chr12:26656383:G:A	79	44	125	37	88	2	0	2
chr12:26657844:T:C	63	36	101	29	72	2	0	2
chr12:26657883:T:G	64	37	102	28	74	2.0	0.0	2.0
chr12:26715389:T:C	168	74	255	99	156	1.0	1.0	0.0
chr12:26725833:G:A	7	4	11	3	8	2	0	2
chr12:27635088:G:A	3	2	5	1	4	2	0	2
chr12:27647813:G:T	4	2	6	2	4	1.5	0.5	1.0
chr12:27655169:G:A	0	0	0	0	0	0	0	0
chr12:27697180:A:T	0	0	0	0	0	0	0	0
chr12:27762785:A:T	1	0	1	1	0	1	1	0
chr12:27763011:A:G	1	1	2	0	2	2	0	2
chr12:27763273:G:A	1	1	2	0	2	2	0	2
chr12:27763291:A:G	1	1	2	0	2	2	0	2
chr12:27791925:G:A	14	7	23	7	16	1.5	0.5	1.0
chr12:27969552:T:A	0	0	0	0	0	0	0	0
chr12:29333812:T:C	3	3	6	0	6	2	0	2
chr12:30630809:C:T	28	17	44	11	33	2.0	0.0	2.0
chr12:30715068:C:T	11	7	20	4	16	2	0	2
chr12:30728875:T:C	17	6	23	11	12	1	1	0
chr12:30735067:T:C	113	54	176	62	114	1	1	0
chr12:30991949:A:G	0	0	0	0	0	0	0	0
chr12:31089337:G:A	3	1	5	3	2	2	1	0
chr12:31089784:T:C	0	0	0	0	0	0	0	0
chr12:31089791:T:C	0	0	0	0	0	0	0	0
chr12:31091658:G:A	0	0	0	0	0	0	0	0
chr12:31091771:C:T	15	15	30	0	30	2	0	2
chr12:31096927:C:G	9	2	12	8	4	1	1	0
chr12:31101061:C:T	18	12	30	6	24	2.0	0.0	2.0
chr12:31101818:C:T	1	1	2	0	2	2	0	2
chr12:31102329:G:A	0	0	0	0	0	0	0	0
chr12:31102471:C:T	20	13	33	7	26	2.0	0.0	2.0
chr12:31103612:G:A	33	15	49	19	30	1	1	0
chr12:31103971:T:C	44	18	65	27	38	1.0	1.0	0.0
chr12:31433073:C:T	6	3	9	3	6	1.5	0.5	1.0
chr12:31981306:C:T	1034	516	1831	679	1152	2.0	1.0	0.0
chr12:31981992:G:A	429	238	726	220	506	2	0	2
chr12:31982009:A:G	432	204	696	260	436	2.0	1.0	0.0
chr12:31984578:C:G	999	541	1930	664	1266	2	1	2
chr12:32582302:C:T	4	3	7	1	6	2.0	0.0	2.0
chr12:32611250:G:A	2	0	2	2	0	1.0	1.0	0.0
chr12:32638862:G:A	0	0	0	0	0	0	0	0
chr12:32737978:T:A	19	8	27	11	16	1	1	0
chr12:32792787:G:T	0	0	0	0	0	0	0	0
chr12:32792835:G:C	0	0	0	0	0	0	0	0
chr12:32821311:C:T	0	0	0	0	0	0	0	0
chr12:33382354:G:A	0	0	0	0	0	0	0	0
chr12:38316781:C:T	36	11	49	25	24	1.0	1.0	0.0
chr12:38321198:A:G	0	0	0	0	0	0	0	0
chr12:39358234:T:C	20	9	29	11	18	1.0	1.0	0.0
chr12:40105545:G:A	27	11	40	16	24	1	1	0
chr12:40322458:T:C	6	3	9	3	6	1.5	0.5	1.0
chr12:40364850:T:C	16	9	25	7	18	2.0	0.0	2.0
chr12:40406167:C:T	0	0	0	0	0	0	0	0
chr12:40406173:G:C	0	0	0	0	0	0	0	0
chr12:40408348:G:A	0	0	0	0	0	0	0	0
chr12:40426406:G:A	0	0	0	0	0	0	0	0
chr12:40428065:G:A	0	0	0	0	0	0	0	0
chr12:40479224:G:A	0	0	0	0	0	0	0	0
chr12:40479476:T:A	0	0	0	0	0	0	0	0
chr12:40479770:C:G	0	0	0	0	0	0	0	0
chr12:40480142:C:G	0	0	0	0	0	0	0	0
chr12:40480286:C:T	0	0	0	0	0	0	0	0
chr12:40480537:G:A	0	0	0	0	0	0	0	0
chr12:40482549:A:T	0	0	0	0	0	0	0	0
chr12:40483260:A:T	0	0	0	0	0	0	0	0
chr12:40483640:C:T	0	0	0	0	0	0	0	0
chr12:40484650:G:A	0	0	0	0	0	0	0	0
chr12:40484711:G:A	0	0	0	0	0	0	0	0
chr12:40484887:G:T	0	0	0	0	0	0	0	0
chr12:40484948:C:T	0	0	0	0	0	0	0	0
chr12:40485044:C:T	0	0	0	0	0	0	0	0
chr12:40490439:A:C	0	0	0	0	0	0	0	0
chr12:40490601:C:A	0	0	0	0	0	0	0	0
chr12:40490731:G:T	0	0	0	0	0	0	0	0
chr12:40491079:A:G	0	0	0	0	0	0	0	0
chr12:40501162:G:T	0	0	0	0	0	0	0	0
chr12:40507243:T:C	0	0	0	0	0	0	0	0
chr12:40526308:T:C	0	0	0	0	0	0	0	0
chr12:40532106:A:C	0	0	0	0	0	0	0	0
chr12:40943633:C:T	0	0	0	0	0	0	0	0
chr12:41573875:G:A	0	0	0	0	0	0	0	0
chr12:42459718:A:G	24	11	37	13	24	1.0	1.0	0.0
chr12:43797822:G:A	66	36	109	31	78	2.0	0.0	2.0
chr12:44532551:T:A	0	0	0	0	0	0	0	0
chr12:47077656:G:A	58	34	97	26	71	2.0	0.0	2.0
chr12:47235585:G:T	78	50	134	30	104	2.0	0.0	2.0
chr12:47740431:G:C	10	6	16	4	12	2.0	0.0	2.0
chr12:47740577:G:T	5	4	9	1	8	2	0	2
chr12:47740912:T:C	2	1	3	1	2	1.5	0.5	1.0
chr12:47748635:C:G	9	3	12	6	6	1	1	0
chr12:47758039:C:G	40	12	52	28	24	1.0	1.0	0.0
chr12:47784123:C:T	87	44	131	43	88	2	0	2
chr12:47785564:C:T	3	0	3	3	0	1	1	0
chr12:47785695:T:G	4	1	5	3	2	1.0	1.0	0.0
chr12:47796261:C:T	46	24	72	24	48	2.0	0.0	2.0
chr12:47844974:A:G	4	2	6	2	4	1.5	0.5	1.0
chr12:47981785:A:G	0	0	0	0	0	0	0	0
chr12:47982508:G:A	0	0	0	0	0	0	0	0
chr12:47997633:G:T	0	0	0	0	0	0	0	0
chr12:48133403:C:T	6	0	6	6	0	1.0	1.0	0.0
chr12:48145699:T:G	23	13	36	10	26	2	0	2
chr12:48184659:C:T	1	1	2	0	2	2	0	2
chr12:48329541:C:G	1	0	1	1	0	1	1	0
chr12:48330001:C:T	1	1	2	0	2	2	0	2
chr12:48343202:T:G	13	7	21	7	14	2	0	2
chr12:48483248:G:A	0	0	0	0	0	0	0	0
chr12:48526010:T:C	0	0	0	0	0	0	0	0
chr12:48526290:G:A	0	0	0	0	0	0	0	0
chr12:48654955:G:T	95	43	150	58	92	1	1	0
chr12:48671944:T:C	146	56	214	96	118	1.0	1.0	0.0
chr12:48693180:G:A	65	30	101	37	64	1	1	0
chr12:48693873:G:C	83	35	122	50	72	1	1	0
chr12:48771042:T:C	0	0	0	0	0	0	0	0
chr12:48773900:C:A	0	0	0	0	0	0	0	0
chr12:48774345:G:C	0	0	0	0	0	0	0	0
chr12:48783089:G:T	0	0	0	0	0	0	0	0
chr12:48966364:G:A	0	0	0	0	0	0	0	0
chr12:49040291:C:A	55	30	90	26	64	2	0	2
chr12:49296554:T:C	0	0	0	0	0	0	0	0
chr12:49297467:A:G	4	4	8	0	8	2.0	0.0	2.0
chr12:49330180:A:G	1	1	2	0	2	2	0	2
chr12:49331172:A:C	0	0	0	0	0	0	0	0
chr12:49544030:A:G	0	0	0	0	0	0	0	0
chr12:49557449:T:C	4	0	4	4	0	1.0	1.0	0.0
chr12:49557594:C:T	7	0	7	7	0	1	1	0
chr12:49558611:C:T	298	141	457	168	289	1.0	1.0	0.0
chr12:49558885:G:A	279	128	423	158	265	1	1	0
chr12:49566768:C:A	191	82	279	113	166	1	1	0
chr12:49599895:C:T	0	0	0	0	0	0	0	0
chr12:49758410:G:A	1794	1063	3769	1247	2522	2.0	1.0	2.0
chr12:49795819:A:G	0	0	0	0	0	0	0	0
chr12:49796870:C:T	3	2	5	1	4	2	0	2
chr12:49796884:A:T	3	2	5	1	4	2	0	2
chr12:49838386:A:T	79	41	124	38	86	2	0	2
chr12:50143277:C:G	6	4	10	2	8	2.0	0.0	2.0
chr12:50144032:A:G	103	53	158	52	106	2	0	2
chr12:50352008:C:G	0	0	0	0	0	0	0	0
chr12:50843019:T:C	0	0	0	0	0	0	0	0
chr12:50844033:G:A	0	0	0	0	0	0	0	0
chr12:51890884:C:A	0	0	0	0	0	0	0	0
chr12:51919160:T:C	0	0	0	0	0	0	0	0
chr12:51919180:A:G	0	0	0	0	0	0	0	0
chr12:52055228:C:A	0	0	0	0	0	0	0	0
chr12:52172263:G:A	0	0	0	0	0	0	0	0
chr12:52406139:G:A	0	0	0	0	0	0	0	0
chr12:52424720:T:G	0	0	0	0	0	0	0	0
chr12:52428208:A:G	0	0	0	0	0	0	0	0
chr12:52428474:A:G	0	0	0	0	0	0	0	0
chr12:52430568:G:A	0	0	0	0	0	0	0	0
chr12:52431579:G:A	0	0	0	0	0	0	0	0
chr12:52434034:T:C	0	0	0	0	0	0	0	0
chr12:52447981:G:A	0	0	0	0	0	0	0	0
chr12:52452017:T:C	0	0	0	0	0	0	0	0
chr12:52468983:GGAT:CGAC	0	0	0	0	0	0	0	0
chr12:52468999:G:A	0	0	0	0	0	0	0	0
chr12:52469254:G:A	0	0	0	0	0	0	0	0
chr12:52469837:T:G	0	0	0	0	0	0	0	0
chr12:52470456:G:T	0	0	0	0	0	0	0	0
chr12:52487644:A:C	0	0	0	0	0	0	0	0
chr12:52490499:A:G	0	0	0	0	0	0	0	0
chr12:52490773:T:C	0	0	0	0	0	0	0	0
chr12:52492694:T:C	0	0	0	0	0	0	0	0
chr12:52492706:A:G	0	0	0	0	0	0	0	0
chr12:52544536:C:T	0	0	0	0	0	0	0	0
chr12:52544580:T:C	0	0	0	0	0	0	0	0
chr12:52544713:A:C	0	0	0	0	0	0	0	0
chr12:52587658:C:A	0	0	0	0	0	0	0	0
chr12:52587843:A:T	0	0	0	0	0	0	0	0
chr12:52590836:C:T	0	0	0	0	0	0	0	0
chr12:52591509:A:G	0	0	0	0	0	0	0	0
chr12:52592403:T:C	0	0	0	0	0	0	0	0
chr12:52599028:T:C	0	0	0	0	0	0	0	0
chr12:52610819:G:A	0	0	0	0	0	0	0	0
chr12:52610870:C:G	0	0	0	0	0	0	0	0
chr12:52768744:G:A	0	0	0	0	0	0	0	0
chr12:52771064:G:A	0	0	0	0	0	0	0	0
chr12:52773611:C:T	0	0	0	0	0	0	0	0
chr12:52792304:G:C	0	0	0	0	0	0	0	0
chr12:52795912:C:G	0	0	0	0	0	0	0	0
chr12:52823917:C:A	0	0	0	0	0	0	0	0
chr12:52834019:A:G	0	0	0	0	0	0	0	0
chr12:52904991:A:T	0	0	0	0	0	0	0	0
chr12:53006394:C:T	10	3	13	7	6	1.0	1.0	0.0
chr12:53033813:C:G	1073	573	1928	661	1267	2	1	2
chr12:53038304:T:C	47	20	68	28	40	1	1	0
chr12:53039152:A:G	18	9	27	9	18	1.5	0.5	1.0
chr12:53039194:T:C	17	9	26	8	18	2	0	2
chr12:53039702:C:T	693	370	1173	379	794	2	1	2
chr12:53049172:G:C	1	0	1	1	0	1	1	0
chr12:53055951:T:C	2	2	4	0	4	2.0	0.0	2.0
chr12:53059672:C:T	1	1	2	0	2	2	0	2
chr12:53062069:C:T	0	0	0	0	0	0	0	0
chr12:53062096:G:A	0	0	0	0	0	0	0	0
chr12:53063834:C:T	3	2	5	1	4	2	0	2
chr12:53063920:C:A	2	1	3	1	2	1.5	0.5	1.0
chr12:53115555:GC:TT	0	0	0	0	0	0	0	0
chr12:53116149:C:T	0	0	0	0	0	0	0	0
chr12:53154203:A:G	0	0	0	0	0	0	0	0
chr12:53187592:C:T	26	9	35	17	18	1.0	1.0	0.0
chr12:53253589:T:C	87	41	130	46	84	1	1	0
chr12:53268840:C:A	1	0	1	1	0	1	1	0
chr12:53276761:C:A	0	0	0	0	0	0	0	0
chr12:53286227:T:G	1	0	1	1	0	1	1	0
chr12:53287899:A:G	0	0	0	0	0	0	0	0
chr12:53288542:G:A	0	0	0	0	0	0	0	0
chr12:53288673:G:A	0	0	0	0	0	0	0	0
chr12:53289202:C:T	0	0	0	0	0	0	0	0
chr12:53486869:C:T	8	4	12	4	8	1.5	0.5	1.0
chr12:54181674:T:C	84	43	130	42	88	2.0	0.5	2.0
chr12:54370338:G:T	4	1	5	3	2	1.0	1.0	0.0
chr12:54402085:G:C	5	4	9	1	8	2	0	2
chr12:54517642:C:T	274	145	442	144	298	2.0	1.0	2.0
chr12:54561540:T:C	6	2	8	4	4	1.0	1.0	0.0
chr12:54576086:T:G	3	2	5	1	4	2	0	2
chr12:54581019:C:T	0	0	0	0	0	0	0	0
chr12:54634843:C:A	0	0	0	0	0	0	0	0
chr12:55129901:C:T	0	0	0	0	0	0	0	0
chr12:55130076:A:C	0	0	0	0	0	0	0	0
chr12:55130388:G:A	0	0	0	0	0	0	0	0
chr12:55130530:T:C	0	0	0	0	0	0	0	0
chr12:55247544:G:A	0	0	0	0	0	0	0	0
chr12:55321335:G:A	0	0	0	0	0	0	0	0
chr12:55366067:A:G	0	0	0	0	0	0	0	0
chr12:55411863:A:G	2	0	2	2	0	1.0	1.0	0.0
chr12:55412350:T:C	1	0	1	1	0	1	1	0
chr12:55412454:A:G	2	0	2	2	0	1.0	1.0	0.0
chr12:55412653:T:C	1	1	2	0	2	2	0	2
chr12:55426337:C:T	0	0	0	0	0	0	0	0
chr12:55469440:C:G	0	0	0	0	0	0	0	0
chr12:55469597:A:G	0	0	0	0	0	0	0	0
chr12:55492510:G:A	0	0	0	0	0	0	0	0
chr12:55492705:T:A	0	0	0	0	0	0	0	0
chr12:55493118:C:T	0	0	0	0	0	0	0	0
chr12:55694989:C:T	0	0	0	0	0	0	0	0
chr12:55695573:C:T	0	0	0	0	0	0	0	0
chr12:55700033:T:G	0	0	0	0	0	0	0	0
chr12:55703032:T:C	0	0	0	0	0	0	0	0
chr12:56021533:G:A	1	1	2	0	2	2	0	2
chr12:56101207:G:A	2	1	3	1	2	1.5	0.5	1.0
chr12:56101214:A:T	2	1	3	1	2	1.5	0.5	1.0
chr12:56116853:A:G	2270	1108	5109	2370	2739	2.0	1.0	0.0
chr12:56137370:T:C	20	8	29	13	16	1.0	1.0	0.0
chr12:56206744:C:T	512	272	871	283	588	2.0	1.0	2.0
chr12:56300123:A:C	36	10	48	27	21	1.0	1.0	0.0
chr12:56420786:T:G	1	1	2	0	2	2	0	2
chr12:56420869:G:A	42	16	58	26	32	1.0	1.0	0.0
chr12:56420872:A:G	42	26	68	16	52	2.0	0.0	2.0
chr12:56421497:T:C	2	0	2	2	0	1.0	1.0	0.0
chr12:56422138:C:T	18	9	28	10	18	1.5	1.0	1.0
chr12:56428594:T:A	56	23	84	34	50	1.0	1.0	0.0
chr12:56431527:C:T	65	26	92	40	52	1	1	0
chr12:56433910:C:G	72	40	113	33	80	2.0	0.0	2.0
chr12:56598593:A:C	227	125	377	109	268	2	0	2
chr12:56611895:A:T	325	161	512	180	332	2	1	0
chr12:56636242:T:C	44	17	62	29	33	1.0	1.0	0.0
chr12:56714419:A:G	4352	4203	70544	23705	46839	14.0	5.0	10.0
chr12:56716147:A:T	17	10	27	7	20	2	0	2
chr12:56720523:A:T	20	13	35	7	28	2.0	0.0	2.0
chr12:56739356:T:G	78	44	129	37	92	2.0	0.0	2.0
chr12:56744044:T:A	1	0	1	1	0	1	1	0
chr12:57003249:C:T	9	6	15	3	12	2	0	2
chr12:57028667:G:A	0	0	0	0	0	0	0	0
chr12:57098962:G:A	3	1	4	2	2	1	1	0
chr12:57099213:G:A	19	14	35	5	30	2	0	2
chr12:57173979:C:T	0	0	0	0	0	0	0	0
chr12:57175695:C:T	0	0	0	0	0	0	0	0
chr12:57191361:C:T	0	0	0	0	0	0	0	0
chr12:57195876:C:T	0	0	0	0	0	0	0	0
chr12:57197014:C:T	0	0	0	0	0	0	0	0
chr12:57199318:G:A	0	0	0	0	0	0	0	0
chr12:57225579:G:A	6	4	10	2	8	2.0	0.0	2.0
chr12:57243810:G:A	22	5	27	17	10	1.0	1.0	0.0
chr12:57449928:G:A	0	0	0	0	0	0	0	0
chr12:57455751:T:G	0	0	0	0	0	0	0	0
chr12:57455985:C:G	0	0	0	0	0	0	0	0
chr12:57465648:G:A	0	0	0	0	0	0	0	0
chr12:57471538:G:A	0	0	0	0	0	0	0	0
chr12:57472038:G:C	0	0	0	0	0	0	0	0
chr12:57475799:T:C	15	6	20	9	11	1	1	0
chr12:57476372:A:C	205	120	337	87	250	2	0	2
chr12:57524302:C:A	27	16	44	12	32	2	0	2
chr12:57591421:C:T	95	40	140	58	82	1	1	0
chr12:57608816:C:T	8	4	12	4	8	1.5	0.5	1.0
chr12:57615419:T:C	0	0	0	0	0	0	0	0
chr12:57615589:G:A	0	0	0	0	0	0	0	0
chr12:57623918:T:G	0	0	0	0	0	0	0	0
chr12:57625196:C:T	0	0	0	0	0	0	0	0
chr12:57628291:G:A	0	0	0	0	0	0	0	0
chr12:57630198:C:A	0	0	0	0	0	0	0	0
chr12:57632030:G:C	0	0	0	0	0	0	0	0
chr12:57750882:C:T	5	1	6	4	2	1	1	0
chr12:57768956:A:G	49	24	80	26	54	1	1	0
chr12:57780523:T:C	5	3	8	2	6	2	0	2
chr12:57782831:T:C	230	112	357	133	224	2.0	1.0	0.0
chr12:57802664:G:A	2	2	4	0	4	2.0	0.0	2.0
chr12:63560524:T:C	0	0	0	0	0	0	0	0
chr12:64126026:T:C	0	0	0	0	0	0	0	0
chr12:64274967:G:A	0	0	0	0	0	0	0	0
chr12:64752752:C:T	61	33	98	29	69	2	0	2
chr12:66302630:C:T	122	83	212	40	172	2.0	0.0	2.0
chr12:66331380:C:T	5	2	7	3	4	1	1	0
chr12:66331422:C:T	6	3	9	3	6	1.5	0.5	1.0
chr12:67658398:G:T	29	16	46	14	32	2	0	2
chr12:68314981:C:T	26	13	39	13	26	1.5	0.5	1.0
chr12:68325436:G:A	2	1	3	1	2	1.5	0.5	1.0
chr12:68326847:G:A	179	97	299	87	212	2	0	2
chr12:68686948:T:G	0	0	0	0	0	0	0	0
chr12:68721918:G:A	15	7	22	8	14	1	1	0
chr12:68808384:A:G	581	310	995	327	668	2	1	2
chr12:68839435:A:G	341	159	557	219	338	2	1	0
chr12:69574082:G:A	88	45	136	46	90	2.0	0.5	2.0
chr12:69588082:G:A	4	2	6	2	4	1.5	0.5	1.0
chr12:69880205:T:G	0	0	0	0	0	0	0	0
chr12:69936307:A:G	0	0	0	0	0	0	0	0
chr12:70559497:T:C	0	0	0	0	0	0	0	0
chr12:70560767:G:A	0	0	0	0	0	0	0	0
chr12:70570970:G:A	0	0	0	0	0	0	0	0
chr12:70745884:T:C	0	0	0	0	0	0	0	0
chr12:71664557:G:A	362	188	600	202	398	2.0	1.0	2.0
chr12:71938935:A:G	2	2	4	0	4	2.0	0.0	2.0
chr12:71979082:A:G	0	0	0	0	0	0	0	0
chr12:74538379:G:C	1567	911	3076	994	2082	2	1	2
chr12:75391320:C:T	10	2	14	8	6	1.0	1.0	0.0
chr12:77044656:T:C	4	2	6	2	4	1.5	0.5	1.0
chr12:77831406:C:A	1	1	2	0	2	2	0	2
chr12:77940273:G:C	0	0	0	0	0	0	0	0
chr12:78137199:G:A	0	0	0	0	0	0	0	0
chr12:78168838:A:G	0	0	0	0	0	0	0	0
chr12:78205111:G:A	0	0	0	0	0	0	0	0
chr12:79217594:C:T	0	0	0	0	0	0	0	0
chr12:80460849:C:T	45	25	70	20	50	2	0	2
chr12:80541586:C:T	12	6	18	6	12	1.5	0.5	1.0
chr12:80541713:A:G	12	6	18	6	12	1.5	0.5	1.0
chr12:80542247:A:G	4	1	5	3	2	1.0	1.0	0.0
chr12:80716986:A:G	0	0	0	0	0	0	0	0
chr12:81439966:G:T	0	0	0	0	0	0	0	0
chr12:82398887:C:T	91	50	148	44	104	2	0	2
chr12:82399163:A:G	33	17	52	16	36	2	0	2
chr12:85280352:G:C	0	0	0	0	0	0	0	0
chr12:89523260:G:A	23	11	34	12	22	1	1	0
chr12:89635124:T:C	729	392	1308	437	871	2	1	2
chr12:91056213:C:T	0	0	0	0	0	0	0	0
chr12:91108473:A:G	0	0	0	0	0	0	0	0
chr12:92737427:A:C	3	2	5	1	4	2	0	2
chr12:92754131:A:T	2	2	4	0	4	2.0	0.0	2.0
chr12:92756326:T:C	1	0	1	1	0	1	1	0
chr12:92802646:T:G	98	44	151	62	89	1.0	1.0	0.0
chr12:92864889:A:G	620	329	1080	354	726	2.0	1.0	2.0
chr12:95943447:C:T	23	13	38	11	27	2	0	2
chr12:95990344:T:C	1	1	2	0	2	2	0	2
chr12:95990361:T:C	1	1	2	0	2	2	0	2
chr12:95990471:T:C	2	2	4	0	4	2.0	0.0	2.0
chr12:96280777:C:T	7	4	11	3	8	2	0	2
chr12:96533859:A:C	0	0	0	0	0	0	0	0
chr12:96742440:T:C	0	0	0	0	0	0	0	0
chr12:98598486:G:A	18	10	28	8	20	2.0	0.0	2.0
chr12:99246650:T:C	0	0	0	0	0	0	0	0
chr12:99246779:T:C	0	0	0	0	0	0	0	0
chr12:99648262:C:G	0	0	0	0	0	0	0	0
chr12:99648385:A:G	0	0	0	0	0	0	0	0
chr12:100623667:T:C	0	0	0	0	0	0	0	0
chr12:100624236:T:C	0	0	0	0	0	0	0	0
chr12:100942423:G:C	0	0	0	0	0	0	0	0
chr12:101401231:A:C	35	17	55	19	36	1	1	0
chr12:101594996:G:T	0	0	0	0	0	0	0	0
chr12:101659897:C:T	0	0	0	0	0	0	0	0
chr12:102852922:C:T	0	0	0	0	0	0	0	0
chr12:102855146:C:T	0	0	0	0	0	0	0	0
chr12:102877415:G:A	0	0	0	0	0	0	0	0
chr12:103674034:C:T	0	0	0	0	0	0	0	0
chr12:103706839:C:T	0	0	0	0	0	0	0	0
chr12:103755244:G:A	0	0	0	0	0	0	0	0
chr12:103793168:G:T	10	6	16	4	12	2.0	0.0	2.0
chr12:104805260:G:A	1	1	2	0	2	2	0	2
chr12:104986374:A:C	535	279	943	323	620	2	1	2
chr12:105190099:G:A	37	16	57	23	34	1	1	0
chr12:105207157:G:A	65	26	95	39	56	1	1	0
chr12:106083967:G:A	0	0	0	0	0	0	0	0
chr12:106239791:C:T	29	3	32	26	6	1	1	0
chr12:106311196:G:A	495	298	896	224	672	2	0	2
chr12:106329412:A:G	35	16	55	21	34	1	1	0
chr12:106444562:T:C	3	2	5	1	4	2	0	2
chr12:106509543:T:C	14	7	21	7	14	1.5	0.5	1.0
chr12:106696423:T:C	0	0	0	0	0	0	0	0
chr12:107734188:A:G	38	19	59	19	40	1.5	0.5	1.0
chr12:107742395:A:G	6	3	9	3	6	1.5	0.5	1.0
chr12:108525613:T:C	4	3	7	1	6	2.0	0.0	2.0
chr12:108538003:C:A	8	3	11	5	6	1.0	1.0	0.0
chr12:108788273:T:C	5	1	6	4	2	1	1	0
chr12:108811413:C:T	2	0	2	2	0	1.0	1.0	0.0
chr12:108899544:A:G	0	0	0	0	0	0	0	0
chr12:108983605:A:G	0	0	0	0	0	0	0	0
chr12:109052596:C:T	545	278	907	312	595	2	1	2
chr12:109237224:T:C	2	2	4	0	4	2.0	0.0	2.0
chr12:109246320:G:A	6	0	6	6	0	1.0	1.0	0.0
chr12:109254248:C:T	4	2	6	2	4	1.5	0.5	1.0
chr12:109256177:C:T	3	2	5	1	4	2	0	2
chr12:109266372:G:A	8	7	15	1	14	2.0	0.0	2.0
chr12:109279892:A:G	0	0	0	0	0	0	0	0
chr12:109287902:G:A	0	0	0	0	0	0	0	0
chr12:109457551:C:T	1	0	1	1	0	1	1	0
chr12:109460568:G:A	8	5	13	3	10	2.0	0.0	2.0
chr12:109499729:G:A	8	5	13	3	10	2.0	0.0	2.0
chr12:109530622:C:T	11	9	20	2	18	2	0	2
chr12:109557065:A:T	286	154	489	163	326	2.0	1.0	2.0
chr12:109565014:A:G	14	6	20	8	12	1.0	1.0	0.0
chr12:109568707:A:G	49	27	78	23	55	2	0	2
chr12:109573424:GC:TT	476	257	818	266	552	2.0	1.0	2.0
chr12:109744202:C:G	0	0	0	0	0	0	0	0
chr12:109803033:T:G	0	0	0	0	0	0	0	0
chr12:110468707:C:G	39	21	61	19	42	2	0	2
chr12:110537085:T:C	37	15	52	22	30	1	1	0
chr12:110904754:G:T	0	0	0	0	0	0	0	0
chr12:110913097:T:G	1	0	1	1	0	1	1	0
chr12:110913195:G:A	0	0	0	0	0	0	0	0
chr12:111347782:T:C	0	0	0	0	0	0	0	0
chr12:111446804:T:C	2	1	3	1	2	1.5	0.5	1.0
chr12:111457399:C:G	12	10	22	2	20	2.0	0.0	2.0
chr12:111457468:C:T	10	8	18	2	16	2.0	0.0	2.0
chr12:111745072:C:T	4	2	9	3	6	2.0	0.5	1.0
chr12:112229871:T:G	3	2	5	1	4	2	0	2
chr12:112881795:C:T	0	0	0	0	0	0	0	0
chr12:112887824:T:C	0	0	0	0	0	0	0	0
chr12:112949145:T:C	9	6	15	3	12	2	0	2
chr12:112963394:G:A	1	1	2	0	2	2	0	2
chr12:112987349:C:G	28	18	45	10	35	2.0	0.0	2.0
chr12:112997645:A:T	216	106	337	119	218	2.0	1.0	0.0
chr12:113009298:A:G	79	38	128	46	82	2	1	0
chr12:113094812:A:G	35	18	53	17	36	2	0	2
chr12:113095080:C:T	43	24	69	19	50	2	0	2
chr12:113099968:C:T	37	13	51	25	26	1	1	0
chr12:113115676:C:T	1	1	2	0	2	2	0	2
chr12:113117141:G:A	1	0	1	1	0	1	1	0
chr12:113155400:G:A	49	24	78	26	52	2	1	0
chr12:113200551:C:A	1	0	1	1	0	1	1	0
chr12:113387874:C:T	9	5	14	4	10	2	0	2
chr12:113388637:C:G	10	5	18	6	12	1.5	1.0	1.0
chr12:116575925:G:C	0	0	0	0	0	0	0	0
chr12:116849620:C:T	6	3	9	3	6	1.5	0.5	1.0
chr12:117028052:T:C	12	8	20	4	16	2.0	0.0	2.0
chr12:117028176:T:C	13	8	21	5	16	2	0	2
chr12:117232109:G:A	0	0	0	0	0	0	0	0
chr12:117247465:G:A	0	0	0	0	0	0	0	0
chr12:117256012:G:A	0	0	0	0	0	0	0	0
chr12:117263909:A:G	0	0	0	0	0	0	0	0
chr12:117582310:G:A	6	3	9	3	6	1.5	0.5	1.0
chr12:118035249:T:C	230	128	387	115	272	2.0	0.0	2.0
chr12:118068381:A:T	59	27	98	38	60	2	1	0
chr12:118246438:A:G	7	3	10	4	6	1	1	0
chr12:118981798:G:C	0	0	0	0	0	0	0	0
chr12:119752083:T:C	3	1	4	2	2	1	1	0
chr12:119782478:A:G	2	2	4	0	4	2.0	0.0	2.0
chr12:119783832:C:T	1	1	2	0	2	2	0	2
chr12:120659819:G:A	0	0	0	0	0	0	0	0
chr12:120994314:G:C	0	0	0	0	0	0	0	0
chr12:120999311:G:A	0	0	0	0	0	0	0	0
chr12:121004396:T:A	196	109	332	94	238	2.0	0.0	2.0
chr12:121004411:G:A	196	108	331	95	236	2.0	0.0	2.0
chr12:121012551:C:A	42	8	53	37	16	1.0	1.0	0.0
chr12:121012581:G:C	42	8	53	37	16	1.0	1.0	0.0
chr12:121154886:T:C	16	6	22	10	12	1.0	1.0	0.0
chr12:121162377:C:T	3	2	5	1	4	2	0	2
chr12:121162450:T:C	20	10	30	10	20	1.5	0.5	1.0
chr12:121167552:G:A	11	6	17	5	12	2	0	2
chr12:121177300:G:A	10	6	16	4	12	2.0	0.0	2.0
chr12:121184393:A:G	24	12	36	12	24	1.5	0.5	1.0
chr12:121184760:G:A	25	13	38	12	26	2	0	2
chr12:121216917:C:T	15	7	22	8	14	1	1	0
chr12:121222984:T:C	120	48	175	75	100	1.0	1.0	0.0
chr12:121233458:C:A	31	10	41	21	20	1	1	0
chr12:121274274:T:A	72	37	114	36	78	2.0	0.0	2.0
chr12:121440856:C:T	40	19	58	21	37	1.0	1.0	0.0
chr12:121442717:G:A	12	2	14	10	4	1.0	1.0	0.0
chr12:121444045:G:A	17	4	22	14	8	1	1	0
chr12:121444295:T:G	4	2	6	2	4	1.5	0.5	1.0
chr12:122043973:A:C	133	74	219	63	156	2	0	2
chr12:122059095:T:C	47	28	75	19	56	2	0	2
chr12:122128051:T:C	0	0	0	0	0	0	0	0
chr12:122129840:T:G	2	1	3	1	2	1.5	0.5	1.0
chr12:122133442:A:G	26	12	38	14	24	1.0	1.0	0.0
chr12:122138453:T:C	1	1	2	0	2	2	0	2
chr12:122191466:A:C	0	0	0	0	0	0	0	0
chr12:122218467:C:T	336	166	526	185	341	1.0	1.0	0.0
chr12:122278057:T:C	64	44	112	20	92	2.0	0.0	2.0
chr12:122327956:G:C	104	50	168	64	104	2.0	1.0	0.0
chr12:122355362:C:T	2	1	3	1	2	1.5	0.5	1.0
chr12:122605340:C:T	16	8	24	8	16	1.5	0.5	1.0
chr12:122620596:C:T	49	30	81	21	60	2	0	2
chr12:122703290:G:A	0	0	0	0	0	0	0	0
chr12:122715552:T:C	0	0	0	0	0	0	0	0
chr12:122716146:A:G	1	0	1	1	0	1	1	0
chr12:122716221:T:G	1	0	1	1	0	1	1	0
chr12:122716390:T:G	3	2	5	1	4	2	0	2
chr12:122753868:AG:GT	221	95	330	136	194	1	1	0
chr12:123009961:C:T	29	16	47	13	34	2	0	2
chr12:123533303:G:C	3	0	3	3	0	1	1	0
chr12:123619502:A:G	212	98	327	127	200	1.0	1.0	0.0
chr12:123620139:G:A	45	26	76	22	54	2	0	2
chr12:123671186:C:A	41	9	52	34	18	1	1	0
chr12:123696502:C:T	31	13	44	18	26	1	1	0
chr12:123724785:T:C	91	35	131	57	74	1	1	0
chr12:123744882:T:C	39	17	45	23	22	1	1	0
chr12:123771606:C:T	1	0	1	1	0	1	1	0
chr12:123789927:A:G	1	1	1	0	1	1	0	1
chr12:123796775:T:C	0	0	0	0	0	0	0	0
chr12:123813677:G:T	0	0	0	0	0	0	0	0
chr12:123833327:C:T	0	0	0	0	0	0	0	0
chr12:123929198:G:C	1	0	1	1	0	1	1	0
chr12:123929551:C:T	2	1	3	1	2	1.5	0.5	1.0
chr12:123933342:C:T	2	1	3	1	2	1.5	0.5	1.0
chr12:124314255:C:T	0	0	0	0	0	0	0	0
chr12:124340651:G:A	12	7	22	6	16	2.0	0.0	2.0
chr12:124341916:C:T	36	16	53	21	32	1.0	1.0	0.0
chr12:124344688:C:T	47	23	70	24	46	1	1	0
chr12:124344709:A:G	45	21	66	24	42	1	1	0
chr12:124355353:T:C	0	0	0	0	0	0	0	0
chr12:124355399:T:C	0	0	0	0	0	0	0	0
chr12:124372114:T:A	10	3	15	7	8	1.0	1.0	0.0
chr12:124495287:C:G	64	38	111	31	80	2.0	0.0	2.0
chr12:124786227:A:G	0	0	0	0	0	0	0	0
chr12:124800202:A:G	0	0	0	0	0	0	0	0
chr12:124863717:C:T	0	0	0	0	0	0	0	0
chr12:124952562:C:T	9	5	14	4	10	2	0	2
chr12:124977430:C:T	13	5	19	9	10	1	1	0
chr12:124982612:C:T	32	14	47	19	28	1.0	1.0	0.0
chr12:125076605:A:G	32	13	46	20	26	1.0	1.0	0.0
chr12:125118606:C:T	0	0	0	0	0	0	0	0
chr12:125349549:C:A	0	0	0	0	0	0	0	0
chr12:128415128:A:G	0	0	0	0	0	0	0	0
chr12:128415460:G:A	0	0	0	0	0	0	0	0
chr12:128794319:A:G	29	19	48	10	38	2	0	2
chr12:128808801:C:T	18	9	27	9	18	1.5	0.5	1.0
chr12:128815130:C:G	11	5	16	6	10	1	1	0
chr12:129075012:C:T	0	0	0	0	0	0	0	0
chr12:129081861:C:T	0	0	0	0	0	0	0	0
chr12:130436926:T:C	0	0	0	0	0	0	0	0
chr12:130821769:C:G	135	93	243	49	194	2	0	2
chr12:130969154:A:G	0	0	0	0	0	0	0	0
chr12:130987154:G:A	0	0	0	0	0	0	0	0
chr12:131138190:T:C	0	0	0	0	0	0	0	0
chr12:131799508:G:A	206	98	317	115	202	1.0	1.0	0.0
chr12:131840694:G:A	5	1	6	4	2	1	1	0
chr12:131840831:C:T	4	3	7	1	6	2.0	0.0	2.0
chr12:131841753:G:A	5	3	8	2	6	2	0	2
chr12:131851140:G:A	14	11	26	4	22	2.0	0.0	2.0
chr12:131917021:C:T	7	2	9	5	4	1	1	0
chr12:132141098:C:T	3	0	3	3	0	1	1	0
chr12:132141646:C:T	4	2	6	2	4	1.5	0.5	1.0
chr12:132141880:G:A	15	9	24	6	18	2	0	2
chr12:132286390:G:A	0	0	0	0	0	0	0	0
chr12:132625629:G:A	1	0	1	1	0	1	1	0
chr12:132625842:G:A	2	1	3	1	2	1.5	0.5	1.0
chr12:132643940:T:C	1	1	2	0	2	2	0	2
chr12:132676210:C:G	0	0	0	0	0	0	0	0
chr12:132780826:T:C	22	11	33	11	22	1.5	0.5	1.0
chr12:133203723:G:T	5	1	6	4	2	1	1	0
chr12:133204577:A:G	12	4	16	8	8	1.0	1.0	0.0
chr13:18258542:A:G	0	0	0	0	0	0	0	0
chr13:18261406:A:G	0	0	0	0	0	0	0	0
chr13:18267268:GCG:TCA	0	0	0	0	0	0	0	0
chr13:18279410:T:C	0	0	0	0	0	0	0	0
chr13:18279455:C:T	0	0	0	0	0	0	0	0
chr13:18290575:G:A	0	0	0	0	0	0	0	0
chr13:18290634:A:C	0	0	0	0	0	0	0	0
chr13:18298334:T:C	0	0	0	0	0	0	0	0
chr13:18298387:G:C	0	0	0	0	0	0	0	0
chr13:18666762:G:A	0	0	0	0	0	0	0	0
chr13:19227280:C:T	0	0	0	0	0	0	0	0
chr13:19359308:G:A	0	0	0	0	0	0	0	0
chr13:19359378:T:C	0	0	0	0	0	0	0	0
chr13:19492854:T:C	4	0	4	4	0	1.0	1.0	0.0
chr13:19492871:A:C	4	0	4	4	0	1.0	1.0	0.0
chr13:19650062:G:T	176	81	267	103	164	1.0	1.0	0.0
chr13:20034325:T:C	31	23	55	9	46	2	0	2
chr13:20142272:C:T	0	0	0	0	0	0	0	0
chr13:20223269:A:G	0	0	0	0	0	0	0	0
chr13:20489385:A:G	102	37	142	68	74	1.0	1.0	0.0
chr13:20512460:G:A	111	73	189	41	148	2	0	2
chr13:20721728:A:C	6	4	10	2	8	2.0	0.0	2.0
chr13:20961447:A:G	0	0	0	0	0	0	0	0
chr13:20961698:T:G	0	0	0	0	0	0	0	0
chr13:20961897:A:C	1	0	1	1	0	1	1	0
chr13:20988232:C:T	1	0	1	1	0	1	1	0
chr13:20988809:G:A	1	1	2	0	2	2	0	2
chr13:23324370:T:C	0	0	0	0	0	0	0	0
chr13:23333895:A:G	7	5	12	2	10	2	0	2
chr13:23354956:T:C	5	4	9	1	8	2	0	2
chr13:23355916:A:T	15	12	28	4	24	2	0	2
chr13:23660378:A:G	0	0	0	0	0	0	0	0
chr13:23669061:T:C	0	0	0	0	0	0	0	0
chr13:23891578:A:G	2	0	2	2	0	1.0	1.0	0.0
chr13:23896900:T:G	1	0	1	1	0	1	1	0
chr13:23896909:C:T	1	0	1	1	0	1	1	0
chr13:23897093:A:G	1	0	1	1	0	1	1	0
chr13:24123202:C:A	0	0	0	0	0	0	0	0
chr13:24223982:T:C	1	1	2	0	2	2	0	2
chr13:24249619:G:A	16	6	22	10	12	1.0	1.0	0.0
chr13:24302614:T:C	15	7	23	9	14	2	1	0
chr13:24321421:A:G	0	0	0	0	0	0	0	0
chr13:24321546:A:G	0	0	0	0	0	0	0	0
chr13:24321667:G:A	0	0	0	0	0	0	0	0
chr13:24455080:C:T	38	25	64	14	50	2.0	0.0	2.0
chr13:24455157:C:T	36	13	49	24	25	1.0	1.0	0.0
chr13:24486175:A:G	72	33	111	43	68	1.5	1.0	0.0
chr13:24709416:G:C	0	0	0	0	0	0	0	0
chr13:25365934:T:C	0	0	0	0	0	0	0	0
chr13:25469044:A:C	0	0	0	0	0	0	0	0
chr13:26213977:A:G	27	19	46	8	38	2	0	2
chr13:26400425:G:A	0	0	0	0	0	0	0	0
chr13:27581392:A:T	77	47	129	33	96	2	0	2
chr13:27665833:G:A	425	208	695	253	442	2	1	0
chr13:27792924:A:G	0	0	0	0	0	0	0	0
chr13:29324646:C:T	0	0	0	0	0	0	0	0
chr13:29514470:G:A	4	3	7	1	6	2.0	0.0	2.0
chr13:30744171:C:A	1	1	2	0	2	2	0	2
chr13:31151123:A:G	61	28	89	33	56	1	1	0
chr13:31151595:A:C	1	1	2	0	2	2	0	2
chr13:31154520:T:C	14	3	17	11	6	1.0	1.0	0.0
chr13:31154529:G:A	14	3	17	11	6	1.0	1.0	0.0
chr13:31161622:G:A	316	162	528	184	344	2.0	1.0	2.0
chr13:31317609:G:A	14	4	18	10	8	1.0	1.0	0.0
chr13:31329697:G:T	8	3	11	5	6	1.0	1.0	0.0
chr13:32311517:TGGCG:CGGCA	0	0	0	0	0	0	0	0
chr13:32332592:A:C	63	29	94	34	60	1	1	0
chr13:32338162:T:C	64	33	98	32	66	2.0	0.0	2.0
chr13:32425814:G:C	875	490	1646	530	1116	2	1	2
chr13:33061326:T:C	2	0	2	2	0	1.0	1.0	0.0
chr13:33126237:T:G	0	0	0	0	0	0	0	0
chr13:33129519:T:C	0	0	0	0	0	0	0	0
chr13:33129928:T:C	0	0	0	0	0	0	0	0
chr13:35593292:G:A	4	1	5	3	2	1.0	1.0	0.0
chr13:36227278:C:T	0	0	0	0	0	0	0	0
chr13:37105131:G:T	0	0	0	0	0	0	0	0
chr13:38689594:C:T	0	0	0	0	0	0	0	0
chr13:38880706:G:A	0	0	0	0	0	0	0	0
chr13:40799118:G:A	15	10	27	5	22	2	0	2
chr13:40805136:C:T	11	8	21	3	18	2	0	2
chr13:40941150:T:A	180	91	285	91	194	2.0	0.5	2.0
chr13:40958916:T:C	2981	1996	8491	2726	5765	2	1	2
chr13:41260903:T:C	101	71	179	33	146	2	0	2
chr13:41458436:T:C	619	340	1497	569	928	2	1	2
chr13:41868410:A:G	48	27	76	22	54	2.0	0.0	2.0
chr13:41891577:C:T	93	42	138	54	84	1	1	0
chr13:42190428:C:G	25	12	37	13	24	1	1	0
chr13:42198581:G:T	17	9	28	8	20	2	0	2
chr13:42229205:T:C	25	12	38	14	24	2	1	0
chr13:42574410:C:G	1	0	1	1	0	1	1	0
chr13:42574429:T:C	1	1	2	0	2	2	0	2
chr13:43023729:A:G	1360	687	2683	1050	1633	2.0	1.0	2.0
chr13:43214022:G:A	1	0	1	1	0	1	1	0
chr13:44397367:A:C	0	0	0	0	0	0	0	0
chr13:44989329:G:C	208	108	353	113	240	2.0	0.0	2.0
chr13:45503246:G:A	5	3	8	2	6	2	0	2
chr13:45529800:A:G	12	5	17	7	10	1.0	1.0	0.0
chr13:45702368:G:C	0	0	0	0	0	0	0	0
chr13:45714010:A:G	0	0	0	0	0	0	0	0
chr13:45988800:A:G	68	35	107	33	74	2.0	0.0	2.0
chr13:46082534:A:G	0	0	0	0	0	0	0	0
chr13:46227835:A:G	0	0	0	0	0	0	0	0
chr13:46228042:A:G	0	0	0	0	0	0	0	0
chr13:51084035:T:C	0	0	0	0	0	0	0	0
chr13:51799551:A:G	402	182	629	247	382	1.0	1.0	0.0
chr13:51941218:A:G	0	0	0	0	0	0	0	0
chr13:51946371:C:T	0	0	0	0	0	0	0	0
chr13:51949672:C:T	0	0	0	0	0	0	0	0
chr13:51950352:T:C	0	0	0	0	0	0	0	0
chr13:51970669:C:G	0	0	0	0	0	0	0	0
chr13:51974004:A:C	0	0	0	0	0	0	0	0
chr13:52011412:G:T	0	0	0	0	0	0	0	0
chr13:52028783:A:C	89	37	130	54	76	1	1	0
chr13:52029058:G:T	98	44	149	57	92	1.0	1.0	0.0
chr13:52127501:T:G	2	0	2	2	0	1.0	1.0	0.0
chr13:52133104:C:G	51	29	83	23	60	2	0	2
chr13:52156124:T:A	230	112	367	127	240	2.0	1.0	0.0
chr13:52397758:G:A	0	0	0	0	0	0	0	0
chr13:52703537:T:G	0	0	0	0	0	0	0	0
chr13:52712815:C:T	1	1	2	0	2	2	0	2
chr13:53028835:A:G	0	0	0	0	0	0	0	0
chr13:53034497:C:T	0	0	0	0	0	0	0	0
chr13:63746866:TGGT:CAGC	0	0	0	0	0	0	0	0
chr13:63746877:A:G	0	0	0	0	0	0	0	0
chr13:67228207:A:T	477	210	743	301	442	1	1	0
chr13:72710273:A:T	413	221	688	222	466	2	0	2
chr13:72775941:T:C	137	56	198	84	114	1	1	0
chr13:75481684:G:C	0	0	0	0	0	0	0	0
chr13:75807964:C:T	26	13	41	13	28	1.5	0.5	1.0
chr13:75855175:G:A	7	4	11	3	8	2	0	2
chr13:76953629:T:A	0	0	0	0	0	0	0	0
chr13:76991955:C:T	7	2	9	5	4	1	1	0
chr13:77058335:C:T	106	42	150	66	84	1.0	1.0	0.0
chr13:77164529:A:G	46	21	67	25	42	1.0	1.0	0.0
chr13:77177757:C:T	32	18	56	16	40	2.0	0.0	2.0
chr13:80336716:A:C	77	37	122	44	78	2	1	0
chr13:80337390:G:A	26	12	39	15	24	1.0	1.0	0.0
chr13:95021537:A:C	8	6	14	2	12	2.0	0.0	2.0
chr13:95062722:C:T	8	5	14	4	10	2.0	0.0	2.0
chr13:95074287:A:G	4	3	8	2	6	2.0	0.0	2.0
chr13:95075526:T:C	8	7	15	1	14	2.0	0.0	2.0
chr13:95854410:A:G	9	9	18	0	18	2	0	2
chr13:98385833:C:T	3	2	5	1	4	2	0	2
chr13:99295924:C:A	120	55	195	74	121	1.5	1.0	0.0
chr13:100491777:A:G	7	3	10	4	6	1	1	0
chr13:101715538:G:A	0	0	0	0	0	0	0	0
chr13:102678368:G:A	30	18	51	13	38	2.0	0.0	2.0
chr13:102687015:A:G	0	0	0	0	0	0	0	0
chr13:102731067:T:C	0	0	0	0	0	0	0	0
chr13:102735665:C:G	0	0	0	0	0	0	0	0
chr13:102736414:T:C	0	0	0	0	0	0	0	0
chr13:102736530:T:C	0	0	0	0	0	0	0	0
chr13:102738036:C:A	0	0	0	0	0	0	0	0
chr13:102739255:T:C	1	1	2	0	2	2	0	2
chr13:102745540:G:A	1	0	1	1	0	1	1	0
chr13:102747487:C:A	0	0	0	0	0	0	0	0
chr13:102747683:A:G	0	0	0	0	0	0	0	0
chr13:102747733:G:A	0	0	0	0	0	0	0	0
chr13:102852167:T:C	339	170	541	190	351	2	1	1
chr13:108820385:G:A	0	0	0	0	0	0	0	0
chr13:109055479:T:C	0	0	0	0	0	0	0	0
chr13:109125155:A:G	0	0	0	0	0	0	0	0
chr13:110161362:G:A	0	0	0	0	0	0	0	0
chr13:110166251:T:G	0	0	0	0	0	0	0	0
chr13:110175227:T:A	0	0	0	0	0	0	0	0
chr13:110175233:C:T	0	0	0	0	0	0	0	0
chr13:110181355:C:T	0	0	0	0	0	0	0	0
chr13:110445879:C:T	0	0	0	0	0	0	0	0
chr13:110449695:G:A	0	0	0	0	0	0	0	0
chr13:110449779:C:T	0	0	0	0	0	0	0	0
chr13:110456942:C:G	0	0	0	0	0	0	0	0
chr13:110457535:A:G	0	0	0	0	0	0	0	0
chr13:110462404:G:A	0	0	0	0	0	0	0	0
chr13:110467049:G:C	0	0	0	0	0	0	0	0
chr13:110469273:C:T	0	0	0	0	0	0	0	0
chr13:110503806:G:A	0	0	0	0	0	0	0	0
chr13:110506527:A:G	0	0	0	0	0	0	0	0
chr13:110524046:A:G	6	1	7	5	2	1.0	1.0	0.0
chr13:110634592:C:T	14	7	22	8	14	2.0	0.5	1.0
chr13:110638533:G:A	18	9	29	9	20	1.5	0.5	1.0
chr13:110646045:A:G	299	157	488	156	332	2	0	2
chr13:110667407:T:C	351	167	556	194	362	1	1	0
chr13:111217690:T:C	225	105	338	125	213	1	1	0
chr13:111328190:C:T	5	1	6	4	2	1	1	0
chr13:112679370:C:T	0	0	0	0	0	0	0	0
chr13:112825506:A:G	12	6	18	6	12	1.5	0.5	1.0
chr13:112854525:G:C	26	7	35	21	14	1.0	1.0	0.0
chr13:112858017:C:T	10	5	15	5	10	1.5	0.5	1.0
chr13:112873653:G:A	91	39	138	54	84	1	1	0
chr13:112876008:G:A	73	50	123	24	99	2	0	2
chr13:112881818:T:C	4	1	5	3	2	1.0	1.0	0.0
chr13:113045359:G:A	3	2	5	1	4	2	0	2
chr13:113066162:C:T	0	0	0	0	0	0	0	0
chr13:113074467:G:A	0	0	0	0	0	0	0	0
chr13:113084811:C:T	0	0	0	0	0	0	0	0
chr13:113096272:G:A	0	0	0	0	0	0	0	0
chr13:113243006:C:T	41	19	61	23	38	1	1	0
chr13:113255025:A:G	39	12	55	29	26	1	1	0
chr13:113325565:G:A	6	4	10	2	8	2.0	0.0	2.0
chr13:113403397:G:A	0	0	0	0	0	0	0	0
chr13:113403507:G:A	0	0	0	0	0	0	0	0
chr13:113404569:T:C	0	0	0	0	0	0	0	0
chr13:113457972:C:A	5	4	9	1	8	2	0	2
chr13:113495792:C:T	226	114	364	118	246	2.0	1.0	2.0
chr13:113520723:G:A	11	5	16	6	10	1	1	0
chr13:113649449:C:T	0	0	0	0	0	0	0	0
chr13:113654911:G:A	0	0	0	0	0	0	0	0
chr13:113667974:A:G	0	0	0	0	0	0	0	0
chr13:113799443:T:C	0	0	0	0	0	0	0	0
chr13:113979298:G:A	19	11	30	8	22	2	0	2
chr13:114015288:A:G	10	2	12	8	4	1.0	1.0	0.0
chr13:114244855:G:T	28	16	44	12	32	2.0	0.0	2.0
chr14:19827845:C:T	0	0	0	0	0	0	0	0
chr14:19827851:G:C	0	0	0	0	0	0	0	0
chr14:19868429:G:A	0	0	0	0	0	0	0	0
chr14:19935932:G:A	0	0	0	0	0	0	0	0
chr14:19936455:C:A	0	0	0	0	0	0	0	0
chr14:19975867:T:G	0	0	0	0	0	0	0	0
chr14:19976034:A:C	0	0	0	0	0	0	0	0
chr14:19976282:C:A	0	0	0	0	0	0	0	0
chr14:19976331:C:T	0	0	0	0	0	0	0	0
chr14:19976429:T:C	0	0	0	0	0	0	0	0
chr14:19976448:C:G	0	0	0	0	0	0	0	0
chr14:20002240:G:A	0	0	0	0	0	0	0	0
chr14:20033961:C:T	0	0	0	0	0	0	0	0
chr14:20060860:C:T	0	0	0	0	0	0	0	0
chr14:20060884:C:G	0	0	0	0	0	0	0	0
chr14:20117883:G:C	0	0	0	0	0	0	0	0
chr14:20301877:T:C	190	99	293	95	198	2.0	0.0	2.0
chr14:20316559:G:T	643	358	1143	353	790	2	1	2
chr14:20356022:T:C	43	24	71	19	52	2	0	2
chr14:20357203:G:A	4	1	5	3	2	1.0	1.0	0.0
chr14:20391046:C:T	7	2	9	5	4	1	1	0
chr14:20428905:C:T	0	0	0	0	0	0	0	0
chr14:20448090:T:C	2	1	3	1	2	1.5	0.5	1.0
chr14:20448799:T:C	285	144	475	165	310	2	1	2
chr14:20449283:A:T	14	9	23	5	18	2.0	0.0	2.0
chr14:20452091:T:C	708	431	1309	364	945	2.0	0.0	2.0
chr14:20452181:A:G	312	175	509	153	356	2.0	0.0	2.0
chr14:20556446:G:A	0	0	0	0	0	0	0	0
chr14:20556460:A:G	0	0	0	0	0	0	0	0
chr14:20558614:C:T	0	0	0	0	0	0	0	0
chr14:20641119:A:T	0	0	0	0	0	0	0	0
chr14:20641226:C:T	0	0	0	0	0	0	0	0
chr14:20641512:A:G	0	0	0	0	0	0	0	0
chr14:20641567:G:A	0	0	0	0	0	0	0	0
chr14:20641586:C:G	0	0	0	0	0	0	0	0
chr14:20693894:T:G	66	44	122	26	96	2.0	0.0	2.0
chr14:20699417:A:T	73	49	122	24	98	2	0	2
chr14:20722147:A:T	0	0	0	0	0	0	0	0
chr14:20770159:G:A	0	0	0	0	0	0	0	0
chr14:20770639:T:C	0	0	0	0	0	0	0	0
chr14:20781965:G:A	234	198	511	47	464	2.0	0.0	2.0
chr14:20782053:T:C	237	202	520	46	474	2	0	2
chr14:20892057:C:G	0	0	0	0	0	0	0	0
chr14:20892185:G:C	0	0	0	0	0	0	0	0
chr14:21030895:G:A	0	0	0	0	0	0	0	0
chr14:21031962:G:T	0	0	0	0	0	0	0	0
chr14:21034186:A:G	0	0	0	0	0	0	0	0
chr14:21092547:C:G	5	0	5	5	0	1	1	0
chr14:21103049:G:T	1	1	2	0	2	2	0	2
chr14:21103064:G:C	1	0	1	1	0	1	1	0
chr14:21302522:A:G	1	1	2	0	2	2	0	2
chr14:21477256:A:G	1202	675	2183	697	1486	2.0	1.0	2.0
chr14:21477470:C:T	213	116	351	109	242	2	0	2
chr14:21492657:T:C	61	31	95	31	64	2	1	2
chr14:21492810:G:A	56	25	86	32	54	1.0	1.0	0.0
chr14:21498965:T:G	62	38	107	29	78	2.0	0.0	2.0
chr14:21503586:C:G	26	16	42	10	32	2.0	0.0	2.0
chr14:21523492:G:C	0	0	0	0	0	0	0	0
chr14:21569994:C:T	0	0	0	0	0	0	0	0
chr14:21570031:A:C	0	0	0	0	0	0	0	0
chr14:21570394:G:T	0	0	0	0	0	0	0	0
chr14:21602359:A:G	0	0	0	0	0	0	0	0
chr14:21665434:A:G	0	0	0	0	0	0	0	0
chr14:21665783:G:A	0	0	0	0	0	0	0	0
chr14:21670115:A:G	0	0	0	0	0	0	0	0
chr14:21670224:G:A	0	0	0	0	0	0	0	0
chr14:22575102:T:G	2995	2139	8651	2451	6200	2	1	2
chr14:22598387:G:A	4	3	7	1	6	2.0	0.0	2.0
chr14:22634064:A:G	0	0	0	0	0	0	0	0
chr14:22634639:A:G	0	0	0	0	0	0	0	0
chr14:22766488:C:T	97	51	161	47	114	2	0	2
chr14:22766599:G:A	4	0	4	4	0	1.0	1.0	0.0
chr14:22767315:C:T	340	175	561	188	373	2.0	1.0	2.0
chr14:22770303:A:G	47	23	70	24	46	1	1	0
chr14:22813127:G:A	19	4	23	15	8	1	1	0
chr14:22813240:C:T	19	4	23	15	8	1	1	0
chr14:22830077:T:C	1308	729	2613	873	1740	2.0	1.0	2.0
chr14:22833376:T:A	20	11	32	10	22	2.0	0.0	2.0
chr14:23043134:A:G	0	0	0	0	0	0	0	0
chr14:23049709:T:C	2	1	3	1	2	1.5	0.5	1.0
chr14:23080076:G:A	63	32	98	32	66	2	1	2
chr14:23127111:A:G	0	0	0	0	0	0	0	0
chr14:23129743:A:G	0	0	0	0	0	0	0	0
chr14:23276324:C:T	18	10	28	8	20	2.0	0.0	2.0
chr14:23387854:G:A	0	0	0	0	0	0	0	0
chr14:23392602:A:G	0	0	0	0	0	0	0	0
chr14:23405298:G:T	0	0	0	0	0	0	0	0
chr14:23405314:C:T	0	0	0	0	0	0	0	0
chr14:23412741:C:T	0	0	0	0	0	0	0	0
chr14:23423679:A:G	0	0	0	0	0	0	0	0
chr14:23429851:G:A	0	0	0	0	0	0	0	0
chr14:23431585:G:A	0	0	0	0	0	0	0	0
chr14:23521896:G:A	0	0	0	0	0	0	0	0
chr14:23523533:T:G	0	0	0	0	0	0	0	0
chr14:23525308:A:G	0	0	0	0	0	0	0	0
chr14:23533678:G:T	0	0	0	0	0	0	0	0
chr14:23557284:A:G	89	62	155	29	126	2	0	2
chr14:23563861:C:T	4	4	10	0	10	2.0	0.0	2.0
chr14:23988953:G:C	246	189	474	62	412	2.0	0.0	2.0
chr14:23989123:T:G	13	11	24	2	22	2	0	2
chr14:23990284:G:A	303	225	572	87	485	2	0	2
chr14:23990311:T:C	303	228	578	84	494	2	0	2
chr14:24000929:C:T	29	10	40	20	20	1	1	0
chr14:24037801:C:A	0	0	0	0	0	0	0	0
chr14:24064330:C:A	0	0	0	0	0	0	0	0
chr14:24065572:G:A	0	0	0	0	0	0	0	0
chr14:24076157:T:C	0	0	0	0	0	0	0	0
chr14:24076166:C:T	0	0	0	0	0	0	0	0
chr14:24076626:C:T	0	0	0	0	0	0	0	0
chr14:24103603:G:A	129	69	200	62	138	2	0	2
chr14:24118458:C:T	68	32	103	37	66	1.0	1.0	0.0
chr14:24148029:C:T	16	11	27	5	22	2.0	0.0	2.0
chr14:24210671:C:T	1360	751	2740	952	1788	2.0	1.0	2.0
chr14:24213652:T:G	62	33	101	31	70	2.0	0.0	2.0
chr14:24259088:G:T	2	2	4	0	4	2.0	0.0	2.0
chr14:24266821:G:A	84	40	138	50	88	2.0	1.0	0.0
chr14:24267755:T:C	77	37	124	46	78	2	1	0
chr14:24267997:A:T	1	0	1	1	0	1	1	0
chr14:24271066:G:A	3	1	4	2	2	1	1	0
chr14:24291602:C:T	110	53	173	59	114	1.0	1.0	0.0
chr14:24300457:T:G	11	9	20	2	18	2	0	2
chr14:24302079:G:A	2	1	3	1	2	1.5	0.5	1.0
chr14:24304181:T:C	30	13	43	17	26	1.0	1.0	0.0
chr14:24307563:G:T	9	7	20	4	16	2	0	2
chr14:24330081:A:T	0	0	0	0	0	0	0	0
chr14:24330372:C:G	0	0	0	0	0	0	0	0
chr14:24332750:G:C	29	14	44	16	28	2	1	0
chr14:24369415:C:T	0	0	0	0	0	0	0	0
chr14:24369877:G:C	0	0	0	0	0	0	0	0
chr14:24369959:C:T	0	0	0	0	0	0	0	0
chr14:24374414:T:C	0	0	0	0	0	0	0	0
chr14:24374493:C:T	0	0	0	0	0	0	0	0
chr14:24376635:T:C	0	0	0	0	0	0	0	0
chr14:24377755:G:T	0	0	0	0	0	0	0	0
chr14:24429350:G:C	7	1	10	8	2	1	1	0
chr14:24429352:C:T	8	6	18	2	16	2.0	0.0	2.0
chr14:30874833:A:G	6	2	8	4	4	1.0	1.0	0.0
chr14:31109556:C:T	18	7	25	11	14	1.0	1.0	0.0
chr14:31129042:A:G	20	11	31	9	22	2.0	0.0	2.0
chr14:31178035:G:A	754	406	1250	404	846	2.0	1.0	2.0
chr14:31295920:T:C	21	7	28	14	14	1	1	0
chr14:31349841:C:T	4	3	7	1	6	2.0	0.0	2.0
chr14:31483548:G:A	0	0	0	0	0	0	0	0
chr14:32545808:G:A	0	0	0	0	0	0	0	0
chr14:34516439:G:A	667	355	1123	371	752	2	1	2
chr14:34753526:C:T	74	28	114	52	62	1.0	1.0	0.0
chr14:34758674:G:T	6	2	8	4	4	1.0	1.0	0.0
chr14:34761902:A:T	47	27	80	20	60	2	0	2
chr14:34771458:C:G	16	9	25	7	18	2.0	0.0	2.0
chr14:35308152:T:G	57	28	86	31	55	2	1	0
chr14:35313094:C:G	50	30	80	20	60	2.0	0.0	2.0
chr14:35314500:G:A	10	2	13	9	4	1.0	1.0	0.0
chr14:35402754:G:A	76	31	113	47	66	1.0	1.0	0.0
chr14:35403101:C:T	45	20	65	25	40	1	1	0
chr14:35403720:G:A	1105	631	2488	842	1646	2	1	2
chr14:36582429:G:C	0	0	0	0	0	0	0	0
chr14:36662788:G:C	4	4	8	0	8	2.0	0.0	2.0
chr14:36662843:A:G	7	7	14	0	14	2	0	2
chr14:36662856:A:G	7	7	14	0	14	2	0	2
chr14:36666547:C:T	158	140	313	19	294	2.0	0.0	2.0
chr14:37591441:C:T	0	0	0	0	0	0	0	0
chr14:37591563:G:A	0	0	0	0	0	0	0	0
chr14:37592537:C:T	0	0	0	0	0	0	0	0
chr14:37622820:GAG:CTC	0	0	0	0	0	0	0	0
chr14:38210268:C:T	0	0	0	0	0	0	0	0
chr14:39114277:A:G	17	2	19	15	4	1	1	0
chr14:39175294:G:A	3084	2177	9465	2990	6475	2.0	1.0	2.0
chr14:39247604:T:C	0	0	0	0	0	0	0	0
chr14:44506307:C:T	0	0	0	0	0	0	0	0
chr14:49851569:G:C	1492	851	2920	940	1980	2.0	1.0	2.0
chr14:50116365:G:T	413	244	713	191	522	2	0	2
chr14:50118530:C:T	47	26	74	22	52	2	0	2
chr14:50150160:G:A	50	25	79	27	52	2.0	0.5	1.0
chr14:50725941:G:A	38	23	65	17	48	2.0	0.0	2.0
chr14:50738278:C:T	141	74	231	75	156	2	0	2
chr14:50757071:C:T	37	13	54	26	28	1	1	0
chr14:50757699:G:C	18	7	25	11	14	1.0	1.0	0.0
chr14:50770983:A:G	152	79	244	78	166	2.0	0.0	2.0
chr14:50904066:G:C	0	0	0	0	0	0	0	0
chr14:50916714:G:A	0	0	0	0	0	0	0	0
chr14:50977250:C:T	0	0	0	0	0	0	0	0
chr14:51715363:T:A	0	0	0	0	0	0	0	0
chr14:51720248:G:A	0	0	0	0	0	0	0	0
chr14:52008003:C:T	7	3	10	4	6	1	1	0
chr14:52011597:A:G	30	17	49	13	36	2.0	0.0	2.0
chr14:52042783:T:C	0	0	0	0	0	0	0	0
chr14:52053650:C:T	0	0	0	0	0	0	0	0
chr14:52068930:G:T	0	0	0	0	0	0	0	0
chr14:53950804:A:G	0	0	0	0	0	0	0	0
chr14:53951878:G:A	0	0	0	0	0	0	0	0
chr14:53991565:C:A	0	0	0	0	0	0	0	0
chr14:54788955:C:T	6	2	8	4	4	1.0	1.0	0.0
chr14:55138318:A:C	273	246	694	57	637	2	0	2
chr14:55350990:T:C	22	15	37	7	30	2.0	0.0	2.0
chr14:55351799:T:A	7	3	10	4	6	1	1	0
chr14:55351988:T:C	6	2	8	4	4	1.0	1.0	0.0
chr14:55440454:C:G	0	0	0	0	0	0	0	0
chr14:56609202:G:T	48	26	75	23	52	2.0	0.0	2.0
chr14:57231595:C:T	158	83	250	81	169	2.0	0.0	2.0
chr14:57471406:C:T	0	0	0	0	0	0	0	0
chr14:57581424:A:G	4	3	7	1	6	2.0	0.0	2.0
chr14:57581449:G:T	3	3	6	0	6	2	0	2
chr14:58096976:G:C	0	0	0	0	0	0	0	0
chr14:58139072:G:A	0	0	0	0	0	0	0	0
chr14:58646278:C:T	1	1	2	0	2	2	0	2
chr14:59263735:G:A	4	1	5	3	2	1.0	1.0	0.0
chr14:60397865:G:T	4	0	4	4	0	1.0	1.0	0.0
chr14:60509819:C:A	0	0	0	0	0	0	0	0
chr14:60982449:T:C	4	3	7	1	6	2.0	0.0	2.0
chr14:60982610:T:A	106	48	164	64	100	1.5	1.0	0.0
chr14:61996048:T:C	0	0	0	0	0	0	0	0
chr14:61996411:G:T	0	0	0	0	0	0	0	0
chr14:61996496:C:T	0	0	0	0	0	0	0	0
chr14:63269236:T:G	0	0	0	0	0	0	0	0
chr14:64146127:C:T	61	32	93	29	64	2	0	2
chr14:64146140:C:A	61	32	93	29	64	2	0	2
chr14:64158626:T:C	49	24	78	28	50	2	1	0
chr14:64170429:C:A	202	79	304	138	166	1.0	1.0	0.0
chr14:64190137:T:C	104	72	185	35	150	2.0	0.0	2.0
chr14:64209380:A:G	7	4	11	3	8	2	0	2
chr14:64214475:C:T	23	6	30	18	12	1	1	0
chr14:64216213:G:A	10	3	13	7	6	1.0	1.0	0.0
chr14:64219407:G:T	120	48	174	76	98	1.0	1.0	0.0
chr14:64541533:C:T	0	0	0	0	0	0	0	0
chr14:64588140:T:C	0	0	0	0	0	0	0	0
chr14:64743191:G:A	0	0	0	0	0	0	0	0
chr14:64774510:A:G	0	0	0	0	0	0	0	0
chr14:64775326:C:T	0	0	0	0	0	0	0	0
chr14:64795375:C:T	0	0	0	0	0	0	0	0
chr14:66012934:G:T	3	3	6	0	6	2	0	2
chr14:66498482:G:A	0	0	0	0	0	0	0	0
chr14:67557417:A:T	0	0	0	0	0	0	0	0
chr14:67562596:G:A	0	0	0	0	0	0	0	0
chr14:67571980:C:G	0	0	0	0	0	0	0	0
chr14:67574344:G:A	0	0	0	0	0	0	0	0
chr14:67575538:A:G	0	0	0	0	0	0	0	0
chr14:67579885:C:T	0	0	0	0	0	0	0	0
chr14:67600244:T:C	318	172	515	155	360	2.0	0.0	2.0
chr14:67692909:G:A	22	9	32	14	18	1.0	1.0	0.0
chr14:67727014:G:A	1	0	1	1	0	1	1	0
chr14:68610971:G:A	14	7	25	9	16	2.0	0.5	1.0
chr14:68610982:T:A	8	4	12	4	8	1.5	0.5	1.0
chr14:68792945:C:A	247	128	407	136	271	2	1	2
chr14:68878930:C:T	0	0	0	0	0	0	0	0
chr14:68885513:G:A	0	0	0	0	0	0	0	0
chr14:69054628:G:A	118	63	189	59	130	2.0	0.0	2.0
chr14:69236441:A:G	0	0	0	0	0	0	0	0
chr14:69237836:G:T	2	1	3	1	2	1.5	0.5	1.0
chr14:69333089:C:T	1	0	1	1	0	1	1	0
chr14:70247141:T:C	0	0	0	0	0	0	0	0
chr14:70457790:A:C	1	1	4	0	4	4	0	4
chr14:70458135:A:C	0	0	0	0	0	0	0	0
chr14:70459101:T:C	0	0	0	0	0	0	0	0
chr14:70642436:C:G	48	37	86	12	74	2.0	0.0	2.0
chr14:70732735:G:A	4	3	7	1	6	2.0	0.0	2.0
chr14:70738256:C:T	1	1	2	0	2	2	0	2
chr14:70907985:G:A	417	250	727	191	536	2	0	2
chr14:70978071:G:A	18	8	26	10	16	1.0	1.0	0.0
chr14:71702413:T:C	16	7	24	10	14	1.5	1.0	0.0
chr14:72753312:A:G	2	2	4	0	4	2.0	0.0	2.0
chr14:72938044:G:C	79	32	119	53	66	1	1	0
chr14:72942975:C:G	16	10	27	7	20	2.0	0.0	2.0
chr14:72955551:C:G	16	7	23	9	14	1.0	1.0	0.0
chr14:72958754:G:A	27	16	45	11	34	2	0	2
chr14:72981875:G:A	25	14	43	11	32	2	0	2
chr14:73024599:C:A	50	24	75	27	48	1.5	1.0	0.0
chr14:73250066:G:A	5	3	8	2	6	2	0	2
chr14:73260801:T:G	1	1	2	0	2	2	0	2
chr14:73268658:C:T	3	2	5	1	4	2	0	2
chr14:73491671:T:C	14	10	26	4	22	2.0	0.0	2.0
chr14:73492108:T:C	12	8	20	4	16	2.0	0.0	2.0
chr14:73523155:C:T	5	4	11	1	10	2	0	2
chr14:73595264:T:C	39	30	69	9	60	2	0	2
chr14:73617142:C:T	1	0	1	1	0	1	1	0
chr14:73729983:T:C	21	11	32	10	22	2	0	2
chr14:73730089:T:C	0	0	0	0	0	0	0	0
chr14:73737086:G:A	19	8	27	11	16	1	1	0
chr14:73739175:C:T	18	9	29	9	20	1.5	0.5	1.0
chr14:73739778:T:C	21	9	33	13	20	1	1	0
chr14:73739955:G:A	23	9	35	15	20	1	1	0
chr14:73903897:G:C	11	5	16	6	10	1	1	0
chr14:73950242:G:C	34	24	59	11	48	2.0	0.0	2.0
chr14:73974981:G:A	7	4	11	3	8	2	0	2
chr14:74047971:A:T	7	4	11	3	8	2	0	2
chr14:74049794:G:A	2	1	4	2	2	2.0	1.0	1.0
chr14:74071605:T:C	2	2	4	0	4	2.0	0.0	2.0
chr14:74502565:C:T	0	0	0	0	0	0	0	0
chr14:74778665:C:T	19	7	28	12	16	1	1	0
chr14:74781966:G:T	20	12	34	8	26	2.0	0.0	2.0
chr14:74892967:G:A	21	11	34	10	24	2	0	2
chr14:74907310:A:G	0	0	0	0	0	0	0	0
chr14:74911482:G:A	2	1	3	1	2	1.5	0.5	1.0
chr14:74919873:G:A	0	0	0	0	0	0	0	0
chr14:74921480:C:T	0	0	0	0	0	0	0	0
chr14:75278923:C:T	572	364	1293	357	936	2.0	0.0	2.0
chr14:75279987:C:T	512	324	1115	312	803	2.0	0.0	2.0
chr14:75437957:A:G	162	84	255	83	172	2.0	0.0	2.0
chr14:75690266:C:T	12	7	20	5	15	1.5	0.0	1.5
chr14:75863838:G:A	11	5	17	7	10	2	1	0
chr14:76866065:T:C	0	0	0	0	0	0	0	0
chr14:77026548:G:A	3	1	4	2	2	1	1	0
chr14:77251783:C:T	0	0	0	0	0	0	0	0
chr14:77277301:G:A	11	4	16	8	8	1	1	0
chr14:77279769:T:C	3	1	4	2	2	1	1	0
chr14:77299682:GGA:AGG	1	0	1	1	0	1	1	0
chr14:77301039:A:G	0	0	0	0	0	0	0	0
chr14:77326864:G:A	356	215	661	179	482	2.0	0.0	2.0
chr14:77327849:C:T	2	1	3	1	2	1.5	0.5	1.0
chr14:77329295:G:A	1	0	1	1	0	1	1	0
chr14:77330298:G:A	1	0	1	1	0	1	1	0
chr14:77377471:T:C	20	11	32	10	22	2.0	0.0	2.0
chr14:77377628:C:T	21	11	33	11	22	2	0	2
chr14:77377922:G:A	20	9	30	12	18	1.5	1.0	0.0
chr14:77378249:T:A	12	3	15	9	6	1.0	1.0	0.0
chr14:77378778:A:G	0	0	0	0	0	0	0	0
chr14:77413962:C:T	4	4	8	0	8	2.0	0.0	2.0
chr14:77459668:C:T	661	360	1174	380	794	2	1	2
chr14:77469177:G:A	631	362	1149	347	802	2	1	2
chr14:77521615:C:A	7	1	8	6	2	1	1	0
chr14:77557176:C:G	2	1	3	1	2	1.5	0.5	1.0
chr14:77562460:A:G	49	25	76	26	50	2	1	2
chr14:77718223:C:A	133	70	207	65	142	2	0	2
chr14:77731022:C:T	157	82	248	78	170	2	0	2
chr14:78988176:G:C	0	0	0	0	0	0	0	0
chr14:80504918:C:T	3	3	6	0	6	2	0	2
chr14:80784911:T:C	9	0	9	9	0	1	1	0
chr14:80955834:C:A	0	0	0	0	0	0	0	0
chr14:81144239:G:C	1	1	2	0	2	2	0	2
chr14:81270732:A:C	1	0	1	1	0	1	1	0
chr14:81277374:C:T	0	0	0	0	0	0	0	0
chr14:87993491:C:A	8	4	12	4	8	1.5	0.5	1.0
chr14:88011069:C:T	43	25	70	20	50	2	0	2
chr14:88011538:A:C	29	21	50	8	42	2	0	2
chr14:88185618:C:T	1	0	1	1	0	1	1	0
chr14:88186045:C:T	1	1	2	0	2	2	0	2
chr14:88227381:G:C	0	0	0	0	0	0	0	0
chr14:88469910:A:G	0	0	0	0	0	0	0	0
chr14:88738921:T:C	2	0	2	2	0	1.0	1.0	0.0
chr14:90185013:G:A	0	0	0	0	0	0	0	0
chr14:90286410:G:A	13	4	17	9	8	1	1	0
chr14:90617994:C:T	1	0	1	1	0	1	1	0
chr14:91170051:C:T	11	4	15	7	8	1	1	0
chr14:91170188:C:T	9	2	11	7	4	1	1	0
chr14:91175890:A:G	1	0	1	1	0	1	1	0
chr14:91215577:G:A	17	7	24	10	14	1	1	0
chr14:91278005:G:T	12	7	20	6	14	2.0	0.0	2.0
chr14:91307224:T:C	17	5	22	12	10	1	1	0
chr14:91408612:T:C	9	6	15	3	12	2	0	2
chr14:91416785:G:A	808	417	1403	501	902	2.0	1.0	2.0
chr14:91458683:G:T	247	127	393	133	260	2	1	1
chr14:91785243:A:G	0	0	0	0	0	0	0	0
chr14:91881336:A:G	0	0	0	0	0	0	0	0
chr14:91974722:C:T	58	25	87	35	52	1.0	1.0	0.0
chr14:92082441:C:T	320	150	520	196	324	2.0	1.0	0.0
chr14:92083242:G:A	327	157	536	196	340	2	1	0
chr14:92093664:G:A	62	32	102	32	70	2.0	0.0	2.0
chr14:92454027:C:T	0	0	0	0	0	0	0	0
chr14:92456556:G:A	0	0	0	0	0	0	0	0
chr14:92652323:C:T	30	16	46	14	32	2.0	0.0	2.0
chr14:92732735:C:T	4	4	8	0	8	2.0	0.0	2.0
chr14:92810309:T:C	69	30	103	41	62	1	1	0
chr14:92938329:T:C	2	1	3	1	2	1.5	0.5	1.0
chr14:93183156:A:G	57	22	80	36	44	1	1	0
chr14:93227076:C:T	48	32	82	16	66	2.0	0.0	2.0
chr14:93243047:C:T	12	5	17	7	10	1.0	1.0	0.0
chr14:93477652:G:A	0	0	0	0	0	0	0	0
chr14:93540729:C:T	0	0	0	0	0	0	0	0
chr14:93603342:C:T	0	0	0	0	0	0	0	0
chr14:93622241:G:A	0	0	0	0	0	0	0	0
chr14:93637256:G:A	0	0	0	0	0	0	0	0
chr14:93925353:G:A	0	0	0	0	0	0	0	0
chr14:93928369:C:T	0	0	0	0	0	0	0	0
chr14:93956948:T:C	0	0	0	0	0	0	0	0
chr14:93956981:T:A	0	0	0	0	0	0	0	0
chr14:93998086:A:G	0	0	0	0	0	0	0	0
chr14:94044618:T:C	5	4	9	1	8	2	0	2
chr14:94096847:T:C	2	1	3	1	2	1.5	0.5	1.0
chr14:94111816:G:T	0	0	0	0	0	0	0	0
chr14:94111842:C:A	0	0	0	0	0	0	0	0
chr14:94128431:T:G	7	3	10	4	6	1	1	0
chr14:94290457:T:C	0	0	0	0	0	0	0	0
chr14:94306092:G:A	0	0	0	0	0	0	0	0
chr14:94378506:T:G	0	0	0	0	0	0	0	0
chr14:94382864:C:T	0	0	0	0	0	0	0	0
chr14:94446462:G:A	0	0	0	0	0	0	0	0
chr14:94446559:T:G	0	0	0	0	0	0	0	0
chr14:94469564:G:C	0	0	0	0	0	0	0	0
chr14:94469773:G:A	0	0	0	0	0	0	0	0
chr14:94476241:C:T	0	0	0	0	0	0	0	0
chr14:94476326:C:A	0	0	0	0	0	0	0	0
chr14:94563515:G:T	0	0	0	0	0	0	0	0
chr14:94587553:G:A	0	0	0	0	0	0	0	0
chr14:94587839:T:C	0	0	0	0	0	0	0	0
chr14:94592294:A:T	0	0	0	0	0	0	0	0
chr14:94614744:A:G	0	0	0	0	0	0	0	0
chr14:94619128:C:G	0	0	0	0	0	0	0	0
chr14:95417986:G:A	24	13	37	11	26	2.0	0.0	2.0
chr14:95690850:G:A	41	18	60	24	36	1	1	0
chr14:96362953:G:A	84	42	129	43	86	1.5	1.0	1.0
chr14:96385734:T:C	31	14	46	18	28	1	1	0
chr14:99865539:T:C	0	0	0	0	0	0	0	0
chr14:99914611:T:C	0	0	0	0	0	0	0	0
chr14:100146756:C:T	60	23	89	41	48	1.0	1.0	0.0
chr14:100149624:C:T	31	16	48	16	32	2	0	2
chr14:100292709:C:A	55	19	74	36	38	1	1	0
chr14:100292940:C:T	52	19	71	33	38	1.0	1.0	0.0
chr14:100328802:G:T	1	0	1	1	0	1	1	0
chr14:100381370:A:G	23	11	36	12	24	1	1	0
chr14:100381593:A:G	14	9	23	5	18	2.0	0.0	2.0
chr14:100734308:T:C	0	0	0	0	0	0	0	0
chr14:101997070:A:G	33	16	49	17	32	1	1	0
chr14:102027424:A:G	62	33	98	32	66	2.0	0.0	2.0
chr14:102033907:G:T	7	3	10	4	6	1	1	0
chr14:102044091:A:G	3	2	5	1	4	2	0	2
chr14:102048098:T:G	0	0	0	0	0	0	0	0
chr14:102082366:T:G	769	432	1434	452	982	2	1	2
chr14:102101959:G:A	79	45	130	38	92	2	0	2
chr14:102102030:T:A	79	45	131	37	94	2	0	2
chr14:102209013:G:C	83	44	129	39	90	2	0	2
chr14:102229226:A:G	194	0	207	207	0	1.0	1.0	0.0
chr14:102229356:T:C	185	0	196	196	0	1	1	0
chr14:102229729:G:A	1	0	1	1	0	1	1	0
chr14:102283421:C:T	2	0	4	4	0	2.0	2.0	0.0
chr14:102341993:C:T	43	19	63	25	38	1	1	0
chr14:102348608:G:A	277	135	463	163	300	2	1	0
chr14:102348705:C:T	279	154	482	150	332	2	0	2
chr14:102434864:A:G	1	1	2	0	2	2	0	2
chr14:102498317:A:G	2	1	3	1	2	1.5	0.5	1.0
chr14:102922662:TGGTG:CGGTC	30	25	55	5	50	2.0	0.0	2.0
chr14:103086061:G:A	0	0	0	0	0	0	0	0
chr14:103100567:G:A	0	0	0	0	0	0	0	0
chr14:103103844:TC:TG	0	0	0	0	0	0	0	0
chr14:103110058:G:A	0	0	0	0	0	0	0	0
chr14:103110078:A:G	0	0	0	0	0	0	0	0
chr14:103374567:C:G	0	0	0	0	0	0	0	0
chr14:103561933:T:C	70	32	108	40	68	1.0	1.0	0.0
chr14:103563112:G:A	626	350	1110	344	766	2.0	1.0	2.0
chr14:103685063:C:T	28	13	43	15	28	1.0	1.0	0.0
chr14:103701208:G:A	228	126	373	109	264	2.0	0.0	2.0
chr14:103986303:G:A	0	0	0	0	0	0	0	0
chr14:104031206:C:T	0	0	0	0	0	0	0	0
chr14:104052116:A:G	0	0	0	0	0	0	0	0
chr14:104166890:A:C	0	0	0	0	0	0	0	0
chr14:104173182:C:G	0	0	0	0	0	0	0	0
chr14:104173761:G:A	0	0	0	0	0	0	0	0
chr14:104175455:C:T	0	0	0	0	0	0	0	0
chr14:104175814:C:T	0	0	0	0	0	0	0	0
chr14:104176187:C:T	0	0	0	0	0	0	0	0
chr14:104177084:T:C	0	0	0	0	0	0	0	0
chr14:104177384:C:A	0	0	0	0	0	0	0	0
chr14:104177762:T:C	0	0	0	0	0	0	0	0
chr14:104177810:C:T	0	0	0	0	0	0	0	0
chr14:104177875:A:G	0	0	0	0	0	0	0	0
chr14:104708385:G:A	0	0	0	0	0	0	0	0
chr14:104714228:T:C	12	4	16	8	8	1.0	1.0	0.0
chr14:104714448:C:T	19	12	31	7	24	2	0	2
chr14:104729893:A:C	0	0	0	0	0	0	0	0
chr14:104729898:G:A	0	0	0	0	0	0	0	0
chr14:104730028:T:C	0	0	0	0	0	0	0	0
chr14:104747006:A:G	3	0	3	3	0	1	1	0
chr14:104755700:C:T	1711	1069	3522	1056	2466	2	1	2
chr14:104772267:C:T	21	10	32	12	20	2	1	0
chr14:104773557:C:T	25	7	32	18	14	1	1	0
chr14:104775891:T:C	0	0	0	0	0	0	0	0
chr14:104776629:T:C	4	2	6	2	4	1.5	0.5	1.0
chr14:104801597:G:A	4	4	8	0	8	2.0	0.0	2.0
chr14:104801767:G:A	4	3	7	1	6	2.0	0.0	2.0
chr14:104877956:C:T	0	0	0	0	0	0	0	0
chr14:104878486:G:A	0	0	0	0	0	0	0	0
chr14:104880295:G:A	0	0	0	0	0	0	0	0
chr14:104884018:A:G	0	0	0	0	0	0	0	0
chr14:104950501:CG:AT	0	0	0	0	0	0	0	0
chr14:104950535:T:C	0	0	0	0	0	0	0	0
chr14:104954590:A:G	0	0	0	0	0	0	0	0
chr14:104954713:T:G	0	0	0	0	0	0	0	0
chr14:105247112:C:T	0	0	0	0	0	0	0	0
chr14:105249697:C:T	20	10	33	11	22	2.0	0.5	1.0
chr14:105256389:T:C	15	6	21	9	12	1	1	0
chr14:105392676:G:A	74	30	106	44	62	1.0	1.0	0.0
chr14:105463408:C:T	1	1	2	0	2	2	0	2
chr14:105464069:G:A	21	12	33	9	24	2	0	2
chr14:105464586:G:A	3	2	5	1	4	2	0	2
chr14:105488345:C:G	3610	2656	34238	13391	20847	5.0	2.0	2.0
chr14:105493850:C:T	64	31	102	36	66	2.0	1.0	0.0
chr15:24676502:T:C	0	0	0	0	0	0	0	0
chr15:24677083:C:G	0	0	0	0	0	0	0	0
chr15:24678243:C:T	0	0	0	0	0	0	0	0
chr15:25679651:G:A	0	0	0	0	0	0	0	0
chr15:25679947:C:G	0	0	0	0	0	0	0	0
chr15:25681039:G:A	0	0	0	0	0	0	0	0
chr15:25687843:G:T	0	0	0	0	0	0	0	0
chr15:26937210:T:C	0	0	0	0	0	0	0	0
chr15:26943312:C:T	0	0	0	0	0	0	0	0
chr15:28111713:C:T	83	38	126	48	78	1	1	0
chr15:28141480:C:T	14	6	22	10	12	2.0	1.0	0.0
chr15:29234205:G:T	0	0	0	0	0	0	0	0
chr15:29716685:G:A	0	0	0	0	0	0	0	0
chr15:30750575:C:T	6	3	9	3	6	1.5	0.5	1.0
chr15:30925350:C:T	1	0	1	1	0	1	1	0
chr15:31002451:C:T	0	0	0	0	0	0	0	0
chr15:33065061:A:G	0	0	0	0	0	0	0	0
chr15:33067169:C:T	0	0	0	0	0	0	0	0
chr15:33067373:C:A	0	0	0	0	0	0	0	0
chr15:33088799:A:T	0	0	0	0	0	0	0	0
chr15:33154057:G:A	0	0	0	0	0	0	0	0
chr15:33154110:G:C	0	0	0	0	0	0	0	0
chr15:33739930:G:A	0	0	0	0	0	0	0	0
chr15:33788444:C:T	0	0	0	0	0	0	0	0
chr15:34341923:C:G	1175	671	2738	883	1855	2	1	2
chr15:34341937:GT:AC	1175	670	2731	886	1845	2	1	2
chr15:34489740:C:T	0	0	0	0	0	0	0	0
chr15:34495079:T:G	0	0	0	0	0	0	0	0
chr15:35085064:T:G	1	0	1	1	0	1	1	0
chr15:37943320:T:A	0	0	0	0	0	0	0	0
chr15:39252311:C:T	0	0	0	0	0	0	0	0
chr15:40161106:A:G	36	28	65	9	56	2.0	0.0	2.0
chr15:40185630:G:A	44	25	74	22	52	2.0	0.0	2.0
chr15:40296801:A:G	8	5	13	3	10	2.0	0.0	2.0
chr15:40297629:G:A	1	0	1	1	0	1	1	0
chr15:40363846:G:A	2	2	4	0	4	2.0	0.0	2.0
chr15:40407641:T:A	694	401	1240	366	874	2.0	0.0	2.0
chr15:40435680:C:A	162	66	249	105	144	1.0	1.0	0.0
chr15:40459356:C:A	1	0	1	1	0	1	1	0
chr15:40466138:A:C	4	3	7	1	6	2.0	0.0	2.0
chr15:40563011:T:A	982	454	1736	720	1016	2.0	1.0	0.0
chr15:40569865:C:T	359	181	571	192	379	2	1	2
chr15:40621979:T:C	12	10	26	2	24	2.0	0.0	2.0
chr15:40622574:C:T	8	7	15	1	14	2.0	0.0	2.0
chr15:40624039:A:G	6	5	11	1	10	2.0	0.0	2.0
chr15:40624603:A:G	8	1	9	7	2	1.0	1.0	0.0
chr15:40738667:C:G	7	3	10	4	6	1	1	0
chr15:40744250:G:A	2	2	4	0	4	2.0	0.0	2.0
chr15:40813460:G:A	6	4	10	2	8	2.0	0.0	2.0
chr15:40814230:C:T	99	46	148	54	94	1	1	0
chr15:40814287:A:C	99	45	148	56	92	1	1	0
chr15:40953478:G:A	1	1	2	0	2	2	0	2
chr15:41184011:T:C	0	0	0	0	0	0	0	0
chr15:41184267:G:A	0	0	0	0	0	0	0	0
chr15:41332199:G:C	14	6	20	8	12	1.0	1.0	0.0
chr15:41380186:A:G	5	4	11	3	8	2	0	2
chr15:41513039:C:T	22	18	39	4	35	2.0	0.0	2.0
chr15:41518241:G:C	21	13	34	8	26	2	0	2
chr15:41527169:T:C	8	4	12	4	8	1.5	0.5	1.0
chr15:41528002:C:T	17	10	27	7	20	2	0	2
chr15:41537032:A:G	32	9	42	24	18	1.0	1.0	0.0
chr15:41565018:G:A	0	0	0	0	0	0	0	0
chr15:41568292:T:A	1	0	1	1	0	1	1	0
chr15:41570983:G:A	0	0	0	0	0	0	0	0
chr15:41729314:T:C	36	17	55	21	34	2.0	1.0	0.0
chr15:41813720:C:G	2	2	6	0	6	3.0	0.0	3.0
chr15:41817025:T:C	0	0	0	0	0	0	0	0
chr15:41828144:A:G	84	38	124	48	76	1.0	1.0	0.0
chr15:41841899:C:T	3	1	4	2	2	1	1	0
chr15:41846258:G:A	15	8	23	7	16	2	0	2
chr15:41847444:C:T	34	13	49	21	28	1.0	1.0	0.0
chr15:41850920:T:C	6	5	13	1	12	2.0	0.0	2.0
chr15:41853738:G:C	3	0	3	3	0	1	1	0
chr15:41855695:G:A	2	2	4	0	4	2.0	0.0	2.0
chr15:41857308:G:C	1	0	1	1	0	1	1	0
chr15:41857398:C:G	1	1	2	0	2	2	0	2
chr15:41858690:G:A	0	0	0	0	0	0	0	0
chr15:41862540:G:A	0	0	0	0	0	0	0	0
chr15:41867092:C:T	0	0	0	0	0	0	0	0
chr15:41874302:C:T	0	0	0	0	0	0	0	0
chr15:41876202:C:T	0	0	0	0	0	0	0	0
chr15:41879264:C:T	0	0	0	0	0	0	0	0
chr15:41893241:C:G	29	13	42	16	26	1	1	0
chr15:41919288:A:G	393	203	649	212	437	2	1	2
chr15:41989521:G:A	0	0	0	0	0	0	0	0
chr15:42050731:G:A	0	0	0	0	0	0	0	0
chr15:42068752:C:T	0	0	0	0	0	0	0	0
chr15:42068824:C:T	0	0	0	0	0	0	0	0
chr15:42070167:C:T	0	0	0	0	0	0	0	0
chr15:42071197:C:T	0	0	0	0	0	0	0	0
chr15:42071282:G:A	0	0	0	0	0	0	0	0
chr15:42087396:G:A	0	0	0	0	0	0	0	0
chr15:42142639:T:C	0	0	0	0	0	0	0	0
chr15:42147178:G:A	0	0	0	0	0	0	0	0
chr15:42402746:T:C	7	5	12	2	10	2	0	2
chr15:42528253:C:T	3	0	3	3	0	1	1	0
chr15:42528391:G:A	225	126	373	103	270	2	0	2
chr15:43024873:T:C	35	11	48	26	22	1	1	0
chr15:43185915:G:C	123	68	197	57	140	2	0	2
chr15:43239213:G:C	0	0	0	0	0	0	0	0
chr15:43253530:G:A	0	0	0	0	0	0	0	0
chr15:43279192:C:G	0	0	0	0	0	0	0	0
chr15:43287368:A:G	0	0	0	0	0	0	0	0
chr15:43340351:T:C	60	30	90	30	60	1.5	0.5	1.0
chr15:43351703:A:G	0	0	0	0	0	0	0	0
chr15:43361124:G:A	14	5	20	10	10	1.0	1.0	0.0
chr15:43366737:C:T	8	1	11	9	2	1.0	1.0	0.0
chr15:43369604:T:C	13	3	17	11	6	1	1	0
chr15:43415610:A:T	30	10	41	21	20	1.0	1.0	0.0
chr15:43432448:T:G	51	24	76	28	48	1	1	0
chr15:43456106:A:G	44	27	78	18	60	2.0	0.0	2.0
chr15:43475576:G:C	42	17	60	26	34	1.0	1.0	0.0
chr15:43523801:C:T	0	0	0	0	0	0	0	0
chr15:43524719:G:A	0	0	0	0	0	0	0	0
chr15:43632410:T:C	8	5	13	3	10	2.0	0.0	2.0
chr15:43639534:G:A	108	53	173	59	114	2.0	1.0	0.0
chr15:43736371:G:C	35	15	51	21	30	1	1	0
chr15:43746701:C:T	1742	1040	3810	1226	2584	2.0	1.0	2.0
chr15:43792507:G:A	163	78	257	91	166	2	1	0
chr15:43828361:T:G	135	57	205	85	120	1	1	0
chr15:44651559:A:G	85	40	133	51	82	2	1	0
chr15:44755375:C:T	12	10	24	2	22	2.0	0.0	2.0
chr15:45114520:C:T	0	0	0	0	0	0	0	0
chr15:45152320:A:G	8	4	12	4	8	1.5	0.5	1.0
chr15:45164908:G:T	14	5	19	9	10	1.0	1.0	0.0
chr15:45164929:C:T	12	4	16	8	8	1.0	1.0	0.0
chr15:47764761:C:T	0	0	0	0	0	0	0	0
chr15:48428329:G:C	0	0	0	0	0	0	0	0
chr15:48505110:A:G	0	0	0	0	0	0	0	0
chr15:48834937:G:A	0	0	0	0	0	0	0	0
chr15:48992804:G:C	43	24	68	20	48	2	0	2
chr15:49000997:C:A	90	47	139	43	96	2.0	0.0	2.0
chr15:49137213:A:G	694	366	1172	386	786	2.0	1.0	2.0
chr15:49328003:C:T	41	14	56	28	28	1	1	0
chr15:49625144:G:A	269	112	409	168	241	1	1	0
chr15:50490506:A:G	135	62	203	77	126	1	1	0
chr15:50574885:G:A	9	4	13	5	8	1	1	0
chr15:51342058:T:G	4	2	6	2	4	1.5	0.5	1.0
chr15:51457529:A:C	0	0	0	0	0	0	0	0
chr15:51537615:G:A	0	0	0	0	0	0	0	0
chr15:51622581:T:G	0	0	0	0	0	0	0	0
chr15:52109754:G:A	19	12	31	7	24	2	0	2
chr15:52128294:G:T	26	12	42	16	26	2.0	1.0	0.0
chr15:52239744:A:G	2	0	2	2	0	1.0	1.0	0.0
chr15:52242147:G:A	3	1	4	2	2	1	1	0
chr15:52319254:A:G	29	12	41	17	24	1	1	0
chr15:52582093:T:C	89	47	140	44	96	2	0	2
chr15:54626849:A:G	0	0	0	0	0	0	0	0
chr15:55319235:A:G	229	120	361	117	244	2	0	2
chr15:55327598:T:C	24	15	39	9	30	2.0	0.0	2.0
chr15:55360833:A:G	461	235	758	262	496	2	1	2
chr15:55546308:G:A	0	0	0	0	0	0	0	0
chr15:55546387:G:T	0	0	0	0	0	0	0	0
chr15:55860674:C:T	3	1	4	2	2	1	1	0
chr15:55915613:T:G	0	0	0	0	0	0	0	0
chr15:55916256:A:G	0	0	0	0	0	0	0	0
chr15:55924554:A:T	2	1	3	1	2	1.5	0.5	1.0
chr15:55924595:C:T	2	1	3	1	2	1.5	0.5	1.0
chr15:56095661:T:C	9	5	14	4	10	2	0	2
chr15:56666830:C:T	80	31	114	50	64	1.0	1.0	0.0
chr15:57523584:C:T	0	0	0	0	0	0	0	0
chr15:57708783:C:T	370	156	561	233	328	1.0	1.0	0.0
chr15:58883766:A:G	127	66	202	68	134	2	1	2
chr15:58887065:G:A	118	70	198	54	144	2.0	0.0	2.0
chr15:59075968:G:A	12	7	19	6	13	2.0	0.5	1.5
chr15:59084332:T:C	4	2	6	2	4	1.5	0.5	1.0
chr15:59678099:C:A	13	9	22	4	18	2	0	2
chr15:59689292:T:G	1149	620	2085	711	1374	2	1	2
chr15:59689316:A:G	881	409	1472	590	882	2	1	0
chr15:59689391:G:A	89	52	150	38	112	2	0	2
chr15:59689520:C:T	94	52	159	43	116	2.0	0.0	2.0
chr15:59768803:G:A	64	0	65	65	0	1.0	1.0	0.0
chr15:60423601:T:G	104	48	155	58	97	1.0	1.0	0.0
chr15:61854399:C:T	42	14	59	29	30	1.0	1.0	0.0
chr15:61882695:A:G	64	42	108	24	84	2.0	0.0	2.0
chr15:61922408:C:T	19	8	27	11	16	1	1	0
chr15:61961592:T:C	72	42	119	33	86	2.0	0.0	2.0
chr15:62067715:C:T	0	0	0	0	0	0	0	0
chr15:62755579:C:T	0	0	0	0	0	0	0	0
chr15:62755594:C:T	0	0	0	0	0	0	0	0
chr15:63056897:G:A	0	0	0	0	0	0	0	0
chr15:63059641:C:A	65	35	104	32	72	2	0	2
chr15:63141567:G:A	62	25	93	39	54	1.0	1.0	0.0
chr15:63157344:A:C	411	211	704	240	464	2	1	2
chr15:63157481:C:G	798	429	1502	493	1009	2.0	1.0	2.0
chr15:63597735:G:C	1	0	1	1	0	1	1	0
chr15:63600069:G:A	2	2	4	0	4	2.0	0.0	2.0
chr15:63640314:G:C	17	9	26	8	18	2	0	2
chr15:63678257:T:C	103	56	167	53	114	2	0	2
chr15:63713523:A:G	30	21	53	9	44	2.0	0.0	2.0
chr15:64300463:G:A	183	105	294	82	212	2	0	2
chr15:64670431:A:C	36	20	62	16	46	2.0	0.0	2.0
chr15:64943580:A:G	18	4	22	14	8	1.0	1.0	0.0
chr15:64963704:G:A	229	118	370	119	251	2	1	2
chr15:65119371:C:G	24	20	44	4	40	2.0	0.0	2.0
chr15:65260908:C:T	24	12	39	13	26	2.0	0.5	1.0
chr15:65329103:C:A	0	0	0	0	0	0	0	0
chr15:65384279:T:C	0	0	0	0	0	0	0	0
chr15:65384388:C:T	0	0	0	0	0	0	0	0
chr15:65385803:A:T	0	0	0	0	0	0	0	0
chr15:65564315:G:A	200	96	308	106	202	1.0	1.0	0.0
chr15:65650594:C:T	34	18	52	16	36	2.0	0.0	2.0
chr15:66306815:G:T	0	0	0	0	0	0	0	0
chr15:66320627:T:C	19	11	33	11	22	2	0	2
chr15:66329044:G:A	23	13	36	10	26	2	0	2
chr15:66332823:A:G	65	26	101	43	58	1	1	0
chr15:66489710:C:T	1	0	1	1	0	1	1	0
chr15:66500423:A:G	49	24	76	28	48	2	1	0
chr15:66540128:A:G	13	8	21	5	16	2	0	2
chr15:67165360:A:G	2	0	2	2	0	1.0	1.0	0.0
chr15:68199690:G:A	0	0	0	0	0	0	0	0
chr15:68331952:G:A	0	0	0	0	0	0	0	0
chr15:68718780:C:T	0	0	0	0	0	0	0	0
chr15:70055023:C:A	2	2	4	0	4	2.0	0.0	2.0
chr15:70059449:T:C	24	7	32	18	14	1.0	1.0	0.0
chr15:70060629:C:G	25	9	34	16	18	1	1	0
chr15:71660706:G:A	0	0	0	0	0	0	0	0
chr15:71731083:C:T	0	0	0	0	0	0	0	0
chr15:71748435:C:T	0	0	0	0	0	0	0	0
chr15:71898732:T:C	15	9	26	6	20	2	0	2
chr15:72170009:G:T	0	0	0	0	0	0	0	0
chr15:72200722:G:A	4	2	6	2	4	1.5	0.5	1.0
chr15:72209800:G:A	296	161	493	149	344	2.0	0.0	2.0
chr15:72266873:A:T	2	1	3	1	2	1.5	0.5	1.0
chr15:72686211:C:T	69	25	99	49	50	1	1	0
chr15:72735137:T:C	35	15	50	20	30	1	1	0
chr15:73249172:A:G	1	0	1	1	0	1	1	0
chr15:73258909:A:G	0	0	0	0	0	0	0	0
chr15:73289103:A:G	0	0	0	0	0	0	0	0
chr15:73927205:G:T	0	0	0	0	0	0	0	0
chr15:73985454:T:C	36	17	53	19	34	1.0	1.0	0.0
chr15:74025021:G:A	10	6	16	4	12	2.0	0.0	2.0
chr15:74034370:G:A	1	0	1	1	0	1	1	0
chr15:74175455:C:T	0	0	0	0	0	0	0	0
chr15:74175515:G:A	0	0	0	0	0	0	0	0
chr15:74176153:C:T	0	0	0	0	0	0	0	0
chr15:74179953:A:G	0	0	0	0	0	0	0	0
chr15:74195505:G:A	0	0	0	0	0	0	0	0
chr15:74195628:A:T	0	0	0	0	0	0	0	0
chr15:74196083:G:A	0	0	0	0	0	0	0	0
chr15:74202605:G:T	0	0	0	0	0	0	0	0
chr15:74207764:G:A	0	0	0	0	0	0	0	0
chr15:74207897:C:T	0	0	0	0	0	0	0	0
chr15:74268435:G:T	0	0	0	0	0	0	0	0
chr15:75206403:G:C	4	2	6	2	4	1.5	0.5	1.0
chr15:75338221:C:T	59	29	93	31	62	2	1	0
chr15:75338294:A:T	59	29	93	31	62	2	1	0
chr15:75347788:G:A	3	1	4	2	2	1	1	0
chr15:75358495:G:A	90	42	134	50	84	1.0	1.0	0.0
chr15:75358631:G:A	28	17	46	12	34	2.0	0.0	2.0
chr15:75598348:G:T	93	53	157	41	116	2	0	2
chr15:75844427:C:T	382	204	618	196	422	2.0	0.0	2.0
chr15:77614803:G:A	1	1	2	0	2	2	0	2
chr15:77896926:A:T	0	0	0	0	0	0	0	0
chr15:77897136:C:A	0	0	0	0	0	0	0	0
chr15:77921418:C:T	0	0	0	0	0	0	0	0
chr15:77921426:C:A	0	0	0	0	0	0	0	0
chr15:77941501:C:T	1	0	1	1	0	1	1	0
chr15:77986887:ACTGC:GCTGG	0	0	0	0	0	0	0	0
chr15:77986944:C:T	0	0	0	0	0	0	0	0
chr15:77986972:G:A	0	0	0	0	0	0	0	0
chr15:78098567:C:T	1	0	1	1	0	1	1	0
chr15:78105804:G:A	195	111	333	95	238	2	0	2
chr15:78340488:C:G	0	0	0	0	0	0	0	0
chr15:78341253:T:G	0	0	0	0	0	0	0	0
chr15:78533220:C:T	0	0	0	0	0	0	0	0
chr15:78533575:A:G	0	0	0	0	0	0	0	0
chr15:78590583:G:A	1	0	1	1	0	1	1	0
chr15:78601997:G:A	1	0	1	1	0	1	1	0
chr15:78618839:T:C	0	0	0	0	0	0	0	0
chr15:78625057:A:G	1	1	2	0	2	2	0	2
chr15:78759379:G:A	5	0	5	5	0	1	1	0
chr15:78759417:G:A	5	5	10	0	10	2	0	2
chr15:78764751:G:A	0	0	0	0	0	0	0	0
chr15:78766609:T:C	0	0	0	0	0	0	0	0
chr15:78771132:A:T	0	0	0	0	0	0	0	0
chr15:78771738:G:A	0	0	0	0	0	0	0	0
chr15:78771801:C:G	0	0	0	0	0	0	0	0
chr15:78776779:A:G	0	0	0	0	0	0	0	0
chr15:78777392:G:T	0	0	0	0	0	0	0	0
chr15:78796665:T:C	0	0	0	0	0	0	0	0
chr15:78796769:A:G	0	0	0	0	0	0	0	0
chr15:78873099:G:T	1238	706	2377	759	1618	2.0	1.0	2.0
chr15:78944838:C:A	50	32	83	19	64	2.0	0.0	2.0
chr15:78944905:C:G	1756	1200	4102	980	3122	2.0	0.0	2.0
chr15:78980756:C:G	5	5	10	0	10	2	0	2
chr15:78984956:T:C	43	24	70	20	50	2	0	2
chr15:78985169:A:G	130	60	197	73	124	1.0	1.0	0.0
chr15:79003830:G:A	338	155	540	208	332	1.0	1.0	0.0
chr15:79006181:G:A	131	64	205	73	132	2	1	0
chr15:79294019:T:C	0	0	0	0	0	0	0	0
chr15:79457785:A:G	1	0	1	1	0	1	1	0
chr15:79463231:C:T	1	1	2	0	2	2	0	2
chr15:79971064:C:T	225	127	407	113	294	2	0	2
chr15:80157986:T:C	0	0	0	0	0	0	0	0
chr15:80158047:G:A	0	0	0	0	0	0	0	0
chr15:80162403:T:C	0	0	0	0	0	0	0	0
chr15:80201771:C:T	0	0	0	0	0	0	0	0
chr15:80201914:G:A	0	0	0	0	0	0	0	0
chr15:81290527:G:A	2	2	4	0	4	2.0	0.0	2.0
chr15:81295416:T:A	8	3	11	5	6	1.0	1.0	0.0
chr15:81300461:A:G	245	106	372	161	211	1	1	0
chr15:81303486:C:T	14	5	20	10	10	1.0	1.0	0.0
chr15:81305884:C:A	1	0	1	1	0	1	1	0
chr15:81305928:T:G	214	93	323	135	188	1.0	1.0	0.0
chr15:81306075:G:A	244	107	378	156	222	1.0	1.0	0.0
chr15:81332427:C:T	16	11	27	5	22	2.0	0.0	2.0
chr15:81333044:C:T	4	3	7	1	6	2.0	0.0	2.0
chr15:81343926:C:T	2	2	4	0	4	2.0	0.0	2.0
chr15:81344943:G:A	3	1	4	2	2	1	1	0
chr15:81374188:G:A	1	1	2	0	2	2	0	2
chr15:82151598:G:A	34	17	54	18	36	2.0	0.5	1.0
chr15:82152096:A:G	15	8	25	9	16	2	0	2
chr15:82163886:T:C	21	10	34	12	22	1	1	0
chr15:82262901:A:G	35	15	55	21	34	1	1	0
chr15:82282538:T:C	3	0	3	3	0	1	1	0
chr15:82327212:C:T	0	0	0	0	0	0	0	0
chr15:82327224:C:T	0	0	0	0	0	0	0	0
chr15:82431921:C:T	0	0	0	0	0	0	0	0
chr15:82538982:A:G	3983	3250	25582	9551	16031	5	2	4
chr15:82544529:G:A	41	22	69	19	50	2	0	2
chr15:82759440:C:T	2	1	3	1	2	1.5	0.5	1.0
chr15:82759441:G:A	2	1	4	2	2	2.0	1.0	1.0
chr15:82833313:AC:CG	38	21	59	17	42	2.0	0.0	2.0
chr15:83011567:G:A	1149	597	2111	740	1371	2	1	2
chr15:83819884:A:G	0	0	0	0	0	0	0	0
chr15:83913137:G:A	0	0	0	0	0	0	0	0
chr15:83982433:C:A	0	0	0	0	0	0	0	0
chr15:84646233:T:G	138	82	231	65	166	2.0	0.0	2.0
chr15:84657289:G:T	508	330	1073	241	832	2.0	0.0	2.0
chr15:84798628:G:A	16	8	24	8	16	1.5	0.5	1.0
chr15:84816773:A:C	0	0	0	0	0	0	0	0
chr15:84840478:A:G	0	0	0	0	0	0	0	0
chr15:84859379:G:A	0	0	0	0	0	0	0	0
chr15:84933210:G:A	0	0	0	0	0	0	0	0
chr15:84935498:G:A	0	0	0	0	0	0	0	0
chr15:85579939:G:T	15	5	20	10	10	1	1	0
chr15:85580133:G:A	12	8	20	4	16	2.0	0.0	2.0
chr15:85684721:A:G	25	18	45	7	38	2	0	2
chr15:85735078:G:A	128	61	199	71	128	1.0	1.0	0.0
chr15:85744679:C:T	123	62	189	63	126	2	1	2
chr15:85768464:G:A	0	0	0	0	0	0	0	0
chr15:85769450:G:A	0	0	0	0	0	0	0	0
chr15:86256978:C:T	0	0	0	0	0	0	0	0
chr15:86262798:C:T	0	0	0	0	0	0	0	0
chr15:86397391:T:C	0	0	0	0	0	0	0	0
chr15:88032954:G:C	0	0	0	0	0	0	0	0
chr15:88136554:G:A	0	0	0	0	0	0	0	0
chr15:88512809:C:A	22	7	29	15	14	1.0	1.0	0.0
chr15:88626472:C:G	111	57	171	55	116	2	0	2
chr15:88629139:T:C	7	3	10	4	6	1	1	0
chr15:88843421:G:A	0	0	0	0	0	0	0	0
chr15:88855176:C:T	0	0	0	0	0	0	0	0
chr15:88874007:A:G	0	0	0	0	0	0	0	0
chr15:88878096:A:G	0	0	0	0	0	0	0	0
chr15:88878174:G:A	0	0	0	0	0	0	0	0
chr15:88879055:C:T	0	0	0	0	0	0	0	0
chr15:88881350:A:G	0	0	0	0	0	0	0	0
chr15:88881377:A:T	0	0	0	0	0	0	0	0
chr15:88887275:C:T	0	0	0	0	0	0	0	0
chr15:88893013:T:C	0	0	0	0	0	0	0	0
chr15:88893064:G:A	0	0	0	0	0	0	0	0
chr15:89295005:A:G	14	5	20	10	10	1.0	1.0	0.0
chr15:89317422:G:T	110	55	173	59	114	2.0	1.0	1.0
chr15:89585735:C:T	0	0	0	0	0	0	0	0
chr15:89645930:C:T	0	0	0	0	0	0	0	0
chr15:89652935:A:C	1	1	2	0	2	2	0	2
chr15:89667026:G:A	0	0	0	0	0	0	0	0
chr15:89797488:G:A	0	0	0	0	0	0	0	0
chr15:89797494:A:C	0	0	0	0	0	0	0	0
chr15:90074307:C:T	21	6	27	15	12	1	1	0
chr15:90079820:T:C	4	0	5	5	0	1.0	1.0	0.0
chr15:90225727:A:C	78	36	123	46	77	1.0	1.0	0.0
chr15:90228518:T:G	103	47	157	59	98	1	1	0
chr15:90241018:T:C	22	12	34	10	24	2.0	0.0	2.0
chr15:90241828:C:T	14	8	22	6	16	2.0	0.0	2.0
chr15:90540121:G:A	158	68	244	98	146	1.0	1.0	0.0
chr15:90638640:G:T	6	4	10	2	8	2.0	0.0	2.0
chr15:90881344:G:C	15	7	21	8	13	1	1	0
chr15:90885060:C:T	12	9	21	3	18	2.0	0.0	2.0
chr15:90885359:T:G	1	0	1	1	0	1	1	0
chr15:90885406:G:A	1	0	1	1	0	1	1	0
chr15:90906424:T:C	2	1	3	1	2	1.5	0.5	1.0
chr15:90906472:A:T	2	1	3	1	2	1.5	0.5	1.0
chr15:90907294:G:A	3	3	8	0	8	2	0	2
chr15:90909365:A:G	3	3	6	0	6	2	0	2
chr15:90911341:T:C	1	1	2	0	2	2	0	2
chr15:90935314:A:C	125	65	199	63	136	2	0	2
chr15:90959819:A:G	1	1	2	0	2	2	0	2
chr15:90960522:T:C	1	0	2	2	0	2	2	0
chr15:90960951:G:A	2	1	4	2	2	2.0	1.0	1.0
chr15:91000531:C:T	65	30	97	35	62	1	1	0
chr15:91006592:G:C	2	0	2	2	0	1.0	1.0	0.0
chr15:91226235:G:A	0	0	0	0	0	0	0	0
chr15:92094963:G:A	0	0	0	0	0	0	0	0
chr15:92171901:A:T	0	0	0	0	0	0	0	0
chr15:92171937:C:T	0	0	0	0	0	0	0	0
chr15:93009258:C:T	62	24	89	39	50	1.0	1.0	0.0
chr15:93045034:G:C	0	0	0	0	0	0	0	0
chr15:93045059:G:A	0	0	0	0	0	0	0	0
chr15:93073704:C:G	0	0	0	0	0	0	0	0
chr15:93073746:A:G	0	0	0	0	0	0	0	0
chr15:94356125:T:G	33	21	54	12	42	2	0	2
chr15:96784163:C:T	0	0	0	0	0	0	0	0
chr15:97969201:C:T	6	3	11	3	8	1.5	0.5	1.0
chr15:98934996:G:A	0	0	0	0	0	0	0	0
chr15:99113595:T:C	0	0	0	0	0	0	0	0
chr15:99130784:T:C	0	0	0	0	0	0	0	0
chr15:99131555:T:C	0	0	0	0	0	0	0	0
chr15:99132517:A:G	0	0	0	0	0	0	0	0
chr15:99175147:A:G	1	0	1	1	0	1	1	0
chr15:99221847:A:G	2	1	3	1	2	1.5	0.5	1.0
chr15:99363342:G:A	25	12	37	13	24	1	1	0
chr15:99712600:G:T	51	23	76	30	46	1	1	0
chr15:99729475:G:C	31	15	48	18	30	2	1	0
chr15:99974320:C:T	1	0	1	1	0	1	1	0
chr15:99974356:G:C	1	0	1	1	0	1	1	0
chr15:99974409:T:C	0	0	0	0	0	0	0	0
chr15:99976267:G:A	0	0	0	0	0	0	0	0
chr15:100152640:A:G	0	0	0	0	0	0	0	0
chr15:100261493:G:A	0	0	0	0	0	0	0	0
chr15:100503827:G:A	1	0	1	1	0	1	1	0
chr15:100569472:C:A	48	19	71	33	38	1.0	1.0	0.0
chr15:100569589:C:G	38	14	55	27	28	1.0	1.0	0.0
chr15:100569613:G:A	36	13	52	26	26	1.0	1.0	0.0
chr15:100569688:C:A	33	11	47	25	22	1	1	0
chr15:100573745:A:G	75	37	113	39	74	2	1	0
chr15:100580758:T:C	130	62	198	70	128	1.0	1.0	0.0
chr15:101022588:G:A	5	3	10	2	8	2	0	2
chr15:101027342:G:C	13	6	19	7	12	1	1	0
chr15:101057995:G:A	8	4	12	4	8	1.5	0.5	1.0
chr15:101066063:G:A	10	7	17	3	14	2.0	0.0	2.0
chr15:101286181:G:A	99	45	159	61	98	2	1	0
chr15:101307391:C:T	0	0	0	0	0	0	0	0
chr15:101382118:A:G	0	0	0	0	0	0	0	0
chr15:101633586:G:C	152	84	258	78	180	2.0	0.0	2.0
chr15:101650179:G:A	44	22	67	23	44	2.0	0.5	1.0
chr15:101724273:C:A	1081	608	2233	729	1504	2	1	2
chr16:53423:C:A	6	2	11	5	6	1.5	1.0	0.0
chr16:53923:C:G	618	363	1113	335	778	2.0	1.0	2.0
chr16:55444:C:T	4	2	6	2	4	1.5	0.5	1.0
chr16:57275:T:G	636	370	1173	362	811	2.0	1.0	2.0
chr16:58586:T:C	1	1	4	0	4	4	0	4
chr16:60167:T:C	0	0	0	0	0	0	0	0
chr16:61249:C:T	1	0	1	1	0	1	1	0
chr16:208185:T:C	314	171	537	167	370	2.0	0.0	2.0
chr16:274052:A:G	4	1	5	3	2	1.0	1.0	0.0
chr16:284890:G:A	0	0	0	0	0	0	0	0
chr16:285373:C:T	0	0	0	0	0	0	0	0
chr16:286396:G:A	0	0	0	0	0	0	0	0
chr16:286660:G:A	0	0	0	0	0	0	0	0
chr16:289672:T:C	1	0	1	1	0	1	1	0
chr16:291182:G:A	0	0	0	0	0	0	0	0
chr16:297184:A:G	29	11	40	18	22	1	1	0
chr16:298222:C:T	10	2	12	8	4	1.0	1.0	0.0
chr16:346264:A:G	4	1	5	3	2	1.0	1.0	0.0
chr16:368597:G:C	675	433	1245	303	942	2	0	2
chr16:369092:A:G	668	280	1058	470	588	1.0	1.0	0.0
chr16:369154:G:A	667	280	1057	469	588	1	1	0
chr16:370140:G:A	627	269	1007	441	566	1	1	0
chr16:376432:T:C	5	1	6	4	2	1	1	0
chr16:377479:T:C	5	3	8	2	6	2	0	2
chr16:377516:T:C	5	3	8	2	6	2	0	2
chr16:406416:T:G	2	0	2	2	0	1.0	1.0	0.0
chr16:406429:G:A	2	2	4	0	4	2.0	0.0	2.0
chr16:489093:G:C	2	2	4	0	4	2.0	0.0	2.0
chr16:551632:T:C	2	1	3	1	2	1.5	0.5	1.0
chr16:552313:C:A	5	2	7	3	4	1	1	0
chr16:552595:G:C	1	0	1	1	0	1	1	0
chr16:565326:T:C	0	0	0	0	0	0	0	0
chr16:574114:A:G	17	9	26	8	18	2	0	2
chr16:574713:C:T	16	9	25	7	18	2.0	0.0	2.0
chr16:580089:C:T	0	0	0	0	0	0	0	0
chr16:580367:C:T	1	1	2	0	2	2	0	2
chr16:583125:T:C	101	60	163	41	122	2	0	2
chr16:627629:T:C	16	7	22	9	13	1.0	1.0	0.0
chr16:631280:G:T	0	0	0	0	0	0	0	0
chr16:632566:T:C	2	1	3	1	2	1.5	0.5	1.0
chr16:651656:C:T	1	1	2	0	2	2	0	2
chr16:655360:T:C	5	3	8	2	6	2	0	2
chr16:655844:T:C	2	1	3	1	2	1.5	0.5	1.0
chr16:655920:G:C	2	1	3	1	2	1.5	0.5	1.0
chr16:656534:G:A	0	0	0	0	0	0	0	0
chr16:658275:C:A	0	0	0	0	0	0	0	0
chr16:659001:C:A	0	0	0	0	0	0	0	0
chr16:661326:G:C	0	0	0	0	0	0	0	0
chr16:661712:C:T	0	0	0	0	0	0	0	0
chr16:661905:A:G	0	0	0	0	0	0	0	0
chr16:662867:A:G	0	0	0	0	0	0	0	0
chr16:665990:G:A	3	2	5	1	4	2	0	2
chr16:667523:G:T	21	12	33	9	24	2	0	2
chr16:668514:C:G	123	65	198	60	138	2	0	2
chr16:670986:G:A	110	49	165	66	99	1.0	1.0	0.0
chr16:672019:C:T	3	1	4	2	2	1	1	0
chr16:672331:C:T	133	67	202	68	134	2	1	2
chr16:672548:A:G	146	78	228	70	158	2.0	0.0	2.0
chr16:673647:C:G	207	111	324	100	224	2	0	2
chr16:685921:T:C	12	8	22	4	18	2.0	0.0	2.0
chr16:722061:C:T	380	160	570	242	328	1.0	1.0	0.0
chr16:722141:G:C	185	81	274	106	168	1	1	0
chr16:722842:T:C	2	1	3	1	2	1.5	0.5	1.0
chr16:724520:C:T	20	10	30	10	20	1.5	0.5	1.0
chr16:724692:A:G	22	13	35	9	26	2.0	0.0	2.0
chr16:728820:G:A	419	251	735	193	542	2	0	2
chr16:734765:C:T	23	12	37	11	26	2	0	2
chr16:734920:A:G	0	0	0	0	0	0	0	0
chr16:765532:C:T	3	0	3	3	0	1	1	0
chr16:893107:A:G	0	0	0	0	0	0	0	0
chr16:893130:C:G	0	0	0	0	0	0	0	0
chr16:911051:C:T	76	38	116	39	77	1.5	1.0	0.5
chr16:954554:C:T	108	56	167	53	114	2.0	0.0	2.0
chr16:954605:A:G	109	52	163	59	104	1	1	0
chr16:985077:C:T	0	0	0	0	0	0	0	0
chr16:985422:G:C	0	0	0	0	0	0	0	0
chr16:985456:A:G	0	0	0	0	0	0	0	0
chr16:1079872:C:T	0	0	0	0	0	0	0	0
chr16:1093696:G:C	0	0	0	0	0	0	0	0
chr16:1202259:A:G	0	0	0	0	0	0	0	0
chr16:1202369:C:T	0	0	0	0	0	0	0	0
chr16:1202441:T:C	0	0	0	0	0	0	0	0
chr16:1209406:G:A	0	0	0	0	0	0	0	0
chr16:1210481:T:C	0	0	0	0	0	0	0	0
chr16:1211377:G:A	0	0	0	0	0	0	0	0
chr16:1218494:C:T	0	0	0	0	0	0	0	0
chr16:1219029:T:C	0	0	0	0	0	0	0	0
chr16:1220162:G:A	0	0	0	0	0	0	0	0
chr16:1220349:T:C	0	0	0	0	0	0	0	0
chr16:1222038:G:A	0	0	0	0	0	0	0	0
chr16:1222865:G:A	0	0	0	0	0	0	0	0
chr16:1228609:G:C	2	0	5	5	0	2.5	2.5	0.0
chr16:1256354:T:C	0	0	0	0	0	0	0	0
chr16:1256980:G:A	0	0	0	0	0	0	0	0
chr16:1347814:C:T	12	6	18	6	12	1.5	0.5	1.0
chr16:1434384:C:A	1	0	1	1	0	1	1	0
chr16:1434391:G:C	21	7	28	14	14	1	1	0
chr16:1434790:C:T	26	15	41	11	30	2.0	0.0	2.0
chr16:1435242:A:G	11	8	19	3	16	2	0	2
chr16:1435254:A:G	11	8	19	3	16	2	0	2
chr16:1438223:T:C	0	0	0	0	0	0	0	0
chr16:1438645:A:G	12	7	19	5	14	2.0	0.0	2.0
chr16:1453878:T:A	28	18	46	10	36	2.0	0.0	2.0
chr16:1487413:C:T	0	0	0	0	0	0	0	0
chr16:1487600:A:G	0	0	0	0	0	0	0	0
chr16:1487692:C:A	0	0	0	0	0	0	0	0
chr16:1487838:G:A	0	0	0	0	0	0	0	0
chr16:1488432:A:G	0	0	0	0	0	0	0	0
chr16:1494300:GA:CG	10	3	13	7	6	1.0	1.0	0.0
chr16:1495447:A:G	6	1	7	5	2	1.0	1.0	0.0
chr16:1500370:G:A	5	4	9	1	8	2	0	2
chr16:1505588:A:G	26	14	42	12	30	2.0	0.0	2.0
chr16:1509837:T:C	45	23	71	23	48	2	0	2
chr16:1510885:A:G	6	3	9	3	6	1.5	0.5	1.0
chr16:1524862:G:A	0	0	0	0	0	0	0	0
chr16:1762971:G:C	3	2	5	1	4	2	0	2
chr16:1764390:T:C	1	1	2	0	2	2	0	2
chr16:1767430:C:T	2	0	2	2	0	1.0	1.0	0.0
chr16:1767934:A:C	3	1	3	2	1	1	1	0
chr16:1768502:G:C	18	7	25	11	14	1.0	1.0	0.0
chr16:1770991:T:A	1354	654	2471	999	1472	2.0	1.0	0.0
chr16:1773443:C:G	16	5	21	11	10	1.0	1.0	0.0
chr16:1775264:G:A	5	2	7	3	4	1	1	0
chr16:1776301:G:T	4	1	5	3	2	1.0	1.0	0.0
chr16:1777521:T:G	31	16	47	15	32	2	0	2
chr16:1786795:C:A	341	185	562	176	386	2	0	2
chr16:1788036:C:G	699	335	1133	429	704	2	1	0
chr16:1788835:C:G	765	423	1330	410	920	2	1	2
chr16:1789014:C:T	783	434	1370	423	947	2	1	2
chr16:1793671:T:C	0	0	0	0	0	0	0	0
chr16:1827912:C:G	204	97	318	118	200	2.0	1.0	0.0
chr16:1862020:T:G	0	0	0	0	0	0	0	0
chr16:1911673:G:C	1	1	4	0	4	4	0	4
chr16:1912045:CG:TA	1	1	4	0	4	4	0	4
chr16:1912131:G:A	1	1	4	0	4	4	0	4
chr16:1964282:A:G	4397	4343	193045	67343	125702	36	13	24
chr16:1964423:C:G	453	276	820	208	612	2	0	2
chr16:2020199:G:C	4	2	10	2	8	1.5	0.5	1.0
chr16:2037784:T:C	4	4	8	0	8	2.0	0.0	2.0
chr16:2061778:T:C	0	0	0	0	0	0	0	0
chr16:2064406:C:T	12	6	18	6	12	1.5	0.5	1.0
chr16:2065505:C:T	3	0	3	3	0	1	1	0
chr16:2088217:A:C	5	0	6	6	0	1	1	0
chr16:2088268:T:C	86	35	128	54	74	1.0	1.0	0.0
chr16:2090009:A:G	3	2	5	1	4	2	0	2
chr16:2090453:T:C	1	1	2	0	2	2	0	2
chr16:2090679:T:C	2	2	4	0	4	2.0	0.0	2.0
chr16:2092941:C:T	0	0	0	0	0	0	0	0
chr16:2102386:AC:GG	0	0	0	0	0	0	0	0
chr16:2105818:A:C	0	0	0	0	0	0	0	0
chr16:2106020:A:G	1	1	2	0	2	2	0	2
chr16:2106446:G:A	0	0	0	0	0	0	0	0
chr16:2107078:T:C	0	0	0	0	0	0	0	0
chr16:2109995:G:A	0	0	0	0	0	0	0	0
chr16:2110502:T:G	0	0	0	0	0	0	0	0
chr16:2110972:A:G	0	0	0	0	0	0	0	0
chr16:2111792:GGAG:AGAA	0	0	0	0	0	0	0	0
chr16:2112360:A:G	0	0	0	0	0	0	0	0
chr16:2112886:A:G	0	0	0	0	0	0	0	0
chr16:2187044:C:T	1	1	2	0	2	2	0	2
chr16:2206460:C:G	39	24	64	16	48	2	0	2
chr16:2207104:C:G	107	64	177	45	132	2	0	2
chr16:2209392:C:G	242	119	379	129	250	2.0	1.0	0.0
chr16:2210934:G:A	3	1	4	2	2	1	1	0
chr16:2235356:C:T	121	56	183	67	116	1	1	0
chr16:2237648:A:C	5	1	6	4	2	1	1	0
chr16:2317335:G:A	1	0	1	1	0	1	1	0
chr16:2462522:G:A	2	0	2	2	0	1.0	1.0	0.0
chr16:2530754:G:C	40	10	49	30	19	1.0	1.0	0.0
chr16:2766626:G:C	49	28	81	23	58	2	0	2
chr16:2771762:C:G	97	51	157	47	110	2	0	2
chr16:3015595:T:C	0	0	0	0	0	0	0	0
chr16:3015755:A:G	0	0	0	0	0	0	0	0
chr16:3025998:C:G	14	8	22	6	16	2.0	0.0	2.0
chr16:3029684:T:C	0	0	0	0	0	0	0	0
chr16:3035334:G:C	0	0	0	0	0	0	0	0
chr16:3035374:G:A	0	0	0	0	0	0	0	0
chr16:3050094:C:T	3	2	5	1	4	2	0	2
chr16:3204418:C:G	0	0	0	0	0	0	0	0
chr16:3204470:T:C	0	0	0	0	0	0	0	0
chr16:3204972:T:C	0	0	0	0	0	0	0	0
chr16:3243438:C:T	0	0	0	0	0	0	0	0
chr16:3243922:A:T	0	0	0	0	0	0	0	0
chr16:3247073:A:G	0	0	0	0	0	0	0	0
chr16:3247175:T:C	0	0	0	0	0	0	0	0
chr16:3247181:C:T	0	0	0	0	0	0	0	0
chr16:3249749:G:A	0	0	0	0	0	0	0	0
chr16:3254463:C:T	0	0	0	0	0	0	0	0
chr16:3254762:A:G	0	0	0	0	0	0	0	0
chr16:3356516:A:G	0	0	0	0	0	0	0	0
chr16:3356626:G:A	0	0	0	0	0	0	0	0
chr16:3500977:C:G	7	3	12	4	8	1	1	0
chr16:3530512:G:A	3	0	3	3	0	1	1	0
chr16:3533173:C:T	7	2	9	5	4	1	1	0
chr16:3563125:C:T	3	2	5	1	4	2	0	2
chr16:3563149:A:G	3	2	5	1	4	2	0	2
chr16:3589138:A:G	2	1	3	1	2	1.5	0.5	1.0
chr16:3589826:G:A	1	0	1	1	0	1	1	0
chr16:3606481:C:T	2	1	3	1	2	1.5	0.5	1.0
chr16:3657746:G:A	13	5	18	8	10	1	1	0
chr16:3658192:G:A	102	56	168	48	120	2.0	0.0	2.0
chr16:4114363:C:T	0	0	0	0	0	0	0	0
chr16:4195692:A:G	0	0	0	0	0	0	0	0
chr16:4260467:C:G	32	19	53	15	38	2.0	0.0	2.0
chr16:4337260:A:C	0	0	0	0	0	0	0	0
chr16:4337423:ACG:GCA	0	0	0	0	0	0	0	0
chr16:4575469:C:G	0	0	0	0	0	0	0	0
chr16:4664638:T:C	7	5	13	3	10	2	0	2
chr16:4686315:C:T	6	3	9	3	6	1.5	0.5	1.0
chr16:4698824:C:T	29	13	42	16	26	1	1	0
chr16:4701044:C:T	24	8	32	16	16	1.0	1.0	0.0
chr16:4702133:A:G	35	18	53	17	36	2	0	2
chr16:4747355:G:A	5	5	10	0	10	2	0	2
chr16:4765601:T:C	41	24	67	19	48	2	0	2
chr16:4796067:T:C	0	0	0	0	0	0	0	0
chr16:5000896:G:C	0	0	0	0	0	0	0	0
chr16:5025541:G:A	125	69	201	61	140	2	0	2
chr16:5025632:G:A	110	47	161	63	98	1.0	1.0	0.0
chr16:5030522:C:T	1	0	1	1	0	1	1	0
chr16:5056183:C:T	0	0	0	0	0	0	0	0
chr16:8537742:C:T	0	0	0	0	0	0	0	0
chr16:8635267:G:A	32	13	46	20	26	1.0	1.0	0.0
chr16:8644493:C:T	3	3	6	0	6	2	0	2
chr16:8735858:T:C	5	2	7	3	4	1	1	0
chr16:8746097:A:G	40	29	75	11	64	2.0	0.0	2.0
chr16:8898485:G:A	12	5	17	7	10	1.0	1.0	0.0
chr16:8902070:G:A	21	14	36	8	28	2	0	2
chr16:10676101:T:C	1	0	1	1	0	1	1	0
chr16:10681998:G:A	1	0	1	1	0	1	1	0
chr16:10694549:G:T	0	0	0	0	0	0	0	0
chr16:10761882:G:A	17	15	32	2	30	2	0	2
chr16:10768057:T:C	85	60	154	28	126	2	0	2
chr16:10901993:G:T	10	4	14	6	8	1.0	1.0	0.0
chr16:10923201:G:A	12	3	15	9	6	1.0	1.0	0.0
chr16:10962521:C:T	196	113	314	86	228	2.0	0.0	2.0
chr16:11042191:C:G	4	1	5	3	2	1.0	1.0	0.0
chr16:11044121:A:G	34	16	53	19	34	1.5	1.0	0.0
chr16:11060913:G:A	7	0	7	7	0	1	1	0
chr16:11269146:C:G	0	0	0	0	0	0	0	0
chr16:11887630:G:A	183	78	274	112	162	1	1	0
chr16:12803721:G:T	61	22	87	41	46	1	1	0
chr16:13203385:C:T	0	0	0	0	0	0	0	0
chr16:15034211:G:T	1	0	1	1	0	1	1	0
chr16:15036113:A:G	20	10	30	10	20	1.5	0.5	1.0
chr16:15040032:T:G	713	349	1194	437	757	2	1	0
chr16:15586785:C:T	0	0	0	0	0	0	0	0
chr16:15717166:C:T	1	1	2	0	2	2	0	2
chr16:15717205:C:T	1	1	2	0	2	2	0	2
chr16:15724284:A:C	358	168	548	206	342	1.0	1.0	0.0
chr16:15724453:G:A	364	169	553	211	342	1.0	1.0	0.0
chr16:15726878:C:T	132	58	197	77	120	1.0	1.0	0.0
chr16:15727006:C:T	21	3	25	19	6	1	1	0
chr16:15745177:G:A	2	1	3	1	2	1.5	0.5	1.0
chr16:15756347:A:G	6	4	12	2	10	2.0	0.0	2.0
chr16:15823340:G:A	0	0	0	0	0	0	0	0
chr16:17108944:G:A	3	0	3	3	0	1	1	0
chr16:17198217:G:C	11	7	18	4	14	2	0	2
chr16:18394567:G:C	0	0	0	0	0	0	0	0
chr16:18828040:T:C	18	9	27	9	18	1.5	0.5	1.0
chr16:18838536:C:T	0	0	0	0	0	0	0	0
chr16:18850013:A:G	14	6	20	8	12	1.0	1.0	0.0
chr16:18854886:C:G	24	15	39	9	30	2.0	0.0	2.0
chr16:18896107:G:T	106	51	162	58	104	2.0	1.0	0.0
chr16:19309138:A:C	0	0	0	0	0	0	0	0
chr16:19444146:G:T	0	0	0	0	0	0	0	0
chr16:19487243:A:G	0	0	0	0	0	0	0	0
chr16:19536708:T:A	48	23	72	26	46	1.5	1.0	0.0
chr16:19536794:G:A	33	21	54	12	42	2	0	2
chr16:19536968:G:A	34	20	57	15	42	2.0	0.0	2.0
chr16:19542628:A:C	19	11	30	8	22	2	0	2
chr16:19548067:G:C	3	3	6	0	6	2	0	2
chr16:19569389:G:C	2	0	2	2	0	1.0	1.0	0.0
chr16:19669224:T:C	18	7	25	11	14	1.0	1.0	0.0
chr16:19710409:A:G	6	5	11	1	10	2.0	0.0	2.0
chr16:19710433:C:T	5	4	9	1	8	2	0	2
chr16:19710484:C:T	5	4	9	1	8	2	0	2
chr16:19735518:C:T	0	0	0	0	0	0	0	0
chr16:19872042:G:A	0	0	0	0	0	0	0	0
chr16:20399166:G:A	0	0	0	0	0	0	0	0
chr16:20399225:C:T	0	0	0	0	0	0	0	0
chr16:20429731:C:G	0	0	0	0	0	0	0	0
chr16:20429755:A:G	0	0	0	0	0	0	0	0
chr16:20483086:C:T	0	0	0	0	0	0	0	0
chr16:20564726:C:A	0	0	0	0	0	0	0	0
chr16:20604353:T:C	0	0	0	0	0	0	0	0
chr16:20623453:T:C	4	3	7	1	6	2.0	0.0	2.0
chr16:20627254:A:T	7	6	13	1	12	2	0	2
chr16:20737009:C:A	301	144	483	171	312	1	1	0
chr16:20738815:C:T	168	87	270	88	182	2.0	1.0	2.0
chr16:20797961:C:A	2	1	3	1	2	1.5	0.5	1.0
chr16:20798745:T:C	5	3	8	2	6	2	0	2
chr16:20954951:G:A	0	0	0	0	0	0	0	0
chr16:20954969:G:T	0	0	0	0	0	0	0	0
chr16:20955040:T:C	0	0	0	0	0	0	0	0
chr16:20964183:T:C	0	0	0	0	0	0	0	0
chr16:20969840:T:C	2	2	4	0	4	2.0	0.0	2.0
chr16:21261270:G:C	6	2	8	4	4	1.0	1.0	0.0
chr16:21261965:A:G	0	0	0	0	0	0	0	0
chr16:21376789:T:C	5	4	9	1	8	2	0	2
chr16:21687628:C:T	0	0	0	0	0	0	0	0
chr16:21962592:G:A	8	4	12	4	8	1.5	0.5	1.0
chr16:22126282:G:A	0	0	0	0	0	0	0	0
chr16:22132997:C:T	0	0	0	0	0	0	0	0
chr16:22144308:A:G	3	2	6	2	4	2	0	2
chr16:22251193:C:A	13	6	20	8	12	2	1	0
chr16:22309556:G:T	16	8	26	8	18	1.5	0.5	1.0
chr16:23348878:T:C	0	0	0	0	0	0	0	0
chr16:23371926:G:A	0	0	0	0	0	0	0	0
chr16:23525210:C:T	4	3	7	1	6	2.0	0.0	2.0
chr16:23710959:G:A	0	0	0	0	0	0	0	0
chr16:24361836:G:A	0	0	0	0	0	0	0	0
chr16:24572085:A:G	458	240	827	270	557	2.0	1.0	2.0
chr16:24777324:T:A	56	24	95	34	61	1.0	1.0	0.0
chr16:24790416:G:A	29	10	39	19	20	1	1	0
chr16:24790658:C:T	40	24	67	19	48	2.0	0.0	2.0
chr16:24805171:A:G	6	5	11	1	10	2.0	0.0	2.0
chr16:24823847:G:A	52	26	80	28	52	2.0	0.5	1.0
chr16:24877325:T:C	0	0	0	0	0	0	0	0
chr16:25228484:G:C	0	0	0	0	0	0	0	0
chr16:25228551:G:C	0	0	0	0	0	0	0	0
chr16:25244185:C:T	4	1	5	3	2	1.0	1.0	0.0
chr16:25246714:A:G	19	8	29	11	18	1	1	0
chr16:25257047:A:G	29	13	43	17	26	1	1	0
chr16:27220419:G:C	5	3	8	2	6	2	0	2
chr16:28111905:G:A	24	12	36	12	24	1.5	0.5	1.0
chr16:28317595:C:T	0	0	0	0	0	0	0	0
chr16:29104256:G:C	8	3	11	5	6	1.0	1.0	0.0
chr16:29819508:T:C	140	84	234	62	172	2.0	0.0	2.0
chr16:29861040:G:A	2	1	3	1	2	1.5	0.5	1.0
chr16:29912189:G:A	6	5	11	1	10	2.0	0.0	2.0
chr16:29983601:C:T	12	7	19	5	14	2.0	0.0	2.0
chr16:29986879:A:G	2	2	6	0	6	3.0	0.0	3.0
chr16:30007179:C:T	0	0	0	0	0	0	0	0
chr16:30007399:C:T	0	0	0	0	0	0	0	0
chr16:30010081:C:T	0	0	0	0	0	0	0	0
chr16:30025807:A:C	0	0	0	0	0	0	0	0
chr16:30086309:C:T	1	0	1	1	0	1	1	0
chr16:30186830:A:G	1379	843	3200	977	2223	2	1	2
chr16:30481502:C:T	21	6	29	15	14	1	1	0
chr16:30499250:C:T	2	0	2	2	0	1.0	1.0	0.0
chr16:30505171:A:G	5	3	8	2	6	2	0	2
chr16:30506775:C:T	2	1	3	1	2	1.5	0.5	1.0
chr16:30525351:A:G	28	13	42	16	26	1.5	1.0	0.0
chr16:30525597:C:G	27	12	39	15	24	1	1	0
chr16:30655046:C:T	117	58	177	61	116	2	1	0
chr16:30985550:CG:GC	1	0	1	1	0	1	1	0
chr16:30987821:A:G	4	2	7	3	4	1.5	1.0	1.0
chr16:30988141:T:C	4	2	7	3	4	1.5	1.0	1.0
chr16:31033576:G:A	409	207	667	231	436	2	1	2
chr16:31063854:G:A	17	13	30	4	26	2	0	2
chr16:31077026:G:A	6	2	8	4	4	1.0	1.0	0.0
chr16:31077304:A:G	7	5	12	2	10	2	0	2
chr16:31079086:G:C	3	0	3	3	0	1	1	0
chr16:31079888:T:C	1	0	1	1	0	1	1	0
chr16:31080754:G:A	8	3	11	5	6	1.0	1.0	0.0
chr16:31081439:G:A	17	7	24	10	14	1	1	0
chr16:31083850:C:T	12	6	18	6	12	1.5	0.5	1.0
chr16:31083883:G:C	11	6	17	5	12	2	0	2
chr16:31084843:G:C	7	3	10	4	6	1	1	0
chr16:31110472:G:A	181	73	260	114	146	1	1	0
chr16:31130672:C:T	21	7	30	14	16	1	1	0
chr16:31325398:G:A	14	8	22	6	16	2.0	0.0	2.0
chr16:31325567:C:T	16	6	22	10	12	1.0	1.0	0.0
chr16:31331684:C:T	29	18	49	13	36	2	0	2
chr16:31403683:C:T	0	0	0	0	0	0	0	0
chr16:31424045:GA:AG	0	0	0	0	0	0	0	0
chr16:31459219:T:C	92	43	136	50	86	1.0	1.0	0.0
chr16:31464865:C:G	9	3	12	6	6	1	1	0
chr16:31465137:C:T	5	3	8	2	6	2	0	2
chr16:31477595:C:G	4	3	7	1	6	2.0	0.0	2.0
chr16:31528613:G:T	0	0	0	0	0	0	0	0
chr16:31569209:A:C	5	0	5	5	0	1	1	0
chr16:32919785:G:A	0	0	0	0	0	0	0	0
chr16:34268483:C:T	0	0	0	0	0	0	0	0
chr16:34268522:C:A	0	0	0	0	0	0	0	0
chr16:49280926:T:G	0	0	0	0	0	0	0	0
chr16:49635885:G:A	0	0	0	0	0	0	0	0
chr16:49637266:T:C	0	0	0	0	0	0	0	0
chr16:49637307:C:T	0	0	0	0	0	0	0	0
chr16:50025257:G:C	103	53	158	52	106	2	0	2
chr16:50025589:C:T	33	20	53	13	40	2	0	2
chr16:50308747:C:T	30	21	52	10	42	2.0	0.0	2.0
chr16:50668046:G:A	2	2	4	0	4	2.0	0.0	2.0
chr16:50697185:G:A	0	0	0	0	0	0	0	0
chr16:50699948:C:G	52	27	82	26	56	2.0	0.5	2.0
chr16:50710713:C:T	10	5	15	5	10	1.5	0.5	1.0
chr16:50711288:C:T	5	4	9	1	8	2	0	2
chr16:50711672:T:G	9	4	13	5	8	1	1	0
chr16:50723365:G:A	10	4	14	6	8	1.0	1.0	0.0
chr16:51140318:G:A	0	0	0	0	0	0	0	0
chr16:53370291:C:A	0	0	0	0	0	0	0	0
chr16:55485623:G:C	0	0	0	0	0	0	0	0
chr16:55493201:G:A	0	0	0	0	0	0	0	0
chr16:55567476:A:G	0	0	0	0	0	0	0	0
chr16:55671926:G:A	0	0	0	0	0	0	0	0
chr16:55833130:A:C	0	0	0	0	0	0	0	0
chr16:55846411:G:A	0	0	0	0	0	0	0	0
chr16:55875251:T:C	0	0	0	0	0	0	0	0
chr16:56334777:C:T	0	0	0	0	0	0	0	0
chr16:56902407:C:T	6	1	7	5	2	1.0	1.0	0.0
chr16:56904332:G:A	0	0	0	0	0	0	0	0
chr16:56904475:C:T	4	0	4	4	0	1.0	1.0	0.0
chr16:56932159:T:G	1500	805	3424	1232	2192	2.0	1.0	2.0
chr16:56982180:G:A	8	0	8	8	0	1.0	1.0	0.0
chr16:56983750:G:A	5	4	9	1	8	2	0	2
chr16:57046616:C:A	42	21	67	23	44	2.0	0.5	1.0
chr16:57059524:G:T	73	33	115	43	72	1	1	0
chr16:57081070:C:T	48	25	75	25	50	2.0	0.5	2.0
chr16:57430324:G:A	135	66	206	74	132	2	1	0
chr16:57451005:G:A	0	0	0	0	0	0	0	0
chr16:57451068:G:A	168	88	265	83	182	2.0	0.0	2.0
chr16:57469301:C:T	5	1	6	4	2	1	1	0
chr16:57473330:C:G	0	0	0	0	0	0	0	0
chr16:57663620:T:G	0	0	0	0	0	0	0	0
chr16:57701988:G:C	0	0	0	0	0	0	0	0
chr16:57707700:G:C	0	0	0	0	0	0	0	0
chr16:57722731:C:T	0	0	0	0	0	0	0	0
chr16:57726787:G:A	0	0	0	0	0	0	0	0
chr16:57737214:G:T	19	10	29	9	20	2	0	2
chr16:57752605:C:T	0	0	0	0	0	0	0	0
chr16:57752799:C:T	10	4	14	6	8	1.0	1.0	0.0
chr16:57757008:T:C	58	31	93	29	64	2.0	0.0	2.0
chr16:57761482:G:A	0	0	0	0	0	0	0	0
chr16:57771264:A:G	0	0	0	0	0	0	0	0
chr16:57816237:C:G	0	0	0	0	0	0	0	0
chr16:57904851:A:G	0	0	0	0	0	0	0	0
chr16:57916153:G:A	0	0	0	0	0	0	0	0
chr16:57963028:G:A	0	0	0	0	0	0	0	0
chr16:57967182:C:T	0	0	0	0	0	0	0	0
chr16:57985492:G:A	0	0	0	0	0	0	0	0
chr16:57987491:A:C	0	0	0	0	0	0	0	0
chr16:57996497:T:C	2	0	2	2	0	1.0	1.0	0.0
chr16:57996730:C:T	2	0	2	2	0	1.0	1.0	0.0
chr16:58010155:T:G	5	4	9	1	8	2	0	2
chr16:58011565:G:A	11	7	19	4	15	2	0	2
chr16:58017274:C:T	5	1	6	4	2	1	1	0
chr16:58284700:T:C	0	0	0	0	0	0	0	0
chr16:58293742:A:G	0	0	0	0	0	0	0	0
chr16:58510736:C:G	1	0	1	1	0	1	1	0
chr16:58511522:A:G	0	0	0	0	0	0	0	0
chr16:58516580:G:A	50	23	73	27	46	1.0	1.0	0.0
chr16:58519017:G:A	71	34	108	38	70	1	1	0
chr16:58532400:G:A	4	1	5	3	2	1.0	1.0	0.0
chr16:58539997:G:A	18	8	30	10	20	1.0	1.0	0.0
chr16:58543517:C:T	19	9	28	10	18	1	1	0
chr16:58545370:C:T	30	14	45	17	28	1.5	1.0	0.0
chr16:58583080:T:C	61	43	105	19	86	2	0	2
chr16:58709550:A:C	32	18	52	14	38	2.0	0.0	2.0
chr16:58716700:G:A	15	8	23	7	16	2	0	2
chr16:58734269:C:G	98	53	154	48	106	2.0	0.0	2.0
chr16:64982225:A:T	0	0	0	0	0	0	0	0
chr16:66379292:G:A	0	0	0	0	0	0	0	0
chr16:66550099:T:C	62	30	95	33	62	1.5	1.0	0.0
chr16:66550210:T:C	19	11	30	8	22	2	0	2
chr16:66566576:G:A	10	1	12	10	2	1.0	1.0	0.0
chr16:66579622:G:A	0	0	0	0	0	0	0	0
chr16:66580105:T:C	1	1	2	0	2	2	0	2
chr16:66612688:C:T	221	92	331	141	190	1	1	0
chr16:67304454:A:T	0	0	0	0	0	0	0	0
chr16:67648331:G:A	0	0	0	0	0	0	0	0
chr16:67649661:C:G	2	1	3	1	2	1.5	0.5	1.0
chr16:67649723:G:A	1	0	1	1	0	1	1	0
chr16:67657574:A:T	222	122	371	109	262	2.0	0.0	2.0
chr16:67657742:G:T	35	25	62	12	50	2	0	2
chr16:67807226:T:G	1	0	1	1	0	1	1	0
chr16:67868423:A:T	31	12	45	19	26	1	1	0
chr16:67877614:T:C	11	6	17	5	12	2	0	2
chr16:67886146:G:A	13	7	20	6	14	2	0	2
chr16:67930300:T:C	29	10	45	21	24	1	1	0
chr16:67936027:A:G	1889	1156	4216	1326	2890	2	1	2
chr16:67945520:G:T	16	11	27	5	22	2.0	0.0	2.0
chr16:67964017:T:C	0	0	0	0	0	0	0	0
chr16:68021592:G:C	188	108	306	88	218	2.0	0.0	2.0
chr16:68054582:A:G	141	83	247	67	180	2	0	2
chr16:68310793:C:T	512	261	832	282	550	2.0	1.0	2.0
chr16:68353470:C:T	15	12	27	3	24	2	0	2
chr16:68355869:C:T	59	34	93	25	68	2	0	2
chr16:68357286:C:G	2	1	3	1	2	1.5	0.5	1.0
chr16:68361191:G:A	0	0	0	0	0	0	0	0
chr16:68363627:T:G	0	0	0	0	0	0	0	0
chr16:68365021:C:T	0	0	0	0	0	0	0	0
chr16:68563127:C:T	233	135	397	108	289	2	0	2
chr16:68679920:C:A	2	1	3	1	2	1.5	0.5	1.0
chr16:68687567:T:C	0	0	0	0	0	0	0	0
chr16:68687630:G:C	0	0	0	0	0	0	0	0
chr16:68691880:G:A	0	0	0	0	0	0	0	0
chr16:68695882:C:A	1	1	2	0	2	2	0	2
chr16:69339820:A:G	329	170	520	181	339	2	1	1
chr16:70253274:A:G	64	34	102	32	70	2.0	0.0	2.0
chr16:70473004:T:C	1	0	1	1	0	1	1	0
chr16:70512255:T:C	104	47	150	57	93	1.0	1.0	0.0
chr16:70512331:G:A	108	48	156	60	96	1.0	1.0	0.0
chr16:70535312:A:T	89	49	142	42	100	2	0	2
chr16:70646947:C:G	1	0	1	1	0	1	1	0
chr16:70657086:G:C	0	0	0	0	0	0	0	0
chr16:70938692:T:C	0	0	0	0	0	0	0	0
chr16:71230620:T:A	0	0	0	0	0	0	0	0
chr16:71230658:A:G	0	0	0	0	0	0	0	0
chr16:71283865:G:C	7	4	11	3	8	2	0	2
chr16:71285636:C:T	42	24	71	21	50	2.0	0.0	2.0
chr16:71448078:A:G	33	22	62	12	50	2	0	2
chr16:71894790:C:T	121	71	209	57	152	2	0	2
chr16:71930021:C:T	45	18	66	28	38	1	1	0
chr16:71934024:C:T	3	0	3	3	0	1	1	0
chr16:71949873:G:C	0	0	0	0	0	0	0	0
chr16:71967211:G:A	0	0	0	0	0	0	0	0
chr16:71973500:C:T	0	0	0	0	0	0	0	0
chr16:71986235:T:C	0	0	0	0	0	0	0	0
chr16:72008713:C:T	19	5	25	15	10	1	1	0
chr16:72008736:A:G	19	14	35	5	30	2	0	2
chr16:72008783:A:C	120	44	177	80	97	1.0	1.0	0.0
chr16:72054568:A:G	0	0	0	0	0	0	0	0
chr16:72059235:C:A	1	0	1	1	0	1	1	0
chr16:72077049:C:G	1	0	1	1	0	1	1	0
chr16:72096304:C:G	417	192	662	258	404	1	1	0
chr16:72096916:C:A	401	184	634	248	386	1	1	0
chr16:72099221:G:A	34	13	48	22	26	1.0	1.0	0.0
chr16:72101115:T:C	15	8	25	7	18	2	0	2
chr16:72103662:G:A	4	0	4	4	0	1.0	1.0	0.0
chr16:72104213:G:T	0	0	0	0	0	0	0	0
chr16:72105285:C:A	10	4	15	7	8	1.5	1.0	0.0
chr16:72108696:C:A	0	0	0	0	0	0	0	0
chr16:72119226:C:G	2	0	2	2	0	1.0	1.0	0.0
chr16:72122943:T:G	4	2	6	2	4	1.5	0.5	1.0
chr16:72129067:G:T	2	1	3	1	2	1.5	0.5	1.0
chr16:72150667:C:T	0	0	0	0	0	0	0	0
chr16:72794405:C:A	0	0	0	0	0	0	0	0
chr16:72795527:C:T	0	0	0	0	0	0	0	0
chr16:72950769:C:T	0	0	0	0	0	0	0	0
chr16:72958322:G:A	0	0	0	0	0	0	0	0
chr16:72958370:G:A	0	0	0	0	0	0	0	0
chr16:72959932:A:C	1	1	2	0	2	2	0	2
chr16:74391460:G:A	1	0	1	1	0	1	1	0
chr16:74465691:G:A	91	46	149	51	98	2	1	2
chr16:74623885:A:G	5	2	7	3	4	1	1	0
chr16:74716498:T:C	3	2	5	1	4	2	0	2
chr16:74716507:G:A	3	2	5	1	4	2	0	2
chr16:74774527:G:A	15	12	29	3	26	2	0	2
chr16:75204205:C:T	0	0	0	0	0	0	0	0
chr16:75207037:G:C	0	0	0	0	0	0	0	0
chr16:75235369:A:G	0	0	0	0	0	0	0	0
chr16:75235579:A:C	0	0	0	0	0	0	0	0
chr16:75242877:G:A	0	0	0	0	0	0	0	0
chr16:75701441:C:T	0	0	0	0	0	0	0	0
chr16:75714293:A:C	5	1	6	4	2	1	1	0
chr16:76495079:T:C	0	0	0	0	0	0	0	0
chr16:76558736:G:A	0	0	0	0	0	0	0	0
chr16:77194969:T:C	10	6	16	4	12	2.0	0.0	2.0
chr16:77212620:C:A	244	122	417	143	274	2.0	1.0	1.0
chr16:77289338:C:G	0	0	0	0	0	0	0	0
chr16:77291428:G:T	0	0	0	0	0	0	0	0
chr16:77320076:G:T	0	0	0	0	0	0	0	0
chr16:77326022:A:T	0	0	0	0	0	0	0	0
chr16:77367648:A:G	0	0	0	0	0	0	0	0
chr16:77735937:G:A	0	0	0	0	0	0	0	0
chr16:77876452:C:T	0	0	0	0	0	0	0	0
chr16:81061486:A:G	3	1	4	2	2	1	1	0
chr16:81108652:T:C	0	0	0	0	0	0	0	0
chr16:81112150:A:T	0	0	0	0	0	0	0	0
chr16:81127947:C:T	0	0	0	0	0	0	0	0
chr16:81128003:T:C	0	0	0	0	0	0	0	0
chr16:81139588:C:T	0	0	0	0	0	0	0	0
chr16:81147383:C:G	0	0	0	0	0	0	0	0
chr16:81147492:G:T	0	0	0	0	0	0	0	0
chr16:81149720:T:A	0	0	0	0	0	0	0	0
chr16:81164836:T:C	0	0	0	0	0	0	0	0
chr16:81165824:G:A	0	0	0	0	0	0	0	0
chr16:81168015:C:A	0	0	0	0	0	0	0	0
chr16:81168020:G:A	0	0	0	0	0	0	0	0
chr16:81174910:G:A	0	0	0	0	0	0	0	0
chr16:81177891:C:A	0	0	0	0	0	0	0	0
chr16:81177943:G:A	0	0	0	0	0	0	0	0
chr16:81179773:A:G	0	0	0	0	0	0	0	0
chr16:81185582:C:T	0	0	0	0	0	0	0	0
chr16:81198670:G:A	0	0	0	0	0	0	0	0
chr16:81198689:T:C	0	0	0	0	0	0	0	0
chr16:81198959:T:G	0	0	0	0	0	0	0	0
chr16:81215111:C:T	0	0	0	0	0	0	0	0
chr16:81216322:C:T	0	0	0	0	0	0	0	0
chr16:81216349:T:A	0	0	0	0	0	0	0	0
chr16:81220154:A:G	0	0	0	0	0	0	0	0
chr16:81220312:A:G	0	0	0	0	0	0	0	0
chr16:81693258:C:G	2	1	3	1	2	1.5	0.5	1.0
chr16:81895774:G:A	32	17	54	16	38	2.0	0.0	2.0
chr16:81895922:C:G	136	77	227	61	166	2.0	0.0	2.0
chr16:81907714:C:T	60	28	90	34	56	1.0	1.0	0.0
chr16:81937798:T:C	66	39	110	28	82	2.0	0.0	2.0
chr16:81938678:T:G	7	1	8	6	2	1	1	0
chr16:83959356:G:A	1	1	2	0	2	2	0	2
chr16:83961185:C:T	1	1	2	0	2	2	0	2
chr16:83966048:A:G	5	4	9	1	8	2	0	2
chr16:84016604:G:A	0	0	0	0	0	0	0	0
chr16:84041958:C:A	1	1	2	0	2	2	0	2
chr16:84054442:C:T	138	77	222	62	160	2.0	0.0	2.0
chr16:84056162:C:T	7	3	10	4	6	1	1	0
chr16:84059457:G:A	3	1	4	2	2	1	1	0
chr16:84081674:T:C	15	10	28	6	22	2	0	2
chr16:84081878:G:A	28	20	51	9	42	2.0	0.0	2.0
chr16:84081956:G:A	9	6	18	4	14	2	0	2
chr16:84101848:A:T	500	248	804	286	518	2.0	1.0	0.0
chr16:84170006:A:G	0	0	0	0	0	0	0	0
chr16:84170333:C:T	0	0	0	0	0	0	0	0
chr16:84174538:C:G	3	1	4	2	2	1	1	0
chr16:84174729:G:T	2	1	3	1	2	1.5	0.5	1.0
chr16:84175892:T:C	0	0	0	0	0	0	0	0
chr16:84176028:C:G	1	0	1	1	0	1	1	0
chr16:84176132:T:C	1	0	1	1	0	1	1	0
chr16:84176209:C:G	1	1	2	0	2	2	0	2
chr16:84176210:T:C	1	0	2	2	0	2	2	0
chr16:84176258:G:C	1	0	1	1	0	1	1	0
chr16:84177877:C:T	41	20	64	22	42	1	1	0
chr16:84178965:C:A	46	25	75	23	52	2.0	0.0	2.0
chr16:84179508:C:T	17	6	23	11	12	1	1	0
chr16:84179828:A:T	13	8	21	5	16	2	0	2
chr16:84180359:G:A	3	1	4	2	2	1	1	0
chr16:84180896:C:T	1	0	1	1	0	1	1	0
chr16:84181527:C:T	4	2	6	2	4	1.5	0.5	1.0
chr16:84181784:T:C	3	1	4	2	2	1	1	0
chr16:84182086:C:T	2	0	2	2	0	1.0	1.0	0.0
chr16:84194631:A:C	0	0	0	0	0	0	0	0
chr16:84194673:G:A	0	0	0	0	0	0	0	0
chr16:84195830:G:A	0	0	0	0	0	0	0	0
chr16:84195953:T:C	0	0	0	0	0	0	0	0
chr16:84195974:C:T	0	0	0	0	0	0	0	0
chr16:84368669:G:C	0	0	0	0	0	0	0	0
chr16:84459426:C:T	1	1	2	0	2	2	0	2
chr16:84459474:A:G	1	0	1	1	0	1	1	0
chr16:84459610:T:C	1	0	1	1	0	1	1	0
chr16:84460646:C:T	1	1	2	0	2	2	0	2
chr16:84460669:C:T	1	0	1	1	0	1	1	0
chr16:84460844:G:A	1	1	2	0	2	2	0	2
chr16:84461618:A:G	0	0	0	0	0	0	0	0
chr16:84462164:G:A	0	0	0	0	0	0	0	0
chr16:84479857:T:G	5	2	7	3	4	1	1	0
chr16:84482703:G:A	5	3	9	3	6	2	0	2
chr16:84486474:T:C	5	3	8	2	6	2	0	2
chr16:84486617:A:T	4	2	6	2	4	1.5	0.5	1.0
chr16:84486719:T:C	9	5	15	5	10	2	0	2
chr16:84489291:G:C	29	21	56	8	48	2	0	2
chr16:84760143:G:C	6	3	9	3	6	1.5	0.5	1.0
chr16:84838445:G:C	0	0	0	0	0	0	0	0
chr16:84845858:A:G	0	0	0	0	0	0	0	0
chr16:84976364:A:G	17	7	25	11	14	1	1	0
chr16:84978016:G:A	0	0	0	0	0	0	0	0
chr16:85067370:G:A	2	2	4	0	4	2.0	0.0	2.0
chr16:85087003:A:G	0	0	0	0	0	0	0	0
chr16:85099170:A:G	0	0	0	0	0	0	0	0
chr16:85112371:T:C	0	0	0	0	0	0	0	0
chr16:86532276:G:C	11	5	16	6	10	1	1	0
chr16:86532433:CGCG:TGCA	10	6	16	4	12	2.0	0.0	2.0
chr16:86541688:G:A	2	2	4	0	4	2.0	0.0	2.0
chr16:86542131:C:T	14	5	19	9	10	1.0	1.0	0.0
chr16:87311261:G:A	2	0	2	2	0	1.0	1.0	0.0
chr16:87411757:G:A	5	0	5	5	0	1	1	0
chr16:87460131:T:C	1	0	1	1	0	1	1	0
chr16:87644559:G:A	0	0	0	0	0	0	0	0
chr16:87644643:G:A	0	0	0	0	0	0	0	0
chr16:87690232:T:C	0	0	0	0	0	0	0	0
chr16:87708486:G:A	0	0	0	0	0	0	0	0
chr16:87708523:G:A	0	0	0	0	0	0	0	0
chr16:87730661:A:T	51	42	100	10	90	2	0	2
chr16:87748790:C:A	107	53	163	55	108	1	1	0
chr16:87984203:C:T	135	73	216	63	153	2	0	2
chr16:88018540:C:T	96	45	144	54	90	1.0	1.0	0.0
chr16:88018555:C:A	97	45	145	55	90	1	1	0
chr16:88027544:C:T	70	35	108	36	72	1.5	1.0	1.0
chr16:88429600:T:C	0	0	0	0	0	0	0	0
chr16:88430811:G:T	11	6	17	5	12	2	0	2
chr16:88439227:A:G	0	0	0	0	0	0	0	0
chr16:88439340:G:A	0	0	0	0	0	0	0	0
chr16:88439378:C:A	0	0	0	0	0	0	0	0
chr16:88528159:C:T	11	8	19	3	16	2	0	2
chr16:88532615:A:G	3	1	4	2	2	1	1	0
chr16:88533251:G:T	3	1	4	2	2	1	1	0
chr16:88535073:C:T	85	34	124	54	70	1	1	0
chr16:88622424:A:G	1	0	1	1	0	1	1	0
chr16:88646828:A:G	4044	3172	22594	8947	13647	5.0	2.0	2.0
chr16:88647065:G:A	125	100	229	28	201	2	0	2
chr16:88647093:A:G	126	101	234	28	206	2.0	0.0	2.0
chr16:88653469:C:G	4	3	7	1	6	2.0	0.0	2.0
chr16:88722526:AGGCG:GGGCA	1	1	2	0	2	2	0	2
chr16:88738210:G:A	0	0	0	0	0	0	0	0
chr16:88738775:G:A	0	0	0	0	0	0	0	0
chr16:88738823:G:A	0	0	0	0	0	0	0	0
chr16:88741733:T:C	0	0	0	0	0	0	0	0
chr16:88805821:A:G	3	1	4	2	2	1	1	0
chr16:88806103:T:C	3	1	4	2	2	1	1	0
chr16:88808224:C:G	4	2	6	2	4	1.5	0.5	1.0
chr16:88810258:C:G	55	31	86	24	62	2	0	2
chr16:88814403:C:T	138	70	216	70	146	2.0	0.5	2.0
chr16:88818058:C:T	71	32	106	40	66	1	1	0
chr16:88835775:G:A	42	14	57	29	28	1.0	1.0	0.0
chr16:88840875:G:T	1	1	2	0	2	2	0	2
chr16:88842620:C:T	0	0	0	0	0	0	0	0
chr16:88842687:G:A	0	0	0	0	0	0	0	0
chr16:88860813:T:C	13	7	20	6	14	2	0	2
chr16:88898149:C:G	17	9	26	8	18	2	0	2
chr16:89100987:C:T	127	56	189	73	116	1	1	0
chr16:89100996:T:C	128	56	190	74	116	1.0	1.0	0.0
chr16:89101023:G:C	127	56	189	73	116	1	1	0
chr16:89101035:T:C	128	56	190	74	116	1.0	1.0	0.0
chr16:89101050:C:A	128	56	190	74	116	1.0	1.0	0.0
chr16:89114475:G:A	104	43	151	63	88	1.0	1.0	0.0
chr16:89114527:G:T	4	0	4	4	0	1.0	1.0	0.0
chr16:89171782:G:A	0	0	0	0	0	0	0	0
chr16:89180262:T:C	0	0	0	0	0	0	0	0
chr16:89185368:G:A	0	0	0	0	0	0	0	0
chr16:89185390:C:T	0	0	0	0	0	0	0	0
chr16:89185443:A:G	0	0	0	0	0	0	0	0
chr16:89196249:G:A	0	0	0	0	0	0	0	0
chr16:89198693:C:T	0	0	0	0	0	0	0	0
chr16:89199058:A:G	0	0	0	0	0	0	0	0
chr16:89546629:G:A	9	2	11	7	4	1	1	0
chr16:89546715:A:G	62	27	93	37	56	1.0	1.0	0.0
chr16:89546825:A:C	1	1	2	0	2	2	0	2
chr16:89548126:C:T	74	41	127	35	92	2.0	0.0	2.0
chr16:89553740:A:G	3	1	4	2	2	1	1	0
chr16:89553920:G:A	50	20	70	30	40	1.0	1.0	0.0
chr16:89556997:C:T	90	47	143	45	98	2.0	0.0	2.0
chr16:89561052:T:G	4437	4364	248621	148910	99711	52	31	20
chr16:89561263:C:T	4446	4374	251778	150117	101661	53.0	31.0	20.0
chr16:89562462:C:G	48	26	75	23	52	2.0	0.0	2.0
chr16:89637016:A:G	30	17	47	13	34	2.0	0.0	2.0
chr16:89637957:G:C	149	60	259	109	150	1	1	0
chr16:89646766:C:T	1	0	1	1	0	1	1	0
chr16:89669515:G:C	93	10	112	90	22	1	1	0
chr16:89694084:C:G	3	1	4	2	2	1	1	0
chr16:89698141:G:A	45	25	70	20	50	2	0	2
chr16:89711353:C:T	7	4	11	3	8	2	0	2
chr16:89722903:G:A	9	6	15	3	12	2	0	2
chr16:89738853:A:G	25	15	40	10	30	2	0	2
chr16:89770491:T:C	4	4	8	0	8	2.0	0.0	2.0
chr16:89783072:C:T	8	3	11	5	6	1.0	1.0	0.0
chr16:89885989:C:T	1082	4	1373	1366	7	1.0	1.0	0.0
chr16:89898647:G:A	717	632	1583	112	1471	2	0	2
chr16:89900809:T:C	55	9	66	48	18	1	1	0
chr16:89911337:C:T	1015	254	1505	977	528	1	1	0
chr16:89919532:G:A	22	12	34	10	24	2.0	0.0	2.0
chr16:89919736:C:T	26	10	36	16	20	1.0	1.0	0.0
chr16:89920200:A:G	38	24	63	15	48	2.0	0.0	2.0
chr16:89933636:C:T	0	0	0	0	0	0	0	0
chr16:89949552:G:C	27	26	57	1	56	2	0	2
chr16:89959232:G:C	486	210	832	352	480	2.0	1.0	0.0
chr16:89971961:A:G	49	25	74	24	50	2	0	2
chr16:90008818:C:T	24	9	33	15	18	1.0	1.0	0.0
chr16:90036679:C:T	2	0	2	2	0	1.0	1.0	0.0
chr16:90036709:G:A	2	0	2	2	0	1.0	1.0	0.0
chr16:90037251:G:A	14	5	19	9	10	1.0	1.0	0.0
chr16:90040338:C:T	17	5	22	12	10	1	1	0
chr16:90042424:C:T	2	1	3	1	2	1.5	0.5	1.0
chr16:90060585:A:G	0	0	0	0	0	0	0	0
chr16:90063728:C:T	0	0	0	0	0	0	0	0
chr16:90094657:A:T	0	0	0	0	0	0	0	0
chr16:90095518:T:C	0	0	0	0	0	0	0	0
chr16:90095551:C:T	0	0	0	0	0	0	0	0
chr16:90095778:T:C	0	0	0	0	0	0	0	0
chr16:90106322:T:C	0	0	0	0	0	0	0	0
chr16:90106346:G:T	0	0	0	0	0	0	0	0
chr17:137603:C:T	0	0	0	0	0	0	0	0
chr17:215819:G:T	12	12	24	0	24	2.0	0.0	2.0
chr17:327568:G:T	2	0	2	2	0	1.0	1.0	0.0
chr17:331688:C:A	0	0	0	0	0	0	0	0
chr17:537247:A:G	2	1	3	1	2	1.5	0.5	1.0
chr17:562535:G:A	29	14	43	15	28	1	1	0
chr17:714753:C:T	278	160	454	130	324	2.0	0.0	2.0
chr17:1280060:T:C	0	0	0	0	0	0	0	0
chr17:1280170:A:G	0	0	0	0	0	0	0	0
chr17:1456069:T:G	114	67	188	52	136	2.0	0.0	2.0
chr17:1470224:T:C	3	2	6	2	4	2	0	2
chr17:1474649:A:G	1	1	2	0	2	2	0	2
chr17:1516559:C:A	273	147	436	132	304	2	0	2
chr17:1576642:C:T	37	17	57	21	36	1	1	0
chr17:1636733:C:T	2	2	4	0	4	2.0	0.0	2.0
chr17:1673075:C:T	54	22	80	34	46	1.0	1.0	0.0
chr17:1675454:T:C	24	13	37	11	26	2.0	0.0	2.0
chr17:1675645:C:T	46	26	73	21	52	2.0	0.0	2.0
chr17:1677635:G:C	18	6	26	12	14	1.0	1.0	0.0
chr17:1681030:A:G	156	80	244	78	166	2.0	0.5	2.0
chr17:1681836:A:G	205	112	328	98	230	2	0	2
chr17:1726675:C:T	2	2	4	0	4	2.0	0.0	2.0
chr17:1726914:C:T	1	0	1	1	0	1	1	0
chr17:1727101:T:C	0	0	0	0	0	0	0	0
chr17:1727290:A:G	2	1	3	1	2	1.5	0.5	1.0
chr17:1733640:A:G	8	5	13	3	10	2.0	0.0	2.0
chr17:1737415:C:T	57	23	81	35	46	1	1	0
chr17:1745000:C:T	0	0	0	0	0	0	0	0
chr17:1858152:G:A	12	5	19	7	12	1.0	1.0	0.0
chr17:1937174:C:T	0	0	0	0	0	0	0	0
chr17:2040586:C:G	61	26	91	39	52	1	1	0
chr17:2041931:T:G	22	10	34	12	22	1.0	1.0	0.0
chr17:2363505:G:A	8	3	11	5	6	1.0	1.0	0.0
chr17:2363518:T:C	8	3	11	5	6	1.0	1.0	0.0
chr17:2364845:G:C	0	0	0	0	0	0	0	0
chr17:2365017:G:A	6	2	8	4	4	1.0	1.0	0.0
chr17:2379545:T:C	5	3	8	2	6	2	0	2
chr17:2380373:AG:GC	34	14	52	22	30	1.0	1.0	0.0
chr17:2395321:T:C	129	60	206	75	131	2	1	0
chr17:2690678:G:A	19	10	29	9	20	2	0	2
chr17:2980294:C:A	7	1	8	6	2	1	1	0
chr17:3026098:G:A	1	1	2	0	2	2	0	2
chr17:3027045:G:A	1	1	2	0	2	2	0	2
chr17:3063251:C:T	0	0	0	0	0	0	0	0
chr17:3197533:T:C	0	0	0	0	0	0	0	0
chr17:3198284:G:T	0	0	0	0	0	0	0	0
chr17:3198296:C:T	0	0	0	0	0	0	0	0
chr17:3198397:G:T	0	0	0	0	0	0	0	0
chr17:3216379:A:G	0	0	0	0	0	0	0	0
chr17:3278090:C:T	0	0	0	0	0	0	0	0
chr17:3421516:A:G	0	0	0	0	0	0	0	0
chr17:3433763:A:G	0	0	0	0	0	0	0	0
chr17:3449000:A:G	0	0	0	0	0	0	0	0
chr17:3449037:C:T	0	0	0	0	0	0	0	0
chr17:3513959:A:G	0	0	0	0	0	0	0	0
chr17:3532786:C:T	0	0	0	0	0	0	0	0
chr17:3542607:T:G	1	0	1	1	0	1	1	0
chr17:3543591:T:C	1	1	2	0	2	2	0	2
chr17:3589906:C:G	4	1	5	3	2	1.0	1.0	0.0
chr17:3656529:G:A	5	4	9	1	8	2	0	2
chr17:3660774:G:A	13	7	20	6	14	2	0	2
chr17:3660779:A:G	13	7	20	6	14	2	0	2
chr17:3660790:T:C	13	7	19	6	13	1	0	1
chr17:3724369:G:A	2	1	3	1	2	1.5	0.5	1.0
chr17:3826208:T:A	412	205	696	246	450	2.0	1.0	0.0
chr17:3903750:T:C	67	25	94	44	50	1	1	0
chr17:3941493:C:G	33	12	45	22	23	1	1	0
chr17:3942633:A:G	28	16	44	12	32	2.0	0.0	2.0
chr17:3943508:A:G	24	14	38	10	28	2.0	0.0	2.0
chr17:3944719:A:C	29	16	45	13	32	2	0	2
chr17:3953321:A:G	53	28	82	26	56	2	0	2
chr17:4013529:G:A	22	14	36	8	28	2.0	0.0	2.0
chr17:4049789:T:C	5	1	6	4	2	1	1	0
chr17:4049808:A:G	7	1	8	6	2	1	1	0
chr17:4062770:A:G	19	8	27	11	16	1	1	0
chr17:4072781:C:G	3	1	4	2	2	1	1	0
chr17:4104727:T:C	17	10	27	7	20	2	0	2
chr17:4156939:G:A	140	73	223	69	154	2.0	0.0	2.0
chr17:4157188:G:T	171	90	277	87	190	2	0	2
chr17:4179947:T:C	18	11	29	7	22	2.0	0.0	2.0
chr17:4448265:G:A	1	1	2	0	2	2	0	2
chr17:4453080:G:T	1	1	3	1	2	3	1	2
chr17:4536217:A:G	0	0	0	0	0	0	0	0
chr17:4555303:G:C	48	19	68	30	38	1.0	1.0	0.0
chr17:4558172:G:A	0	0	0	0	0	0	0	0
chr17:4558453:G:A	0	0	0	0	0	0	0	0
chr17:4559728:G:A	0	0	0	0	0	0	0	0
chr17:4560404:G:A	0	0	0	0	0	0	0	0
chr17:4560501:G:A	0	0	0	0	0	0	0	0
chr17:4593865:T:C	0	0	0	0	0	0	0	0
chr17:4595316:G:A	0	0	0	0	0	0	0	0
chr17:4715918:C:T	0	0	0	0	0	0	0	0
chr17:4719343:C:T	130	73	208	62	146	2.0	0.0	2.0
chr17:4733270:T:G	343	173	583	201	382	2	1	2
chr17:4734591:G:A	56	37	93	19	74	2.0	0.0	2.0
chr17:4735189:T:C	52	35	87	17	70	2.0	0.0	2.0
chr17:4735268:G:A	56	35	91	21	70	2.0	0.0	2.0
chr17:4735442:A:G	55	35	91	21	70	2	0	2
chr17:4738460:C:T	53	32	86	22	64	2	0	2
chr17:4739492:C:A	58	36	95	23	72	2.0	0.0	2.0
chr17:4780800:G:A	0	0	0	0	0	0	0	0
chr17:4783119:A:C	0	0	0	0	0	0	0	0
chr17:4786277:T:C	2	2	4	0	4	2.0	0.0	2.0
chr17:4789759:G:A	9	2	11	7	4	1	1	0
chr17:4796257:G:A	1791	1093	3694	1212	2482	2	1	2
chr17:4809100:A:T	12	9	14	4	10	1.0	0.0	1.0
chr17:4815481:G:A	6	1	7	5	2	1.0	1.0	0.0
chr17:4816836:C:G	0	0	0	0	0	0	0	0
chr17:4817174:C:T	4	2	6	2	4	1.5	0.5	1.0
chr17:4818081:A:G	4	1	5	3	2	1.0	1.0	0.0
chr17:4893361:T:C	2	1	3	1	2	1.5	0.5	1.0
chr17:4898592:A:G	11	7	18	4	14	2	0	2
chr17:4898671:G:A	23	15	40	8	32	2	0	2
chr17:4899022:T:C	20	13	33	7	26	2.0	0.0	2.0
chr17:4901872:C:T	2	2	4	0	4	2.0	0.0	2.0
chr17:4902094:G:A	0	0	0	0	0	0	0	0
chr17:4902142:C:A	0	0	0	0	0	0	0	0
chr17:4932600:T:C	1	0	1	1	0	1	1	0
chr17:4953081:A:G	14	7	21	7	14	1.5	0.5	1.0
chr17:4959711:G:A	71	31	103	41	62	1	1	0
chr17:4972271:T:C	13	5	18	8	10	1	1	0
chr17:4980155:T:C	3	0	3	3	0	1	1	0
chr17:4988392:C:T	19	8	28	12	16	1	1	0
chr17:4988881:C:G	4	3	7	1	6	2.0	0.0	2.0
chr17:5001269:T:C	16	10	26	6	20	2.0	0.0	2.0
chr17:5023587:A:G	10	3	13	7	6	1.0	1.0	0.0
chr17:5033677:G:A	0	0	0	0	0	0	0	0
chr17:5132362:G:T	0	0	0	0	0	0	0	0
chr17:5135843:C:T	1	0	1	1	0	1	1	0
chr17:5139420:G:A	2	0	3	3	0	1.5	1.5	0.0
chr17:5139542:C:T	3	0	3	3	0	1	1	0
chr17:5139599:T:C	3	0	3	3	0	1	1	0
chr17:5155513:G:A	0	0	0	0	0	0	0	0
chr17:5169021:C:T	2	2	4	0	4	2.0	0.0	2.0
chr17:5169038:T:G	2	0	2	2	0	1.0	1.0	0.0
chr17:5182598:C:T	3	1	4	2	2	1	1	0
chr17:5183745:A:G	29	11	42	18	24	1	1	0
chr17:5223379:A:G	564	272	948	355	593	2.0	1.0	0.0
chr17:5223394:G:A	570	273	962	362	600	2.0	1.0	0.0
chr17:5223473:G:A	27	16	46	12	34	2	0	2
chr17:6088024:C:T	0	0	0	0	0	0	0	0
chr17:6426748:T:C	0	0	0	0	0	0	0	0
chr17:6461433:A:G	0	0	0	0	0	0	0	0
chr17:6478619:G:A	0	0	0	0	0	0	0	0
chr17:6579726:T:C	9	4	13	5	8	1	1	0
chr17:6589878:T:C	3	1	4	2	2	1	1	0
chr17:6608461:A:G	3	1	4	2	2	1	1	0
chr17:6610009:G:A	3	1	4	2	2	1	1	0
chr17:6612067:A:G	6	3	9	3	6	1.5	0.5	1.0
chr17:6620978:T:A	7	2	9	5	4	1	1	0
chr17:6628328:A:G	62	20	83	43	40	1.0	1.0	0.0
chr17:6635035:G:A	73	45	122	30	92	2	0	2
chr17:6642939:T:C	12	6	18	6	12	1.5	0.5	1.0
chr17:6650263:G:A	90	66	161	25	136	2.0	0.0	2.0
chr17:6687779:A:T	1	0	1	1	0	1	1	0
chr17:6687830:C:T	1	0	1	1	0	1	1	0
chr17:6756005:A:G	12	7	19	5	14	2.0	0.0	2.0
chr17:6758265:T:C	51	24	79	29	50	2	1	0
chr17:6760576:C:G	1815	1087	3965	1231	2734	2	1	2
chr17:6996181:G:T	7	4	11	3	8	2	0	2
chr17:6999424:G:A	17	14	31	3	28	2	0	2
chr17:7001615:A:G	34	9	43	25	18	1.0	1.0	0.0
chr17:7001742:T:G	32	24	56	8	48	2.0	0.0	2.0
chr17:7010333:G:A	1	1	2	0	2	2	0	2
chr17:7028489:G:C	1	0	1	1	0	1	1	0
chr17:7038789:C:T	8	3	11	5	6	1.0	1.0	0.0
chr17:7039947:G:A	7	2	9	5	4	1	1	0
chr17:7107810:C:T	0	0	0	0	0	0	0	0
chr17:7107825:G:A	0	0	0	0	0	0	0	0
chr17:7108754:GGCCCCC:TGCCTCT	0	0	0	0	0	0	0	0
chr17:7221449:T:C	3	0	3	3	0	1	1	0
chr17:7224399:T:C	3	2	5	1	4	2	0	2
chr17:7226521:T:C	45	24	69	21	48	2	0	2
chr17:7229843:G:A	18	11	29	7	22	2.0	0.0	2.0
chr17:7251215:G:A	405	205	666	222	444	2	1	2
chr17:7251263:T:C	410	207	676	224	452	2.0	1.0	2.0
chr17:7260420:A:G	211	58	307	175	132	1	1	0
chr17:7283804:T:C	0	0	0	0	0	0	0	0
chr17:7288772:C:T	0	0	0	0	0	0	0	0
chr17:7313221:G:A	961	505	1689	595	1094	2	1	2
chr17:7314220:C:T	25	13	38	12	26	2	0	2
chr17:7317562:C:T	11	5	16	6	10	1	1	0
chr17:7318388:G:T	0	0	0	0	0	0	0	0
chr17:7321830:C:G	0	0	0	0	0	0	0	0
chr17:7327526:G:T	6	1	7	5	2	1.0	1.0	0.0
chr17:7348286:G:C	2	1	3	1	2	1.5	0.5	1.0
chr17:7350996:G:A	307	164	514	165	349	2	1	2
chr17:7355162:C:T	0	0	0	0	0	0	0	0
chr17:7383007:T:A	0	0	0	0	0	0	0	0
chr17:7384513:C:A	30	15	46	16	30	2.0	0.5	1.0
chr17:7425815:G:A	0	0	0	0	0	0	0	0
chr17:7445306:A:G	0	0	0	0	0	0	0	0
chr17:7446731:C:A	0	0	0	0	0	0	0	0
chr17:7463300:T:C	11	5	16	6	10	1	1	0
chr17:7482771:G:A	3	2	5	1	4	2	0	2
chr17:7496547:G:A	131	55	193	79	114	1	1	0
chr17:7497496:T:C	48	23	78	28	50	2.0	1.0	0.0
chr17:7498253:A:T	6	2	11	5	6	1.5	1.0	0.0
chr17:7499281:T:C	104	43	125	64	61	1.0	1.0	0.0
chr17:7508451:C:T	166	93	272	82	190	2.0	0.0	2.0
chr17:7513280:G:A	231	104	367	140	227	1	1	0
chr17:7514234:T:C	643	341	1152	394	758	2	1	2
chr17:7557368:G:A	281	159	477	135	342	2	0	2
chr17:7559238:G:A	21	8	29	13	16	1	1	0
chr17:7561096:C:T	58	23	84	36	48	1.0	1.0	0.0
chr17:7565371:G:T	10	6	16	4	12	2.0	0.0	2.0
chr17:7580783:C:A	215	119	379	118	261	2	1	2
chr17:7582265:C:T	59	36	97	23	74	2	0	2
chr17:7587492:G:A	215	114	348	108	240	2	0	2
chr17:7626829:G:C	554	270	887	317	570	2.0	1.0	0.0
chr17:7626953:C:T	899	415	1500	592	908	2	1	0
chr17:7633209:G:A	0	0	0	0	0	0	0	0
chr17:7651454:C:T	0	0	0	0	0	0	0	0
chr17:7654101:A:G	0	0	0	0	0	0	0	0
chr17:7702893:G:A	2	1	3	1	2	1.5	0.5	1.0
chr17:7776841:G:A	0	0	0	0	0	0	0	0
chr17:7851675:G:A	15	8	23	7	16	2	0	2
chr17:7929179:C:T	2	1	3	1	2	1.5	0.5	1.0
chr17:7944519:A:T	23	14	37	9	28	2	0	2
chr17:8015172:T:C	0	0	0	0	0	0	0	0
chr17:8042601:C:T	0	0	0	0	0	0	0	0
chr17:8042714:G:C	0	0	0	0	0	0	0	0
chr17:8048501:A:G	0	0	0	0	0	0	0	0
chr17:8080363:G:A	0	0	0	0	0	0	0	0
chr17:8080651:G:C	0	0	0	0	0	0	0	0
chr17:8118290:G:C	0	0	0	0	0	0	0	0
chr17:8122394:A:G	0	0	0	0	0	0	0	0
chr17:8144692:C:A	33	17	50	16	34	2	0	2
chr17:8149767:T:G	23	9	32	14	18	1	1	0
chr17:8161461:C:G	258	139	416	128	288	2.0	0.0	2.0
chr17:8175711:G:C	21	14	42	8	34	2	0	2
chr17:8205021:G:A	2	1	4	2	2	2.0	1.0	1.0
chr17:8232774:C:T	13	3	16	10	6	1	1	0
chr17:8235325:A:C	24	13	37	11	26	2.0	0.0	2.0
chr17:8236145:G:A	104	43	152	62	90	1.0	1.0	0.0
chr17:8257831:C:T	4	4	8	0	8	2.0	0.0	2.0
chr17:8312216:C:T	0	0	0	0	0	0	0	0
chr17:8313150:T:C	0	0	0	0	0	0	0	0
chr17:8797664:C:T	0	0	0	0	0	0	0	0
chr17:8797798:G:A	0	0	0	0	0	0	0	0
chr17:8798105:A:G	0	0	0	0	0	0	0	0
chr17:8798481:G:T	0	0	0	0	0	0	0	0
chr17:8836822:C:T	0	0	0	0	0	0	0	0
chr17:8880832:T:C	0	0	0	0	0	0	0	0
chr17:8881770:A:C	0	0	0	0	0	0	0	0
chr17:8881775:C:T	0	0	0	0	0	0	0	0
chr17:8888686:C:T	1	1	2	0	2	2	0	2
chr17:8888712:A:G	1	1	2	0	2	2	0	2
chr17:8888854:T:C	1	1	2	0	2	2	0	2
chr17:9889451:G:A	0	0	0	0	0	0	0	0
chr17:9889555:T:C	0	0	0	0	0	0	0	0
chr17:9926854:C:T	0	0	0	0	0	0	0	0
chr17:10313193:G:A	0	0	0	0	0	0	0	0
chr17:10320397:T:C	0	0	0	0	0	0	0	0
chr17:10328100:C:T	0	0	0	0	0	0	0	0
chr17:10333148:G:A	0	0	0	0	0	0	0	0
chr17:10393169:G:A	0	0	0	0	0	0	0	0
chr17:10415319:A:G	0	0	0	0	0	0	0	0
chr17:10462887:T:C	0	0	0	0	0	0	0	0
chr17:10512523:A:G	0	0	0	0	0	0	0	0
chr17:10524607:G:A	0	0	0	0	0	0	0	0
chr17:10545452:A:T	0	0	0	0	0	0	0	0
chr17:10547499:T:C	0	0	0	0	0	0	0	0
chr17:10632701:G:A	9	4	13	5	8	1	1	0
chr17:10638198:C:T	2	1	3	1	2	1.5	0.5	1.0
chr17:10639154:T:G	0	0	0	0	0	0	0	0
chr17:10639448:A:G	1	1	2	0	2	2	0	2
chr17:10639569:T:C	1	1	2	0	2	2	0	2
chr17:10640146:T:C	1	1	2	0	2	2	0	2
chr17:10641099:G:T	1	1	2	0	2	2	0	2
chr17:10711125:A:G	423	197	670	254	416	2	1	0
chr17:11629518:A:G	0	0	0	0	0	0	0	0
chr17:11854239:C:G	0	0	0	0	0	0	0	0
chr17:11874923:G:A	0	0	0	0	0	0	0	0
chr17:11883634:T:C	0	0	0	0	0	0	0	0
chr17:11929970:A:G	0	0	0	0	0	0	0	0
chr17:11930048:G:A	0	0	0	0	0	0	0	0
chr17:11932014:G:A	0	0	0	0	0	0	0	0
chr17:12756473:C:T	0	0	0	0	0	0	0	0
chr17:12958853:C:T	1073	583	2219	777	1442	2	1	2
chr17:14191992:A:G	19	9	28	10	18	1	1	0
chr17:14236763:C:T	1	1	2	0	2	2	0	2
chr17:15230858:T:G	0	0	0	0	0	0	0	0
chr17:15259072:T:C	0	0	0	0	0	0	0	0
chr17:15502883:A:T	14	14	30	0	30	2.0	0.0	2.0
chr17:15593416:A:G	0	0	0	0	0	0	0	0
chr17:15594867:A:G	0	0	0	0	0	0	0	0
chr17:15651190:G:A	2	0	2	2	0	1.0	1.0	0.0
chr17:15704463:A:G	2	2	4	0	4	2.0	0.0	2.0
chr17:15704644:G:A	3	2	5	1	4	2	0	2
chr17:15704880:T:G	4	4	8	0	8	2.0	0.0	2.0
chr17:15708181:T:C	142	83	229	61	168	2.0	0.0	2.0
chr17:15717167:C:T	6	3	11	3	8	1.5	0.5	1.0
chr17:15741192:C:T	0	0	0	0	0	0	0	0
chr17:15741975:G:A	0	0	0	0	0	0	0	0
chr17:16000288:C:A	245	117	373	135	238	1	1	0
chr17:16027568:T:C	154	81	244	76	168	2.0	0.0	2.0
chr17:16325918:A:G	38	20	60	18	42	2.0	0.0	2.0
chr17:16553300:T:G	53	29	86	26	60	2	0	2
chr17:16569001:A:G	60	30	94	32	62	2.0	0.5	1.0
chr17:16617119:C:G	3	3	6	0	6	2	0	2
chr17:16617296:G:A	1	1	2	0	2	2	0	2
chr17:16624043:G:A	57	22	80	36	44	1	1	0
chr17:16624481:C:A	79	32	116	50	66	1	1	0
chr17:16746566:A:G	8	0	9	9	0	1.0	1.0	0.0
chr17:16939598:A:G	612	348	1214	394	820	2.0	1.0	2.0
chr17:16939857:A:G	15	11	26	4	22	2	0	2
chr17:16940678:G:A	3	2	5	1	4	2	0	2
chr17:16952564:C:T	452	233	834	298	536	2.0	1.0	2.0
chr17:17142710:C:A	17	8	26	10	16	2	1	0
chr17:17158927:C:G	10	5	15	5	10	1.5	0.5	1.0
chr17:17224157:G:A	4	2	6	2	4	1.5	0.5	1.0
chr17:17276167:G:A	30	10	40	20	20	1.0	1.0	0.0
chr17:17506246:C:T	147	85	247	67	180	2	0	2
chr17:17522317:C:T	136	78	227	63	164	2.0	0.0	2.0
chr17:17994379:G:C	0	0	0	0	0	0	0	0
chr17:18119247:G:C	0	0	0	0	0	0	0	0
chr17:18138193:C:T	0	0	0	0	0	0	0	0
chr17:18140503:C:T	0	0	0	0	0	0	0	0
chr17:18143875:G:A	0	0	0	0	0	0	0	0
chr17:18151915:G:A	0	0	0	0	0	0	0	0
chr17:18156140:G:A	0	0	0	0	0	0	0	0
chr17:18161416:C:T	4	4	8	0	8	2.0	0.0	2.0
chr17:18184780:C:T	125	57	187	71	116	1	1	0
chr17:18233827:A:G	1	0	1	1	0	1	1	0
chr17:18236582:G:T	0	0	0	0	0	0	0	0
chr17:18241406:C:T	0	0	0	0	0	0	0	0
chr17:18245171:G:A	189	103	319	97	222	2	0	2
chr17:18251196:T:C	0	0	0	0	0	0	0	0
chr17:18264083:G:T	11	6	17	5	12	2	0	2
chr17:18264370:G:A	12	7	19	5	14	2.0	0.0	2.0
chr17:18316521:T:C	24	11	35	13	22	1.0	1.0	0.0
chr17:18317696:A:G	8	4	12	4	8	1.5	0.5	1.0
chr17:18353665:C:T	5	3	8	2	6	2	0	2
chr17:18476840:A:G	10	3	13	7	6	1.0	1.0	0.0
chr17:18494397:G:A	22	11	33	11	22	1.5	0.5	1.0
chr17:18625310:A:G	325	190	578	168	410	2	0	2
chr17:18639119:T:C	0	0	0	0	0	0	0	0
chr17:18699163:A:G	7	3	10	4	6	1	1	0
chr17:18790964:G:A	103	42	153	67	86	1	1	0
chr17:18857796:G:A	2	1	3	1	2	1.5	0.5	1.0
chr17:18969024:T:C	31	14	45	17	28	1	1	0
chr17:18971407:C:G	2	0	2	2	0	1.0	1.0	0.0
chr17:18971652:C:T	1	1	2	0	2	2	0	2
chr17:18976955:C:A	1	1	2	0	2	2	0	2
chr17:19331964:C:T	8	1	9	7	2	1.0	1.0	0.0
chr17:19382211:T:A	34	0	35	35	0	1.0	1.0	0.0
chr17:19741159:A:T	6	3	9	3	6	1.5	0.5	1.0
chr17:19742625:A:C	7	3	10	4	6	1	1	0
chr17:20204460:T:C	32	20	54	12	42	2.0	0.0	2.0
chr17:20204926:A:T	26	19	47	7	40	2.0	0.0	2.0
chr17:20205876:C:T	7	1	8	6	2	1	1	0
chr17:20232359:G:A	11	8	23	3	20	2	0	2
chr17:20260216:A:G	0	0	0	0	0	0	0	0
chr17:20306161:C:T	0	0	0	0	0	0	0	0
chr17:20428825:G:A	0	0	0	0	0	0	0	0
chr17:20841152:A:T	0	0	0	0	0	0	0	0
chr17:20841170:A:G	0	0	0	0	0	0	0	0
chr17:20841288:C:T	0	0	0	0	0	0	0	0
chr17:20841334:A:C	0	0	0	0	0	0	0	0
chr17:20895806:A:G	0	0	0	0	0	0	0	0
chr17:21002938:C:T	98	33	133	65	68	1.0	1.0	0.0
chr17:21007891:G:T	254	124	402	141	261	2.0	1.0	0.0
chr17:21011322:G:A	37	20	57	18	39	2	0	2
chr17:21302148:C:T	130	0	138	138	0	1.0	1.0	0.0
chr17:21415291:C:T	0	0	0	0	0	0	0	0
chr17:21415317:C:A	0	0	0	0	0	0	0	0
chr17:21415351:G:A	0	0	0	0	0	0	0	0
chr17:21702803:G:A	0	0	0	0	0	0	0	0
chr17:21702902:GGCG:AGCA	0	0	0	0	0	0	0	0
chr17:21702953:C:A	0	0	0	0	0	0	0	0
chr17:22062150:C:A	0	0	0	0	0	0	0	0
chr17:27301794:T:C	459	354	876	128	748	2	0	2
chr17:27303362:T:C	16	12	28	4	24	2.0	0.0	2.0
chr17:27645285:C:T	6	3	9	3	6	1.5	0.5	1.0
chr17:27647232:T:C	19	11	30	8	22	2	0	2
chr17:27778906:G:A	0	0	0	0	0	0	0	0
chr17:28395871:A:G	1	1	2	0	2	2	0	2
chr17:28468295:G:T	619	1	710	708	2	1	1	0
chr17:28547296:G:A	580	335	1003	295	708	2.0	0.0	2.0
chr17:28556295:A:G	2	2	4	0	4	2.0	0.0	2.0
chr17:28673373:A:G	318	159	525	177	348	2.0	1.0	1.0
chr17:28682731:C:T	12	3	15	9	6	1.0	1.0	0.0
chr17:28717649:T:C	68	64	132	4	128	2.0	0.0	2.0
chr17:28880435:G:A	194	110	321	91	230	2.0	0.0	2.0
chr17:28880553:C:T	108	50	168	62	106	1.0	1.0	0.0
chr17:28959833:T:C	1	1	2	0	2	2	0	2
chr17:29095035:C:T	20	10	33	11	22	2.0	0.5	1.0
chr17:29097145:A:C	1	0	1	1	0	1	1	0
chr17:29097298:G:A	21	11	36	12	24	2	1	2
chr17:29111451:G:A	19	10	29	9	20	2	0	2
chr17:29115692:G:C	12	5	17	7	10	1.0	1.0	0.0
chr17:29508120:C:T	88	40	133	49	84	1.0	1.0	0.0
chr17:29530680:C:T	12	6	18	6	12	1.5	0.5	1.0
chr17:29562560:T:C	29	13	45	17	28	1	1	0
chr17:29562968:T:C	30	12	46	20	26	1.0	1.0	0.0
chr17:29571810:T:C	19	11	30	8	22	2	0	2
chr17:29574957:A:G	2	1	3	1	2	1.5	0.5	1.0
chr17:29577693:G:A	2	1	3	1	2	1.5	0.5	1.0
chr17:29583688:C:T	0	0	0	0	0	0	0	0
chr17:29617071:C:T	2	1	3	1	2	1.5	0.5	1.0
chr17:29941782:A:C	0	0	0	0	0	0	0	0
chr17:30059508:A:G	1	1	2	0	2	2	0	2
chr17:30080858:T:G	1	0	1	1	0	1	1	0
chr17:30184960:G:A	471	232	779	271	508	2	1	0
chr17:30560116:G:A	0	0	0	0	0	0	0	0
chr17:31219157:T:C	2	0	2	2	0	1.0	1.0	0.0
chr17:31226467:G:A	12	6	19	7	12	2.0	0.5	1.0
chr17:31319014:G:A	405	261	771	183	588	2	0	2
chr17:31523680:G:A	1	1	2	0	2	2	0	2
chr17:31856838:T:C	355	185	591	195	396	2	1	2
chr17:31901637:G:A	504	269	843	285	558	2.0	1.0	2.0
chr17:32206951:A:G	25	14	40	12	28	2	0	2
chr17:32298186:G:A	0	0	0	0	0	0	0	0
chr17:32369273:C:T	64	36	100	28	72	2.0	0.0	2.0
chr17:32464066:G:A	529	262	867	307	560	2	1	0
chr17:33291714:A:G	0	0	0	0	0	0	0	0
chr17:34156218:A:G	0	0	0	0	0	0	0	0
chr17:34156251:C:G	0	0	0	0	0	0	0	0
chr17:34285875:G:A	0	0	0	0	0	0	0	0
chr17:34961344:C:T	75	17	97	63	34	1	1	0
chr17:35003131:A:C	2	1	3	1	2	1.5	0.5	1.0
chr17:35004556:C:T	14	5	20	10	10	1.0	1.0	0.0
chr17:35127396:C:A	3	1	4	2	2	1	1	0
chr17:35150223:G:A	0	0	0	0	0	0	0	0
chr17:35193244:T:C	0	0	0	0	0	0	0	0
chr17:35265572:C:T	27	24	59	3	56	2	0	2
chr17:35422900:A:C	16	3	19	13	6	1.0	1.0	0.0
chr17:35441315:T:G	7	4	13	3	10	2	0	2
chr17:35441364:T:A	7	3	11	5	6	2	1	0
chr17:35444977:G:A	6	4	10	2	8	2.0	0.0	2.0
chr17:35479527:G:A	20	9	30	12	18	1.5	1.0	0.0
chr17:35479844:G:A	47	24	73	23	50	2	0	2
chr17:35487739:T:C	78	44	127	37	90	2.0	0.0	2.0
chr17:35671783:G:C	21	10	31	11	20	1	1	0
chr17:35745012:G:A	1	0	1	1	0	1	1	0
chr17:35745536:G:A	0	0	0	0	0	0	0	0
chr17:35750213:G:A	1	1	2	0	2	2	0	2
chr17:35863065:C:A	0	0	0	0	0	0	0	0
chr17:36089191:G:A	21	17	49	7	42	2	0	2
chr17:36105188:T:C	2	2	10	0	10	5.0	0.0	5.0
chr17:37406385:G:A	244	132	413	133	280	2.0	0.0	2.0
chr17:37411381:T:C	202	70	282	140	142	1.0	1.0	0.0
chr17:37542123:C:G	56	33	91	23	68	2.0	0.0	2.0
chr17:37628628:T:C	92	42	138	54	84	1.0	1.0	0.0
chr17:37643330:G:A	175	90	270	88	182	2	0	2
chr17:38752808:A:G	2276	1426	5482	1878	3604	2.0	1.0	2.0
chr17:38802749:G:A	33	21	54	12	42	2	0	2
chr17:38945127:T:C	1	1	2	0	2	2	0	2
chr17:39072512:A:G	0	0	0	0	0	0	0	0
chr17:39160735:T:C	0	0	0	0	0	0	0	0
chr17:39162776:T:G	0	0	0	0	0	0	0	0
chr17:39165708:C:T	0	0	0	0	0	0	0	0
chr17:39165827:T:C	0	0	0	0	0	0	0	0
chr17:39184083:G:A	0	0	0	0	0	0	0	0
chr17:39195032:T:C	0	0	0	0	0	0	0	0
chr17:39657827:G:A	61	25	90	38	52	1	1	0
chr17:39666058:A:C	12	5	17	7	10	1.0	1.0	0.0
chr17:39727784:C:G	3	1	4	2	2	1	1	0
chr17:39766006:G:A	302	164	504	154	350	2.0	0.0	2.0
chr17:39864166:T:C	1144	624	2160	711	1449	2.0	1.0	2.0
chr17:39868373:C:T	15	11	26	4	22	2	0	2
chr17:39872381:G:T	6	4	10	2	8	2.0	0.0	2.0
chr17:39875421:C:T	4	2	6	2	4	1.5	0.5	1.0
chr17:39905943:G:A	60	13	75	49	26	1.0	1.0	0.0
chr17:39965740:G:A	1	1	2	0	2	2	0	2
chr17:39966427:G:T	1	0	1	1	0	1	1	0
chr17:39966433:G:A	1	0	1	1	0	1	1	0
chr17:39989901:T:C	359	186	573	185	388	2	0	2
chr17:40016890:G:A	0	0	0	0	0	0	0	0
chr17:40019613:G:A	122	58	189	71	118	1.5	1.0	0.0
chr17:40020003:A:T	9	4	13	5	8	1	1	0
chr17:40023239:A:G	22	12	34	10	24	2.0	0.0	2.0
chr17:40023414:A:G	2	1	3	1	2	1.5	0.5	1.0
chr17:40026837:G:T	5	2	7	3	4	1	1	0
chr17:40029853:C:T	15	8	23	7	16	2	0	2
chr17:40032166:C:T	2	1	3	1	2	1.5	0.5	1.0
chr17:40192875:G:A	0	0	0	0	0	0	0	0
chr17:40300899:G:A	3	3	6	0	6	2	0	2
chr17:40390022:A:C	0	0	0	0	0	0	0	0
chr17:40443840:G:A	103	53	175	59	116	2	1	2
chr17:40487133:G:A	0	0	0	0	0	0	0	0
chr17:40751196:C:T	0	0	0	0	0	0	0	0
chr17:40794020:T:C	0	0	0	0	0	0	0	0
chr17:40799739:C:T	0	0	0	0	0	0	0	0
chr17:40818360:T:C	3272	2353	10678	3370	7308	3.0	1.0	2.0
chr17:40822210:C:T	0	0	0	0	0	0	0	0
chr17:40834427:T:A	17	7	28	10	18	1	1	0
chr17:40834800:TT:GA	17	11	30	8	22	2	0	2
chr17:40863652:C:A	0	0	0	0	0	0	0	0
chr17:40958710:C:T	0	0	0	0	0	0	0	0
chr17:40963690:G:A	0	0	0	0	0	0	0	0
chr17:40966545:G:A	0	0	0	0	0	0	0	0
chr17:40980852:A:G	0	0	0	0	0	0	0	0
chr17:40980902:C:G	0	0	0	0	0	0	0	0
chr17:40981045:C:T	0	0	0	0	0	0	0	0
chr17:40981135:C:T	0	0	0	0	0	0	0	0
chr17:40982460:G:A	0	0	0	0	0	0	0	0
chr17:40983969:C:T	0	0	0	0	0	0	0	0
chr17:40984165:T:C	0	0	0	0	0	0	0	0
chr17:40994105:A:G	0	0	0	0	0	0	0	0
chr17:41008922:G:A	0	0	0	0	0	0	0	0
chr17:41026852:T:C	0	0	0	0	0	0	0	0
chr17:41029779:C:T	0	0	0	0	0	0	0	0
chr17:41029916:A:C	0	0	0	0	0	0	0	0
chr17:41084252:A:G	0	0	0	0	0	0	0	0
chr17:41084259:A:T	0	0	0	0	0	0	0	0
chr17:41084409:C:G	0	0	0	0	0	0	0	0
chr17:41097563:G:A	0	0	0	0	0	0	0	0
chr17:41097583:C:T	0	0	0	0	0	0	0	0
chr17:41105681:C:T	0	0	0	0	0	0	0	0
chr17:41105697:T:C	0	0	0	0	0	0	0	0
chr17:41117983:G:A	0	0	0	0	0	0	0	0
chr17:41118266:C:T	0	0	0	0	0	0	0	0
chr17:41149704:G:A	0	0	0	0	0	0	0	0
chr17:41232559:C:A	0	0	0	0	0	0	0	0
chr17:41250157:C:A	0	0	0	0	0	0	0	0
chr17:41250195:A:G	0	0	0	0	0	0	0	0
chr17:41302224:A:T	0	0	0	0	0	0	0	0
chr17:41302513:A:G	0	0	0	0	0	0	0	0
chr17:41302641:G:A	0	0	0	0	0	0	0	0
chr17:41307794:G:C	1	0	1	1	0	1	1	0
chr17:41308235:G:C	1	0	1	1	0	1	1	0
chr17:41308484:C:G	1	0	1	1	0	1	1	0
chr17:41308842:C:T	2	1	3	1	2	1.5	0.5	1.0
chr17:41309137:T:A	1	1	2	0	2	2	0	2
chr17:41315526:C:T	0	0	0	0	0	0	0	0
chr17:41315677:G:A	0	0	0	0	0	0	0	0
chr17:41422172:G:T	0	0	0	0	0	0	0	0
chr17:41422860:G:A	0	0	0	0	0	0	0	0
chr17:41423878:G:A	0	0	0	0	0	0	0	0
chr17:41424487:C:A	0	0	0	0	0	0	0	0
chr17:41437368:T:C	0	0	0	0	0	0	0	0
chr17:41460022:A:T	0	0	0	0	0	0	0	0
chr17:41462841:GT:AC	0	0	0	0	0	0	0	0
chr17:41462967:G:A	0	0	0	0	0	0	0	0
chr17:41464313:C:T	0	0	0	0	0	0	0	0
chr17:41467111:T:C	0	0	0	0	0	0	0	0
chr17:41467370:A:C	0	0	0	0	0	0	0	0
chr17:41477097:G:C	0	0	0	0	0	0	0	0
chr17:41477102:C:T	0	0	0	0	0	0	0	0
chr17:41478373:A:G	0	0	0	0	0	0	0	0
chr17:41480992:A:G	0	0	0	0	0	0	0	0
chr17:41486309:T:A	0	0	0	0	0	0	0	0
chr17:41487394:G:A	0	0	0	0	0	0	0	0
chr17:41518389:T:C	0	0	0	0	0	0	0	0
chr17:41525223:A:G	0	0	0	0	0	0	0	0
chr17:41528069:G:C	0	0	0	0	0	0	0	0
chr17:41528158:G:A	0	0	0	0	0	0	0	0
chr17:41571798:G:A	0	0	0	0	0	0	0	0
chr17:41582545:T:C	0	0	0	0	0	0	0	0
chr17:41586604:G:A	0	0	0	0	0	0	0	0
chr17:41624515:C:G	0	0	0	0	0	0	0	0
chr17:41936910:A:G	0	0	0	0	0	0	0	0
chr17:42483043:G:A	9	3	12	6	6	1	1	0
chr17:42543998:G:A	43	20	65	25	40	1	1	0
chr17:42553082:C:T	51	29	80	22	58	2	0	2
chr17:42553697:G:A	18	8	26	10	16	1.0	1.0	0.0
chr17:42553706:T:G	17	8	22	9	13	1	1	0
chr17:42562786:C:A	110	43	154	69	85	1.0	1.0	0.0
chr17:42564217:C:T	5	0	5	5	0	1	1	0
chr17:42564502:A:G	112	50	164	64	100	1.0	1.0	0.0
chr17:42568587:G:A	19	14	32	5	27	2	0	2
chr17:42568614:G:A	20	15	35	5	30	2.0	0.0	2.0
chr17:42569342:C:A	32	12	46	20	26	1.0	1.0	0.0
chr17:42570011:A:G	94	48	146	48	98	1.0	1.0	1.0
chr17:42570144:G:A	96	48	149	53	96	2.0	1.0	1.0
chr17:42573638:G:C	3	1	4	2	2	1	1	0
chr17:42614528:C:G	53	25	84	34	50	1	1	0
chr17:42659763:C:T	2	0	2	2	0	1.0	1.0	0.0
chr17:42666433:G:A	24	4	29	21	8	1.0	1.0	0.0
chr17:42666681:A:G	25	4	30	22	8	1	1	0
chr17:42683904:A:C	2	1	3	1	2	1.5	0.5	1.0
chr17:42690066:G:A	4	0	4	4	0	1.0	1.0	0.0
chr17:43400342:A:G	7	6	13	1	12	2	0	2
chr17:43909694:A:G	0	0	0	0	0	0	0	0
chr17:43953041:G:A	0	0	0	0	0	0	0	0
chr17:44007690:C:G	4	2	8	2	6	1.5	0.5	1.0
chr17:44261630:T:G	0	0	0	0	0	0	0	0
chr17:44372421:G:A	0	0	0	0	0	0	0	0
chr17:44375697:A:C	0	0	0	0	0	0	0	0
chr17:44708845:G:C	33	14	52	20	32	1	1	0
chr17:44860381:C:G	20	5	25	15	10	1.0	1.0	0.0
chr17:44880487:A:G	8	6	14	2	12	2.0	0.0	2.0
chr17:44902821:G:A	2	1	3	1	2	1.5	0.5	1.0
chr17:44904286:A:G	0	0	0	0	0	0	0	0
chr17:44904920:A:G	0	0	0	0	0	0	0	0
chr17:44907319:G:C	0	0	0	0	0	0	0	0
chr17:44910155:GT:AC	1	1	2	0	2	2	0	2
chr17:44910724:G:C	0	0	0	0	0	0	0	0
chr17:44926116:T:C	0	0	0	0	0	0	0	0
chr17:44934540:G:A	0	0	0	0	0	0	0	0
chr17:45034320:G:A	290	133	460	172	288	1.0	1.0	0.0
chr17:45099436:C:T	112	55	174	62	112	1.5	1.0	0.0
chr17:45105660:G:A	68	35	106	34	72	2.0	0.5	2.0
chr17:45105740:G:A	67	34	103	33	70	2	0	2
chr17:45115454:A:G	4	1	5	3	2	1.0	1.0	0.0
chr17:45239153:T:C	9	7	16	2	14	2	0	2
chr17:45242403:C:T	36	21	57	15	42	2.0	0.0	2.0
chr17:45264774:G:C	20	11	31	9	22	2.0	0.0	2.0
chr17:45397074:C:G	1	1	2	0	2	2	0	2
chr17:45404898:C:T	1	0	1	1	0	1	1	0
chr17:45586865:T:G	39	10	50	30	20	1	1	0
chr17:45586900:G:A	42	13	58	30	28	1.0	1.0	0.0
chr17:45829360:A:C	0	0	0	0	0	0	0	0
chr17:45830379:C:T	0	0	0	0	0	0	0	0
chr17:45830530:T:C	0	0	0	0	0	0	0	0
chr17:45830600:G:A	0	0	0	0	0	0	0	0
chr17:45833141:C:T	0	0	0	0	0	0	0	0
chr17:45834793:G:C	0	0	0	0	0	0	0	0
chr17:45845576:T:C	0	0	0	0	0	0	0	0
chr17:45845900:G:A	0	0	0	0	0	0	0	0
chr17:45846568:T:C	0	0	0	0	0	0	0	0
chr17:45846707:T:C	0	0	0	0	0	0	0	0
chr17:45846764:G:A	0	0	0	0	0	0	0	0
chr17:45846834:C:G	0	0	0	0	0	0	0	0
chr17:45846853:T:C	0	0	0	0	0	0	0	0
chr17:45846865:G:A	0	0	0	0	0	0	0	0
chr17:45962325:A:G	0	0	0	0	0	0	0	0
chr17:45974480:A:G	0	0	0	0	0	0	0	0
chr17:45978272:T:A	0	0	0	0	0	0	0	0
chr17:45978281:A:T	0	0	0	0	0	0	0	0
chr17:45983409:C:T	0	0	0	0	0	0	0	0
chr17:45983657:G:A	0	0	0	0	0	0	0	0
chr17:45983670:T:C	0	0	0	0	0	0	0	0
chr17:45983912:C:T	0	0	0	0	0	0	0	0
chr17:45990034:T:C	0	0	0	0	0	0	0	0
chr17:45991558:G:A	0	0	0	0	0	0	0	0
chr17:45993928:T:C	0	0	0	0	0	0	0	0
chr17:45996523:A:G	0	0	0	0	0	0	0	0
chr17:45996607:T:C	0	0	0	0	0	0	0	0
chr17:45999299:A:G	0	0	0	0	0	0	0	0
chr17:46024197:T:C	2	1	3	1	2	1.5	0.5	1.0
chr17:46031540:A:G	35	17	52	18	34	1	1	0
chr17:46031822:C:G	4	0	4	4	0	1.0	1.0	0.0
chr17:46033166:G:A	9	5	15	5	10	2	0	2
chr17:46033175:G:A	9	5	15	5	10	2	0	2
chr17:46038520:C:T	9	6	15	3	12	2	0	2
chr17:46038946:T:C	2	1	3	1	2	1.5	0.5	1.0
chr17:46039753:A:G	12	8	20	4	16	2.0	0.0	2.0
chr17:46171403:T:C	296	194	504	109	395	2.0	0.0	2.0
chr17:46721850:C:T	5	2	7	3	4	1	1	0
chr17:46751565:G:A	14	9	25	7	18	2.0	0.0	2.0
chr17:46923163:G:C	379	207	630	197	433	2	0	2
chr17:46940493:A:G	32	16	49	17	32	2.0	0.5	1.0
chr17:47017649:G:T	4	0	4	4	0	1.0	1.0	0.0
chr17:47018312:G:A	2	2	4	0	4	2.0	0.0	2.0
chr17:47287174:T:C	1	1	2	0	2	2	0	2
chr17:47290971:A:C	1	1	2	0	2	2	0	2
chr17:47391492:T:G	33	8	42	26	16	1	1	0
chr17:47733844:A:G	26	10	37	17	20	1.0	1.0	0.0
chr17:47808390:C:T	38	21	59	17	42	2.0	0.0	2.0
chr17:47813341:C:T	16	9	25	7	18	2.0	0.0	2.0
chr17:47815179:T:C	1	1	2	0	2	2	0	2
chr17:47815455:G:A	1	0	1	1	0	1	1	0
chr17:47824114:C:T	289	150	457	150	307	2	1	2
chr17:47827054:C:T	279	140	437	149	288	2	1	2
chr17:47835330:C:T	0	0	0	0	0	0	0	0
chr17:47838102:T:G	116	55	172	62	110	1.0	1.0	0.0
chr17:47839781:C:G	10	8	17	2	15	2.0	0.0	2.0
chr17:47840239:T:C	338	111	472	244	228	1.0	1.0	0.0
chr17:47944699:G:A	70	39	116	32	84	2.0	0.0	2.0
chr17:47946328:G:A	21	10	33	11	22	1	1	0
chr17:47971226:A:G	244	144	408	106	302	2.0	0.0	2.0
chr17:47974545:G:A	46	26	74	21	53	2.0	0.0	2.0
chr17:47975517:G:A	310	140	487	191	296	1.0	1.0	0.0
chr17:47977981:A:G	1	0	1	1	0	1	1	0
chr17:48029268:G:T	0	0	0	0	0	0	0	0
chr17:48032062:T:C	4	2	6	2	4	1.5	0.5	1.0
chr17:48113457:G:A	28	16	44	12	32	2.0	0.0	2.0
chr17:48121514:G:C	74	37	122	42	80	2.0	1.0	1.0
chr17:48550303:C:T	0	0	0	0	0	0	0	0
chr17:48597878:G:T	0	0	0	0	0	0	0	0
chr17:48770002:C:A	0	0	0	0	0	0	0	0
chr17:48817015:A:C	0	0	0	0	0	0	0	0
chr17:48930601:C:T	1245	649	2275	830	1445	2	1	2
chr17:48944056:A:C	39	15	54	24	30	1	1	0
chr17:48944066:C:G	39	15	53	24	29	1	1	0
chr17:48958680:C:A	0	0	0	0	0	0	0	0
chr17:48961770:T:C	0	0	0	0	0	0	0	0
chr17:49826019:C:T	14	3	17	11	6	1.0	1.0	0.0
chr17:50170328:C:T	1	0	1	1	0	1	1	0
chr17:50175443:T:C	8	3	11	5	6	1.0	1.0	0.0
chr17:50188065:A:G	0	0	0	0	0	0	0	0
chr17:50192065:C:T	0	0	0	0	0	0	0	0
chr17:50196376:C:A	0	0	0	0	0	0	0	0
chr17:50199874:C:A	0	0	0	0	0	0	0	0
chr17:50278899:G:C	1	0	1	1	0	1	1	0
chr17:50360095:C:G	6	3	9	3	6	1.5	0.5	1.0
chr17:50462636:T:C	5	3	8	2	6	2	0	2
chr17:50464346:G:A	1	1	2	0	2	2	0	2
chr17:50468235:G:A	0	0	0	0	0	0	0	0
chr17:50472430:C:G	65	35	107	31	76	2	0	2
chr17:50518627:G:C	5	2	7	3	4	1	1	0
chr17:50519753:C:T	4	2	6	2	4	1.5	0.5	1.0
chr17:50525051:C:A	1	0	1	1	0	1	1	0
chr17:50526073:C:T	4	3	7	1	6	2.0	0.0	2.0
chr17:50541888:C:A	3	2	5	1	4	2	0	2
chr17:50541911:G:A	3	1	4	2	2	1	1	0
chr17:50541929:G:A	3	1	4	2	2	1	1	0
chr17:50549028:C:T	0	0	0	0	0	0	0	0
chr17:50549037:C:T	0	0	0	0	0	0	0	0
chr17:50550731:A:G	10	8	18	2	16	2.0	0.0	2.0
chr17:50551109:T:A	16	14	32	2	30	2.0	0.0	2.0
chr17:50551220:T:A	2	2	4	0	4	2.0	0.0	2.0
chr17:50551951:G:C	7	3	11	5	6	2	1	0
chr17:50575993:C:A	0	0	0	0	0	0	0	0
chr17:50624439:C:T	0	0	0	0	0	0	0	0
chr17:50626391:T:C	0	0	0	0	0	0	0	0
chr17:50683647:G:T	0	0	0	0	0	0	0	0
chr17:50977078:T:C	36	18	54	18	36	1.5	0.5	1.0
chr17:50990402:T:C	69	39	113	33	80	2	0	2
chr17:51154262:CTAAG:GTAAA	46	29	80	22	58	2.0	0.0	2.0
chr17:51161675:C:A	7	5	12	2	10	2	0	2
chr17:51260896:C:T	492	263	828	262	566	2.0	1.0	2.0
chr17:53823368:C:T	0	0	0	0	0	0	0	0
chr17:53824024:C:T	0	0	0	0	0	0	0	0
chr17:54936619:A:G	0	0	0	0	0	0	0	0
chr17:54961384:A:G	8	1	9	7	2	1.0	1.0	0.0
chr17:54964656:C:G	0	0	0	0	0	0	0	0
chr17:54999438:G:A	63	35	99	29	70	2	0	2
chr17:56795078:T:C	6	3	9	3	6	1.5	0.5	1.0
chr17:56795194:C:A	1	1	2	0	2	2	0	2
chr17:56795234:A:G	1	1	2	0	2	2	0	2
chr17:56795243:C:T	1	1	2	0	2	2	0	2
chr17:56795253:C:T	1	1	2	0	2	2	0	2
chr17:56834978:G:A	103	57	165	47	118	2	0	2
chr17:56862354:T:C	6	3	9	3	6	1.5	0.5	1.0
chr17:57872703:C:T	0	0	0	0	0	0	0	0
chr17:57982854:T:C	108	52	167	59	108	2.0	1.0	0.0
chr17:58195029:A:G	1	0	1	1	0	1	1	0
chr17:58249160:G:C	0	0	0	0	0	0	0	0
chr17:58249495:C:T	0	0	0	0	0	0	0	0
chr17:58268002:C:T	0	0	0	0	0	0	0	0
chr17:58279141:A:G	0	0	0	0	0	0	0	0
chr17:58305116:C:T	1	0	1	1	0	1	1	0
chr17:58307567:C:T	1	1	2	0	2	2	0	2
chr17:58308757:A:G	0	0	0	0	0	0	0	0
chr17:58308997:T:A	0	0	0	0	0	0	0	0
chr17:58310877:C:G	0	0	0	0	0	0	0	0
chr17:58311566:T:C	0	0	0	0	0	0	0	0
chr17:58312371:T:C	3	0	3	3	0	1	1	0
chr17:58318322:G:A	0	0	0	0	0	0	0	0
chr17:58318396:C:T	0	0	0	0	0	0	0	0
chr17:58319248:T:C	0	0	0	0	0	0	0	0
chr17:58327663:G:A	0	0	0	0	0	0	0	0
chr17:58357719:G:C	11	1	12	10	2	1	1	0
chr17:58370936:C:T	19	11	32	8	24	2	0	2
chr17:58415439:T:C	3	2	5	1	4	2	0	2
chr17:58506844:A:C	9	4	13	5	8	1	1	0
chr17:58507147:T:C	8	4	12	4	8	1.5	0.5	1.0
chr17:58508511:G:C	14	8	22	6	16	2.0	0.0	2.0
chr17:58521078:T:C	3	2	5	1	4	2	0	2
chr17:58521630:T:A	3	1	4	2	2	1	1	0
chr17:58526617:G:A	0	0	0	0	0	0	0	0
chr17:59210093:A:G	30	15	45	15	30	1.5	0.5	1.0
chr17:59878393:G:C	5	2	7	3	4	1	1	0
chr17:59886176:A:G	144	73	222	74	148	2.0	0.0	2.0
chr17:60156793:A:T	0	0	0	0	0	0	0	0
chr17:60426371:A:C	0	0	0	0	0	0	0	0
chr17:60526015:C:A	365	196	595	182	413	2	0	2
chr17:62676543:A:C	0	0	0	0	0	0	0	0
chr17:62692442:A:G	4	0	4	4	0	1.0	1.0	0.0
chr17:63237911:G:A	0	0	0	0	0	0	0	0
chr17:63395964:C:A	0	0	0	0	0	0	0	0
chr17:63480412:A:G	0	0	0	0	0	0	0	0
chr17:63918502:G:A	33	14	47	19	28	1	1	0
chr17:63941413:T:C	0	0	0	0	0	0	0	0
chr17:63941743:G:T	0	0	0	0	0	0	0	0
chr17:63957350:C:T	0	0	0	0	0	0	0	0
chr17:64001974:A:G	1	0	1	1	0	1	1	0
chr17:64044120:T:C	0	0	0	0	0	0	0	0
chr17:64066984:C:A	10	4	14	6	8	1.0	1.0	0.0
chr17:64068312:A:G	1	0	1	1	0	1	1	0
chr17:64068368:A:G	0	0	0	0	0	0	0	0
chr17:64150801:T:C	0	0	0	0	0	0	0	0
chr17:64193581:C:T	1	0	1	1	0	1	1	0
chr17:64449110:T:G	6	3	9	3	6	1.5	0.5	1.0
chr17:64485673:C:T	73	40	113	33	80	2	0	2
chr17:64800641:A:C	3	2	5	1	4	2	0	2
chr17:65537650:G:A	18	18	36	0	36	2.0	0.0	2.0
chr17:65538132:T:C	4	4	8	0	8	2.0	0.0	2.0
chr17:65558351:G:A	24	0	24	24	0	1.0	1.0	0.0
chr17:65750713:C:T	0	0	0	0	0	0	0	0
chr17:66212112:G:A	0	0	0	0	0	0	0	0
chr17:66688960:G:A	0	0	0	0	0	0	0	0
chr17:68043234:A:G	102	55	166	50	116	2.0	0.0	2.0
chr17:68046523:T:A	110	54	172	64	108	1.5	1.0	0.0
chr17:68256954:T:A	270	132	434	150	284	2.0	1.0	0.0
chr17:68271509:T:G	0	0	0	0	0	0	0	0
chr17:68368608:T:C	2	1	3	1	2	1.5	0.5	1.0
chr17:68368663:T:C	2	1	3	1	2	1.5	0.5	1.0
chr17:68420216:C:T	26	17	42	9	33	2.0	0.0	2.0
chr17:68426017:A:G	7	2	9	5	4	1	1	0
chr17:68428782:C:T	25	13	38	12	26	2	0	2
chr17:68537514:A:G	0	0	0	0	0	0	0	0
chr17:68600322:C:T	0	0	0	0	0	0	0	0
chr17:68876661:G:C	0	0	0	0	0	0	0	0
chr17:68877407:G:C	0	0	0	0	0	0	0	0
chr17:69153831:C:T	13	8	22	6	16	2	0	2
chr17:69215890:A:G	4	1	5	3	2	1.0	1.0	0.0
chr17:69264785:A:G	13	8	21	5	16	2	0	2
chr17:72124410:A:C	0	0	0	0	0	0	0	0
chr17:73201300:C:T	10	3	13	7	6	1.0	1.0	0.0
chr17:73260969:C:A	1	0	1	1	0	1	1	0
chr17:73357975:C:T	1	1	2	0	2	2	0	2
chr17:73430517:G:T	1	0	1	1	0	1	1	0
chr17:73430531:G:A	1	0	1	1	0	1	1	0
chr17:73507497:T:C	1	0	1	1	0	1	1	0
chr17:73737869:C:T	0	0	0	0	0	0	0	0
chr17:74237420:G:A	4	3	7	1	6	2.0	0.0	2.0
chr17:74244038:T:G	5	3	8	2	6	2	0	2
chr17:74249962:T:C	3	1	4	2	2	1	1	0
chr17:74250327:C:T	3	1	4	2	2	1	1	0
chr17:74252344:A:G	2	1	3	1	2	1.5	0.5	1.0
chr17:74253090:C:A	1	0	1	1	0	1	1	0
chr17:74299827:C:T	0	0	0	0	0	0	0	0
chr17:74466882:C:T	0	0	0	0	0	0	0	0
chr17:74473819:A:G	3	2	7	1	6	2	0	2
chr17:74525758:G:A	0	0	0	0	0	0	0	0
chr17:74592187:A:C	0	0	0	0	0	0	0	0
chr17:74612695:G:A	0	0	0	0	0	0	0	0
chr17:74613950:C:T	0	0	0	0	0	0	0	0
chr17:74617450:T:G	0	0	0	0	0	0	0	0
chr17:74772831:G:A	3	2	5	1	4	2	0	2
chr17:74773600:A:G	196	90	303	117	186	1.0	1.0	0.0
chr17:74775627:C:G	298	137	470	176	294	1.0	1.0	0.0
chr17:74836789:G:A	4	1	5	3	2	1.0	1.0	0.0
chr17:74838815:C:A	5	3	10	2	8	2	0	2
chr17:74842510:C:A	1	0	1	1	0	1	1	0
chr17:74847239:C:T	1	1	2	0	2	2	0	2
chr17:74864131:G:A	1	1	2	0	2	2	0	2
chr17:74866471:T:C	72	45	128	32	96	2.0	0.0	2.0
chr17:74866583:G:A	3	1	4	2	2	1	1	0
chr17:74866687:C:T	4	1	5	3	2	1.0	1.0	0.0
chr17:74866908:C:T	7	2	9	5	4	1	1	0
chr17:74868645:G:A	1	0	1	1	0	1	1	0
chr17:74872953:G:A	87	51	154	42	112	2	0	2
chr17:74931028:G:T	0	0	0	0	0	0	0	0
chr17:74947031:G:A	0	0	0	0	0	0	0	0
chr17:74953051:C:T	0	0	0	0	0	0	0	0
chr17:74960029:G:A	1	0	1	1	0	1	1	0
chr17:75003678:C:T	0	0	0	0	0	0	0	0
chr17:75003966:A:G	0	0	0	0	0	0	0	0
chr17:75020526:C:T	234	115	359	123	236	1.5	1.0	0.0
chr17:75093611:G:A	36	11	47	25	22	1.0	1.0	0.0
chr17:75131253:G:A	1816	1039	3876	1338	2538	2.0	1.0	2.0
chr17:75240070:C:T	10	8	18	2	16	2.0	0.0	2.0
chr17:75492713:C:T	1	1	2	0	2	2	0	2
chr17:75493486:C:G	1	1	2	0	2	2	0	2
chr17:75495813:G:A	0	0	0	0	0	0	0	0
chr17:75498882:G:A	1	1	2	0	2	2	0	2
chr17:75502571:G:A	0	0	0	0	0	0	0	0
chr17:75503616:T:C	0	0	0	0	0	0	0	0
chr17:75516940:A:G	3	0	3	3	0	1	1	0
chr17:75517104:C:A	3	1	4	2	2	1	1	0
chr17:75522122:G:C	64	24	88	40	48	1.0	1.0	0.0
chr17:75522203:G:C	63	24	87	39	48	1	1	0
chr17:75523332:C:T	51	19	72	34	38	1	1	0
chr17:75556104:G:A	52	27	80	25	55	1.5	0.0	1.5
chr17:75563261:G:A	0	0	0	0	0	0	0	0
chr17:75563482:G:A	5	2	7	3	4	1	1	0
chr17:75563548:A:G	4	1	4	3	1	1.0	1.0	0.0
chr17:75569090:T:C	3	2	5	1	4	2	0	2
chr17:75571765:C:T	12	6	18	6	12	1.5	0.5	1.0
chr17:75571974:C:T	15	6	21	9	12	1	1	0
chr17:75574637:C:G	18	7	25	11	14	1.0	1.0	0.0
chr17:75574949:A:G	20	8	30	12	18	1.0	1.0	0.0
chr17:75588584:CAGCC:GAGCA	7	4	11	3	8	2	0	2
chr17:75589597:T:C	0	0	0	0	0	0	0	0
chr17:75589605:T:C	0	0	0	0	0	0	0	0
chr17:75589899:C:G	0	0	0	0	0	0	0	0
chr17:75589915:TC:CA	0	0	0	0	0	0	0	0
chr17:75589947:T:C	1	1	2	0	2	2	0	2
chr17:75589964:G:A	1	1	2	0	2	2	0	2
chr17:75590103:C:G	1	0	1	1	0	1	1	0
chr17:75590152:C:G	1	1	2	0	2	2	0	2
chr17:75590246:T:G	0	0	0	0	0	0	0	0
chr17:75590277:G:A	0	0	0	0	0	0	0	0
chr17:75590332:C:T	0	0	0	0	0	0	0	0
chr17:75590683:T:C	1	0	1	1	0	1	1	0
chr17:75591187:C:T	4	0	4	4	0	1.0	1.0	0.0
chr17:75591703:A:G	2	2	4	0	4	2.0	0.0	2.0
chr17:75591946:C:T	2	0	2	2	0	1.0	1.0	0.0
chr17:75594736:C:T	0	0	0	0	0	0	0	0
chr17:75601463:A:G	8	4	12	4	8	1.5	0.5	1.0
chr17:75605946:G:A	0	0	0	0	0	0	0	0
chr17:75606000:G:A	0	0	0	0	0	0	0	0
chr17:75612824:G:A	4	3	7	1	6	2.0	0.0	2.0
chr17:75613031:G:A	5	1	6	4	2	1	1	0
chr17:75615742:T:C	1	1	2	0	2	2	0	2
chr17:75615827:C:T	1	1	2	0	2	2	0	2
chr17:75619807:A:G	1	0	1	1	0	1	1	0
chr17:75619853:T:C	1	0	1	1	0	1	1	0
chr17:75619882:T:C	12	9	21	3	18	2.0	0.0	2.0
chr17:75619903:G:A	12	9	21	3	18	2.0	0.0	2.0
chr17:75620008:T:C	12	9	21	3	18	2.0	0.0	2.0
chr17:75621024:A:C	1	0	1	1	0	1	1	0
chr17:75629350:G:A	5	3	8	2	6	2	0	2
chr17:75667292:A:T	12	1	13	11	2	1.0	1.0	0.0
chr17:75706173:G:A	0	0	0	0	0	0	0	0
chr17:75754778:C:G	11	9	20	2	18	2	0	2
chr17:75763471:G:A	0	0	0	0	0	0	0	0
chr17:75823444:C:T	3	1	5	3	2	2	1	0
chr17:75828040:T:C	96	48	151	51	100	2.0	0.5	1.0
chr17:75831124:T:C	56	29	87	29	58	2.0	0.5	2.0
chr17:76018387:C:A	0	0	0	0	0	0	0	0
chr17:76018547:G:A	0	0	0	0	0	0	0	0
chr17:76018553:G:T	0	0	0	0	0	0	0	0
chr17:76018587:T:C	0	0	0	0	0	0	0	0
chr17:76040492:A:T	5	1	6	4	2	1	1	0
chr17:76040831:A:G	7	1	8	6	2	1	1	0
chr17:76043786:T:C	11	4	15	7	8	1	1	0
chr17:76080334:G:A	0	0	0	0	0	0	0	0
chr17:76080561:G:A	0	0	0	0	0	0	0	0
chr17:76081416:G:C	91	40	139	55	84	1	1	0
chr17:76085264:C:T	1	1	2	0	2	2	0	2
chr17:76094580:A:G	127	57	191	73	118	1	1	0
chr17:76137893:C:T	0	0	0	0	0	0	0	0
chr17:76156285:A:G	0	0	0	0	0	0	0	0
chr17:76291123:C:G	9	3	12	6	6	1	1	0
chr17:76291308:T:C	6	1	7	5	2	1.0	1.0	0.0
chr17:76291513:G:A	4	1	5	3	2	1.0	1.0	0.0
chr17:76293419:G:A	7	3	10	4	6	1	1	0
chr17:76293624:A:G	11	4	16	8	8	1	1	0
chr17:76294016:T:A	16	7	24	10	14	1.5	1.0	0.0
chr17:76311656:T:C	275	138	443	151	292	2	1	2
chr17:76385474:G:A	1	1	2	0	2	2	0	2
chr17:76481538:C:T	25	10	35	15	20	1	1	0
chr17:76481609:C:T	6	4	10	2	8	2.0	0.0	2.0
chr17:76585832:C:G	0	0	0	0	0	0	0	0
chr17:76629604:A:G	0	0	0	0	0	0	0	0
chr17:76629633:T:C	0	0	0	0	0	0	0	0
chr17:76688319:T:C	0	0	0	0	0	0	0	0
chr17:76737017:G:A	1054	554	1946	696	1250	2.0	1.0	2.0
chr17:76932682:C:T	0	0	0	0	0	0	0	0
chr17:76940752:C:T	0	0	0	0	0	0	0	0
chr17:76948069:C:T	0	0	0	0	0	0	0	0
chr17:76948852:G:A	0	0	0	0	0	0	0	0
chr17:77194880:C:T	44	29	73	15	58	2.0	0.0	2.0
chr17:77211884:A:G	3	1	4	2	2	1	1	0
chr17:78050542:G:A	5	3	8	2	6	2	0	2
chr17:78064873:A:C	9	3	12	6	6	1	1	0
chr17:78097785:T:C	1	0	1	1	0	1	1	0
chr17:78102638:A:G	3	0	3	3	0	1	1	0
chr17:78132305:G:C	17	10	31	9	22	2	0	2
chr17:78134494:A:T	17	11	28	6	22	2	0	2
chr17:78134989:G:A	20	13	33	7	26	2.0	0.0	2.0
chr17:78161185:T:C	18	2	20	16	4	1.0	1.0	0.0
chr17:78399340:G:A	1	1	2	0	2	2	0	2
chr17:78399349:C:T	80	38	119	43	76	1.0	1.0	0.0
chr17:78459136:G:A	3	1	4	2	2	1	1	0
chr17:78459183:C:T	3	2	5	1	4	2	0	2
chr17:78459935:C:G	0	0	0	0	0	0	0	0
chr17:78485611:C:G	0	0	0	0	0	0	0	0
chr17:78485915:T:C	0	0	0	0	0	0	0	0
chr17:78486174:A:G	0	0	0	0	0	0	0	0
chr17:78486350:A:G	0	0	0	0	0	0	0	0
chr17:78499168:C:T	0	0	0	0	0	0	0	0
chr17:78500268:A:C	0	0	0	0	0	0	0	0
chr17:78500279:C:G	0	0	0	0	0	0	0	0
chr17:78501696:T:C	0	0	0	0	0	0	0	0
chr17:78501838:C:A	0	0	0	0	0	0	0	0
chr17:78507511:T:C	0	0	0	0	0	0	0	0
chr17:78507542:C:T	0	0	0	0	0	0	0	0
chr17:78510525:G:A	0	0	0	0	0	0	0	0
chr17:78529483:A:G	0	0	0	0	0	0	0	0
chr17:78532509:C:T	0	0	0	0	0	0	0	0
chr17:78532708:A:G	0	0	0	0	0	0	0	0
chr17:78551552:T:C	0	0	0	0	0	0	0	0
chr17:79044046:T:C	0	0	0	0	0	0	0	0
chr17:79044103:G:C	0	0	0	0	0	0	0	0
chr17:79046636:C:T	0	0	0	0	0	0	0	0
chr17:79079585:TCCCCCA:CCCTCCG	15	6	21	9	12	1	1	0
chr17:79080358:G:T	16	7	23	9	14	1.0	1.0	0.0
chr17:79085706:G:A	10	2	14	8	6	1.0	1.0	0.0
chr17:79094391:A:G	1	1	2	0	2	2	0	2
chr17:79952692:G:A	0	0	0	0	0	0	0	0
chr17:80245266:C:A	0	0	0	0	0	0	0	0
chr17:80245301:C:T	0	0	0	0	0	0	0	0
chr17:80287931:G:A	323	168	530	170	360	2	1	2
chr17:80288006:A:G	321	164	521	171	350	2	1	2
chr17:80288362:T:C	315	166	518	165	353	2	1	2
chr17:80332071:G:A	21	9	30	12	18	1	1	0
chr17:80332302:G:C	26	14	41	13	28	2.0	0.0	2.0
chr17:80332508:C:G	30	18	49	13	36	2.0	0.0	2.0
chr17:80334336:G:A	3	2	5	1	4	2	0	2
chr17:80337560:C:T	9	2	11	7	4	1	1	0
chr17:80345336:G:A	9	5	14	4	10	2	0	2
chr17:80345580:G:C	8	3	11	5	6	1.0	1.0	0.0
chr17:80347357:T:C	26	13	38	14	24	1.0	0.5	0.5
chr17:80353741:A:G	3	0	4	4	0	1	1	0
chr17:80360040:T:C	11	5	16	6	10	1	1	0
chr17:80422204:A:G	8	8	18	0	18	2.0	0.0	2.0
chr17:80473534:C:T	0	0	0	0	0	0	0	0
chr17:80545719:T:C	102	43	150	62	88	1.0	1.0	0.0
chr17:80823266:T:A	25	13	38	12	26	2	0	2
chr17:80880423:A:G	25	18	43	7	36	2	0	2
chr17:80891746:T:C	24	8	32	16	16	1.0	1.0	0.0
chr17:80923761:C:T	0	0	0	0	0	0	0	0
chr17:80923787:A:G	0	0	0	0	0	0	0	0
chr17:80940445:G:T	3	1	4	2	2	1	1	0
chr17:80945758:C:T	5	5	12	0	12	2	0	2
chr17:80961397:C:T	1	0	1	1	0	1	1	0
chr17:80964404:G:C	4	1	5	3	2	1.0	1.0	0.0
chr17:81192336:G:A	9	0	9	9	0	1	1	0
chr17:81208978:T:C	18	9	27	9	18	1.5	0.5	1.0
chr17:81229156:T:C	87	37	124	50	74	1	1	0
chr17:81231936:G:A	29	13	42	16	26	1	1	0
chr17:81236907:G:A	0	0	0	0	0	0	0	0
chr17:81457490:A:G	0	0	0	0	0	0	0	0
chr17:81457511:C:T	0	0	0	0	0	0	0	0
chr17:81459455:A:G	0	0	0	0	0	0	0	0
chr17:81460539:C:G	0	0	0	0	0	0	0	0
chr17:81462685:C:T	0	0	0	0	0	0	0	0
chr17:81528864:C:T	1	1	2	0	2	2	0	2
chr17:81645450:C:T	5	5	10	0	10	2	0	2
chr17:81665333:C:T	1106	564	1961	713	1248	2.0	1.0	2.0
chr17:81670337:C:G	504	212	794	338	456	1.0	1.0	0.0
chr17:81672520:G:A	202	82	299	127	172	1.0	1.0	0.0
chr17:81672678:C:T	204	83	306	128	178	1.0	1.0	0.0
chr17:81682274:A:G	222	85	324	146	178	1.0	1.0	0.0
chr17:81683151:A:G	9	4	13	5	8	1	1	0
chr17:81683645:C:G	62	39	106	24	82	2.0	0.0	2.0
chr17:81683798:T:G	13	3	16	10	6	1	1	0
chr17:81690810:A:G	1	1	2	0	2	2	0	2
chr17:81691382:T:G	2	2	4	0	4	2.0	0.0	2.0
chr17:81695037:A:G	8	4	12	4	8	1.5	0.5	1.0
chr17:81695719:C:T	0	0	0	0	0	0	0	0
chr17:81696850:T:C	34	21	57	13	44	2.0	0.0	2.0
chr17:81696901:T:C	38	24	64	14	50	2.0	0.0	2.0
chr17:81701105:G:T	139	58	199	83	116	1	1	0
chr17:81701522:C:T	173	74	252	104	148	1	1	0
chr17:81701634:C:T	214	97	326	128	198	1.0	1.0	0.0
chr17:81704684:T:C	288	145	501	189	312	2.0	1.0	2.0
chr17:81715528:T:C	8	7	15	1	14	2.0	0.0	2.0
chr17:81720188:G:A	4	3	7	1	6	2.0	0.0	2.0
chr17:81808949:C:A	0	0	0	0	0	0	0	0
chr17:81811590:T:C	0	0	0	0	0	0	0	0
chr17:81812864:C:T	0	0	0	0	0	0	0	0
chr17:81833721:A:G	7	4	11	3	8	2	0	2
chr17:81833916:G:A	4	1	5	3	2	1.0	1.0	0.0
chr17:81845225:A:G	271	149	450	142	308	2	0	2
chr17:81847258:G:A	210	107	326	112	214	2.0	1.0	2.0
chr17:81859129:G:A	2	0	2	2	0	1.0	1.0	0.0
chr17:81869287:C:T	16	8	24	8	16	1.5	0.5	1.0
chr17:81940768:G:A	0	0	0	0	0	0	0	0
chr17:81941396:A:G	0	0	0	0	0	0	0	0
chr17:81941407:C:T	0	0	0	0	0	0	0	0
chr17:81941619:G:A	0	0	0	0	0	0	0	0
chr17:81996668:T:A	140	85	233	58	175	2.0	0.0	2.0
chr17:82019724:C:T	9	4	13	5	8	1	1	0
chr17:82048936:C:T	4	3	7	1	6	2.0	0.0	2.0
chr17:82050011:A:G	6	4	11	3	8	2.0	0.0	2.0
chr17:82050021:G:T	6	4	11	3	8	2.0	0.0	2.0
chr17:82050516:G:T	12	6	18	6	12	1.5	0.5	1.0
chr17:82056985:T:G	14	5	19	9	10	1.0	1.0	0.0
chr17:82060838:C:T	2	2	4	0	4	2.0	0.0	2.0
chr17:82063098:C:T	3	2	5	1	4	2	0	2
chr17:82084916:C:T	0	0	0	0	0	0	0	0
chr17:82085168:C:G	0	0	0	0	0	0	0	0
chr17:82087210:G:C	0	0	0	0	0	0	0	0
chr17:82093307:A:G	2	1	3	1	2	1.5	0.5	1.0
chr17:82127757:A:G	8	6	16	2	14	2.0	0.0	2.0
chr17:82127827:G:T	8	6	16	2	14	2.0	0.0	2.0
chr17:82128510:CGTC:TGTT	7	5	14	2	12	2	0	2
chr17:82128519:T:C	7	5	14	2	12	2	0	2
chr17:82157571:G:A	5	2	8	4	4	2	1	0
chr17:82178542:C:T	5	1	6	4	2	1	1	0
chr17:82188309:T:C	4	4	8	0	8	2.0	0.0	2.0
chr17:82193929:T:C	5	2	7	3	4	1	1	0
chr17:82194005:G:A	8	3	11	5	6	1.0	1.0	0.0
chr17:82317377:T:C	0	0	0	0	0	0	0	0
chr17:82362113:C:G	0	0	0	0	0	0	0	0
chr17:82362127:C:G	0	0	0	0	0	0	0	0
chr17:82362685:G:A	0	0	0	0	0	0	0	0
chr17:82394427:G:A	133	75	216	64	152	2	0	2
chr17:82415501:G:T	224	119	353	113	240	2.0	0.0	2.0
chr17:82419814:T:G	205	115	332	94	238	2	0	2
chr17:82433808:A:G	79	42	124	38	86	2	0	2
chr17:82444070:A:G	505	231	797	315	482	2	1	0
chr17:82664607:G:T	0	0	0	0	0	0	0	0
chr17:82831592:G:A	0	0	0	0	0	0	0	0
chr17:82831752:T:C	0	0	0	0	0	0	0	0
chr17:82932762:T:C	7	4	11	3	8	2	0	2
chr17:82937377:G:A	1	1	2	0	2	2	0	2
chr17:82938057:A:G	64	31	95	33	62	1.0	1.0	0.0
chr17:82941405:G:A	69	32	101	37	64	1	1	0
chr17:83048753:C:T	16	6	22	10	12	1.0	1.0	0.0
chr17:83085299:G:T	0	0	0	0	0	0	0	0
chr18:49034:G:A	0	0	0	0	0	0	0	0
chr18:672792:C:T	0	0	0	0	0	0	0	0
chr18:672836:A:G	1	0	1	1	0	1	1	0
chr18:673016:C:T	4	2	17	7	10	2.0	1.0	1.0
chr18:691266:A:G	0	0	0	0	0	0	0	0
chr18:2740716:A:G	139	77	224	64	160	2	0	2
chr18:2763699:C:T	149	64	219	89	130	1	1	0
chr18:2885120:C:T	1	1	2	0	2	2	0	2
chr18:5197396:G:C	0	0	0	0	0	0	0	0
chr18:5410575:A:G	0	0	0	0	0	0	0	0
chr18:5416222:C:T	0	0	0	0	0	0	0	0
chr18:5956239:C:T	0	0	0	0	0	0	0	0
chr18:6889974:A:G	0	0	0	0	0	0	0	0
chr18:6943265:G:A	0	0	0	0	0	0	0	0
chr18:6977845:A:G	0	0	0	0	0	0	0	0
chr18:6985271:C:T	0	0	0	0	0	0	0	0
chr18:6986260:G:A	0	0	0	0	0	0	0	0
chr18:6999629:T:C	0	0	0	0	0	0	0	0
chr18:7008592:T:C	0	0	0	0	0	0	0	0
chr18:7010375:T:C	0	0	0	0	0	0	0	0
chr18:7013963:C:A	0	0	0	0	0	0	0	0
chr18:7017323:A:G	0	0	0	0	0	0	0	0
chr18:7023372:A:G	0	0	0	0	0	0	0	0
chr18:7033038:G:A	0	0	0	0	0	0	0	0
chr18:7034509:T:G	0	0	0	0	0	0	0	0
chr18:7049148:G:A	0	0	0	0	0	0	0	0
chr18:7567805:C:G	0	0	0	0	0	0	0	0
chr18:8783837:T:C	0	0	0	0	0	0	0	0
chr18:8784614:A:G	0	0	0	0	0	0	0	0
chr18:8784725:A:G	0	0	0	0	0	0	0	0
chr18:8825194:A:G	0	0	0	0	0	0	0	0
chr18:8830082:C:T	1	1	2	0	2	2	0	2
chr18:9887880:G:A	1	1	2	0	2	2	0	2
chr18:10487921:C:T	0	0	0	0	0	0	0	0
chr18:10488094:G:T	0	0	0	0	0	0	0	0
chr18:10539742:A:G	11	6	17	5	12	2	0	2
chr18:10540435:A:C	10	5	15	5	10	1.5	0.5	1.0
chr18:10699131:G:T	0	0	0	0	0	0	0	0
chr18:10731430:C:T	0	0	0	0	0	0	0	0
chr18:10748605:A:T	0	0	0	0	0	0	0	0
chr18:10758025:G:A	0	0	0	0	0	0	0	0
chr18:10759842:C:A	0	0	0	0	0	0	0	0
chr18:10762964:G:A	0	0	0	0	0	0	0	0
chr18:10763009:T:C	0	0	0	0	0	0	0	0
chr18:11610333:G:T	0	0	0	0	0	0	0	0
chr18:11610350:G:A	0	0	0	0	0	0	0	0
chr18:11610383:C:A	0	0	0	0	0	0	0	0
chr18:11884671:C:G	14	11	27	3	24	2.0	0.0	2.0
chr18:11893392:C:T	22	13	35	9	26	2.0	0.0	2.0
chr18:12254786:G:C	0	0	0	0	0	0	0	0
chr18:12254817:A:G	0	0	0	0	0	0	0	0
chr18:12274105:G:T	0	0	0	0	0	0	0	0
chr18:12978734:C:G	6	4	10	2	8	2.0	0.0	2.0
chr18:12984145:C:A	22	9	31	13	18	1.0	1.0	0.0
chr18:13068133:T:C	4	3	7	1	6	2.0	0.0	2.0
chr18:13095610:T:C	8	1	9	7	2	1.0	1.0	0.0
chr18:13116433:G:T	37	16	56	22	34	1	1	0
chr18:13387627:T:C	56	21	81	37	44	1.0	1.0	0.0
chr18:13642722:T:C	4	1	5	3	2	1.0	1.0	0.0
chr18:14132403:G:C	122	67	190	57	133	2.0	0.0	2.0
chr18:14183735:A:G	29	0	29	29	0	1	1	0
chr18:14183748:T:C	28	0	28	28	0	1.0	1.0	0.0
chr18:14542891:G:C	0	0	0	0	0	0	0	0
chr18:14613455:T:G	0	0	0	0	0	0	0	0
chr18:14848821:C:T	0	0	0	0	0	0	0	0
chr18:14848822:G:A	0	0	0	0	0	0	0	0
chr18:21573533:C:T	75	33	111	45	66	1	1	0
chr18:21574182:G:A	92	41	141	53	88	1.0	1.0	0.0
chr18:22200900:A:G	0	0	0	0	0	0	0	0
chr18:23437872:T:C	74	28	105	48	57	1.0	1.0	0.0
chr18:23463142:T:C	31	15	46	16	30	1	1	0
chr18:23544981:C:G	15	6	21	9	12	1	1	0
chr18:23568899:A:G	31	17	50	16	34	2	0	2
chr18:23931070:C:A	0	0	0	0	0	0	0	0
chr18:23954737:CTC:ATT	0	0	0	0	0	0	0	0
chr18:26286221:G:C	3	1	4	2	2	1	1	0
chr18:27963423:G:A	0	0	0	0	0	0	0	0
chr18:28036487:A:T	0	0	0	0	0	0	0	0
chr18:31354718:A:T	0	0	0	0	0	0	0	0
chr18:31355412:C:T	0	0	0	0	0	0	0	0
chr18:31388408:G:A	0	0	0	0	0	0	0	0
chr18:31406370:A:C	0	0	0	0	0	0	0	0
chr18:31475994:A:G	0	0	0	0	0	0	0	0
chr18:31524735:C:T	0	0	0	0	0	0	0	0
chr18:31545891:A:G	0	0	0	0	0	0	0	0
chr18:31870337:T:A	11	5	16	6	10	1	1	0
chr18:31907604:C:A	16	8	24	8	16	1.5	0.5	1.0
chr18:32217958:C:T	0	0	0	0	0	0	0	0
chr18:32270333:G:A	0	0	0	0	0	0	0	0
chr18:34890327:G:A	0	0	0	0	0	0	0	0
chr18:34890495:C:T	0	0	0	0	0	0	0	0
chr18:35140395:C:T	41	23	67	21	46	2	0	2
chr18:35242418:G:T	130	72	210	62	148	2.0	0.0	2.0
chr18:35243363:T:C	64	32	102	34	68	2.0	0.5	1.0
chr18:35246124:A:G	29	16	45	13	32	2	0	2
chr18:35337680:T:C	1110	613	1991	651	1340	2.0	1.0	2.0
chr18:35497696:A:G	58	34	94	24	70	2.0	0.0	2.0
chr18:35972635:C:T	50	35	90	16	74	2.0	0.0	2.0
chr18:35977503:A:G	241	113	389	141	248	2	1	0
chr18:36114157:G:A	18	11	29	7	22	2.0	0.0	2.0
chr18:36138363:A:C	184	94	284	94	190	2.0	0.0	2.0
chr18:36139471:C:T	26	13	40	14	26	2.0	0.5	1.0
chr18:36164714:T:C	144	74	224	72	152	2.0	0.0	2.0
chr18:36170083:C:T	82	53	138	32	106	2.0	0.0	2.0
chr18:36681548:C:T	0	0	0	0	0	0	0	0
chr18:36709179:A:G	0	0	0	0	0	0	0	0
chr18:44950031:G:C	135	77	216	60	156	2	0	2
chr18:45727281:C:T	7	2	9	5	4	1	1	0
chr18:45727373:C:A	8	3	11	5	6	1.0	1.0	0.0
chr18:45730222:A:G	0	0	0	0	0	0	0	0
chr18:46072237:G:A	5	5	11	1	10	2	0	2
chr18:46086986:C:A	2	1	5	1	4	2.5	0.5	2.0
chr18:46098058:G:A	88	35	129	54	75	1.0	1.0	0.0
chr18:46569511:G:A	0	0	0	0	0	0	0	0
chr18:46657135:C:T	0	0	0	0	0	0	0	0
chr18:46946835:A:C	2	0	2	2	0	1.0	1.0	0.0
chr18:47033473:G:A	0	0	0	0	0	0	0	0
chr18:47033667:C:A	0	0	0	0	0	0	0	0
chr18:47033752:C:T	0	0	0	0	0	0	0	0
chr18:47033929:C:T	0	0	0	0	0	0	0	0
chr18:47034504:C:A	0	0	0	0	0	0	0	0
chr18:47035145:C:G	0	0	0	0	0	0	0	0
chr18:47035248:G:C	0	0	0	0	0	0	0	0
chr18:47035259:C:T	0	0	0	0	0	0	0	0
chr18:47059584:G:A	0	0	0	0	0	0	0	0
chr18:47084347:T:C	22	11	34	12	22	2.0	0.5	1.0
chr18:47845324:A:G	30	27	59	3	56	2.0	0.0	2.0
chr18:48029458:T:C	0	0	0	0	0	0	0	0
chr18:49490664:A:G	39	19	62	20	42	1	1	0
chr18:49491450:A:G	203	117	337	91	246	2	0	2
chr18:49849733:C:G	0	0	0	0	0	0	0	0
chr18:50040277:A:G	0	0	0	0	0	0	0	0
chr18:50267603:G:A	6	2	8	4	4	1.0	1.0	0.0
chr18:50663901:T:G	0	0	0	0	0	0	0	0
chr18:50664070:G:A	0	0	0	0	0	0	0	0
chr18:50801445:G:A	22	13	35	9	26	2.0	0.0	2.0
chr18:50806833:C:G	46	32	78	14	64	2.0	0.0	2.0
chr18:52906232:C:G	0	0	0	0	0	0	0	0
chr18:54294435:G:A	26	12	39	15	24	1.5	1.0	0.0
chr18:54591317:T:C	0	0	0	0	0	0	0	0
chr18:54597828:C:T	0	0	0	0	0	0	0	0
chr18:54937957:C:T	3	3	4	0	4	1	0	1
chr18:55403683:G:A	20	11	39	11	28	2.0	0.0	2.0
chr18:57147794:G:T	0	0	0	0	0	0	0	0
chr18:57354494:A:C	0	0	0	0	0	0	0	0
chr18:57360103:G:T	0	0	0	0	0	0	0	0
chr18:57360295:C:T	0	0	0	0	0	0	0	0
chr18:57601640:T:C	66	29	96	38	58	1.0	1.0	0.0
chr18:57602545:G:A	9	2	11	7	4	1	1	0
chr18:57616004:T:C	4	1	5	3	2	1.0	1.0	0.0
chr18:57621844:C:T	61	19	90	44	46	1	1	0
chr18:58579210:T:C	0	0	0	0	0	0	0	0
chr18:61499308:C:T	0	0	0	0	0	0	0	0
chr18:62102800:C:T	6	1	7	5	2	1.0	1.0	0.0
chr18:62106804:C:T	6	1	7	5	2	1.0	1.0	0.0
chr18:62113160:T:A	4	2	6	2	4	1.5	0.5	1.0
chr18:62113191:A:G	3	2	5	1	4	2	0	2
chr18:62354528:C:T	0	0	0	0	0	0	0	0
chr18:62368850:A:G	0	0	0	0	0	0	0	0
chr18:63318646:T:C	800	408	1399	491	908	2.0	1.0	2.0
chr18:63595133:C:T	0	0	0	0	0	0	0	0
chr18:63597064:G:A	0	0	0	0	0	0	0	0
chr18:63597234:C:T	0	0	0	0	0	0	0	0
chr18:63712604:G:T	0	0	0	0	0	0	0	0
chr18:63979835:G:A	279	156	522	168	354	2	1	2
chr18:65843940:T:C	0	0	0	0	0	0	0	0
chr18:65862780:A:G	0	0	0	0	0	0	0	0
chr18:68697892:T:G	5	1	6	4	2	1	1	0
chr18:68837114:G:A	14	6	20	8	12	1.0	1.0	0.0
chr18:70020624:T:C	8	6	14	2	12	2.0	0.0	2.0
chr18:72750399:C:T	0	0	0	0	0	0	0	0
chr18:74147815:C:A	6	5	11	1	10	2.0	0.0	2.0
chr18:74147828:G:A	6	1	7	5	2	1.0	1.0	0.0
chr18:74291840:G:A	668	478	1325	237	1088	2.0	0.0	2.0
chr18:74353910:T:A	0	0	0	0	0	0	0	0
chr18:74567400:C:T	0	0	0	0	0	0	0	0
chr18:74632282:C:T	22	12	34	10	24	2.0	0.0	2.0
chr18:74632553:G:A	21	10	31	11	20	1	1	0
chr18:74632597:G:A	22	10	32	12	20	1.0	1.0	0.0
chr18:74635526:T:C	19	8	27	11	16	1	1	0
chr18:75064165:G:A	2	0	2	2	0	1.0	1.0	0.0
chr18:75202325:G:A	241	110	364	138	226	1	1	0
chr18:75285396:C:G	0	0	0	0	0	0	0	0
chr18:75285722:C:T	1	1	2	0	2	2	0	2
chr18:75286049:T:C	4	3	7	1	6	2.0	0.0	2.0
chr18:75286313:T:C	5	3	8	2	6	2	0	2
chr18:75286931:T:C	2	0	2	2	0	1.0	1.0	0.0
chr18:75287404:T:C	8	2	10	6	4	1.0	1.0	0.0
chr18:76968252:C:T	52	33	94	20	74	2.0	0.0	2.0
chr18:76990028:G:A	2	1	3	1	2	1.5	0.5	1.0
chr18:77250689:T:C	0	0	0	0	0	0	0	0
chr18:78993588:A:G	0	0	0	0	0	0	0	0
chr18:78993768:C:G	0	0	0	0	0	0	0	0
chr18:78994367:C:T	0	0	0	0	0	0	0	0
chr18:78994466:C:T	0	0	0	0	0	0	0	0
chr18:78994871:G:T	0	0	0	0	0	0	0	0
chr18:79372793:G:A	3	2	5	1	4	2	0	2
chr18:79410477:C:A	87	42	132	46	86	1	1	0
chr18:79467476:A:G	359	204	628	190	438	2	0	2
chr18:79486406:T:G	11	7	18	4	14	2	0	2
chr18:80037321:C:T	10	4	14	6	8	1.0	1.0	0.0
chr18:80045896:G:T	191	99	311	105	206	2	1	2
chr19:307345:G:A	8	3	11	5	6	1.0	1.0	0.0
chr19:362108:T:C	0	0	0	0	0	0	0	0
chr19:362283:C:T	0	0	0	0	0	0	0	0
chr19:464310:A:G	0	0	0	0	0	0	0	0
chr19:501786:C:A	1	0	1	1	0	1	1	0
chr19:501801:AG:CC	1	0	1	1	0	1	1	0
chr19:501900:C:A	1	1	2	0	2	2	0	2
chr19:541685:C:T	134	63	201	73	128	1.0	1.0	0.0
chr19:549725:TCCC:CCCG	12	7	36	16	20	2.5	1.0	2.0
chr19:605171:T:C	0	0	0	0	0	0	0	0
chr19:613307:C:T	8	4	12	4	8	1.5	0.5	1.0
chr19:691909:T:C	2	2	67	19	48	33.5	9.5	24.0
chr19:756985:T:G	0	0	0	0	0	0	0	0
chr19:804396:C:T	177	105	294	78	216	2	0	2
chr19:804642:C:T	171	103	286	74	212	2	0	2
chr19:808586:C:G	207	115	340	100	240	2	0	2
chr19:808742:G:T	221	121	363	109	254	2	0	2
chr19:814680:G:T	2	0	3	3	0	1.5	1.5	0.0
chr19:829568:C:T	2	1	3	1	2	1.5	0.5	1.0
chr19:830854:T:C	0	0	0	0	0	0	0	0
chr19:844020:G:A	0	0	0	0	0	0	0	0
chr19:855966:C:A	0	0	0	0	0	0	0	0
chr19:871222:G:A	153	75	235	83	152	2	1	0
chr19:872089:A:G	46	22	70	26	44	1.5	1.0	0.0
chr19:885818:A:G	11	6	17	5	12	2	0	2
chr19:899444:C:T	408	190	642	242	400	1.0	1.0	0.0
chr19:1003173:C:T	2	2	6	0	6	3.0	0.0	3.0
chr19:1011216:G:A	54	23	79	31	48	1.0	1.0	0.0
chr19:1036457:C:G	278	140	478	166	312	2.0	1.0	2.0
chr19:1036469:A:G	298	147	508	180	328	2.0	1.0	0.0
chr19:1036553:T:C	320	170	547	177	370	2.0	1.0	2.0
chr19:1036576:G:A	4	1	5	3	2	1.0	1.0	0.0
chr19:1036632:T:C	3	1	4	2	2	1	1	0
chr19:1037552:G:A	8	2	10	6	4	1.0	1.0	0.0
chr19:1037564:A:G	8	1	9	7	2	1.0	1.0	0.0
chr19:1037585:C:T	9	1	10	8	2	1	1	0
chr19:1052006:C:T	5	2	7	3	4	1	1	0
chr19:1054061:A:G	4	3	7	1	6	2.0	0.0	2.0
chr19:1055192:G:A	10	3	13	7	6	1.0	1.0	0.0
chr19:1056066:A:G	43	14	58	32	26	1	1	0
chr19:1056493:G:C	56	20	81	39	42	1.0	1.0	0.0
chr19:1064194:G:A	186	76	278	116	162	1.0	1.0	0.0
chr19:1065019:G:T	224	93	337	139	198	1.0	1.0	0.0
chr19:1068735:TTGCG:CTGCA	120	69	194	52	142	2.0	0.0	2.0
chr19:1074001:A:T	68	35	103	33	70	2.0	0.0	2.0
chr19:1077986:A:G	266	142	432	134	298	2.0	0.0	2.0
chr19:1079960:G:A	219	100	332	130	202	1	1	0
chr19:1080312:G:C	71	30	108	42	66	1	1	0
chr19:1081618:A:G	106	51	161	57	104	1.0	1.0	0.0
chr19:1085967:A:G	479	264	809	251	558	2	0	2
chr19:1086044:T:C	514	284	871	273	598	2.0	0.0	2.0
chr19:1095337:C:T	499	224	776	308	468	1	1	0
chr19:1104079:G:A	2474	1550	6839	2375	4464	2.0	1.0	2.0
chr19:1127616:G:C	9	5	14	4	10	2	0	2
chr19:1127721:G:A	9	5	14	4	10	2	0	2
chr19:1257137:C:T	23	11	34	12	22	1	1	0
chr19:1360576:G:A	21	10	37	11	26	1	1	0
chr19:1370676:C:G	15	7	21	8	13	1	1	0
chr19:1388539:C:T	1338	759	2553	825	1728	2.0	1.0	2.0
chr19:1398739:T:A	4	2	6	2	4	1.5	0.5	1.0
chr19:1487887:G:A	0	0	0	0	0	0	0	0
chr19:1495635:G:A	0	0	0	0	0	0	0	0
chr19:1495724:C:G	0	0	0	0	0	0	0	0
chr19:1533973:C:G	0	0	0	0	0	0	0	0
chr19:1535085:G:A	0	0	0	0	0	0	0	0
chr19:1535180:G:A	0	0	0	0	0	0	0	0
chr19:1535292:G:A	0	0	0	0	0	0	0	0
chr19:1783262:C:T	0	0	0	0	0	0	0	0
chr19:1784891:A:G	0	0	0	0	0	0	0	0
chr19:1784945:A:G	0	0	0	0	0	0	0	0
chr19:1877728:G:T	15	15	32	0	32	2	0	2
chr19:1877784:C:T	13	0	13	13	0	1	1	0
chr19:1997364:A:G	30	12	43	19	24	1.0	1.0	0.0
chr19:2097987:T:C	25	22	49	3	46	2	0	2
chr19:2098016:T:C	25	23	50	2	48	2	0	2
chr19:2109158:T:C	62	24	92	42	50	1.0	1.0	0.0
chr19:2109813:G:C	0	0	0	0	0	0	0	0
chr19:2110747:G:A	45	16	63	32	31	1	1	0
chr19:2111383:G:A	2	1	3	1	2	1.5	0.5	1.0
chr19:2111398:T:C	2	1	3	1	2	1.5	0.5	1.0
chr19:2111625:G:A	1	1	2	0	2	2	0	2
chr19:2111650:T:C	1	0	1	1	0	1	1	0
chr19:2111662:G:A	1	0	1	1	0	1	1	0
chr19:2116650:A:G	193	85	293	113	180	1	1	0
chr19:2118693:C:T	155	68	232	90	142	1	1	0
chr19:2214058:C:T	0	0	0	0	0	0	0	0
chr19:2226677:G:A	14	9	23	5	18	2.0	0.0	2.0
chr19:2339950:T:C	50	23	76	28	48	1.0	1.0	0.0
chr19:2341049:C:T	46	17	63	29	34	1.0	1.0	0.0
chr19:2343144:G:A	7	4	11	3	8	2	0	2
chr19:2353152:C:A	116	56	175	63	112	1.5	1.0	0.0
chr19:2396558:C:T	0	0	0	0	0	0	0	0
chr19:2396613:C:T	0	0	0	0	0	0	0	0
chr19:2410334:T:C	0	0	0	0	0	0	0	0
chr19:2413963:G:C	3	0	3	3	0	1	1	0
chr19:2421859:C:T	4	1	7	3	4	1.0	1.0	0.0
chr19:2477279:C:T	174	98	300	84	216	2.0	0.0	2.0
chr19:2477318:G:A	175	77	276	110	166	1	1	0
chr19:2520718:T:C	623	379	1167	325	842	2	0	2
chr19:2717258:C:G	0	0	0	0	0	0	0	0
chr19:2757776:G:A	114	54	170	60	110	1.0	1.0	0.0
chr19:2762587:A:C	110	49	162	62	100	1.0	1.0	0.0
chr19:2767194:G:T	156	82	242	76	166	2.0	0.0	2.0
chr19:2834375:C:T	3	1	4	2	2	1	1	0
chr19:2877367:C:T	1	0	1	1	0	1	1	0
chr19:2877830:A:T	1	1	2	0	2	2	0	2
chr19:2900917:GA:AT	4	1	5	3	2	1.0	1.0	0.0
chr19:2917289:C:A	12	7	19	5	14	2.0	0.0	2.0
chr19:2933482:C:T	20	11	31	9	22	2.0	0.0	2.0
chr19:2997792:T:C	5	3	8	2	6	2	0	2
chr19:3148821:G:T	0	0	0	0	0	0	0	0
chr19:3284821:T:C	0	0	0	0	0	0	0	0
chr19:3492435:G:C	96	53	156	48	108	2.0	0.0	2.0
chr19:3573878:G:A	41	19	60	22	38	1	1	0
chr19:3595796:A:G	20	11	35	9	26	2.0	0.0	2.0
chr19:3595925:G:A	20	9	30	12	18	1.5	1.0	0.0
chr19:3653527:C:T	10	6	16	4	12	2.0	0.0	2.0
chr19:3728611:G:A	0	0	0	0	0	0	0	0
chr19:3728675:T:C	0	0	0	0	0	0	0	0
chr19:3731987:G:A	0	0	0	0	0	0	0	0
chr19:3752876:A:G	55	24	80	32	48	1	1	0
chr19:3753771:C:T	48	21	70	28	42	1.0	1.0	0.0
chr19:3759704:T:C	64	31	98	34	64	1.5	1.0	0.0
chr19:3762700:C:T	1779	1250	4024	949	3075	2	0	2
chr19:3767267:C:T	1771	1104	3780	1148	2632	2	1	2
chr19:3771882:C:T	1	1	2	0	2	2	0	2
chr19:3823276:C:T	0	0	0	0	0	0	0	0
chr19:3924618:T:C	0	0	0	0	0	0	0	0
chr19:3982969:G:A	2019	1305	5043	1591	3452	2	1	2
chr19:3983186:A:G	2033	1317	5099	1610	3489	2	1	2
chr19:4013324:T:C	43	25	70	18	52	2	0	2
chr19:4028785:C:T	85	41	128	46	82	2	1	0
chr19:4033464:T:C	80	38	118	42	76	1.0	1.0	0.0
chr19:4090574:G:A	656	344	1149	386	763	2.0	1.0	2.0
chr19:4102451:G:A	392	207	645	217	428	2.0	1.0	2.0
chr19:4174953:A:G	7	1	8	6	2	1	1	0
chr19:4186398:T:G	22	15	37	7	30	2.0	0.0	2.0
chr19:4200159:G:A	0	0	0	0	0	0	0	0
chr19:4207943:G:A	1	1	2	0	2	2	0	2
chr19:4236999:G:A	0	0	0	0	0	0	0	0
chr19:4237070:A:G	0	0	0	0	0	0	0	0
chr19:4251072:T:C	337	158	521	197	324	1	1	0
chr19:4254378:C:T	327	153	505	191	314	1	1	0
chr19:4280189:C:T	0	0	0	0	0	0	0	0
chr19:4288208:T:C	0	0	0	0	0	0	0	0
chr19:4288223:C:T	0	0	0	0	0	0	0	0
chr19:4288335:A:G	0	0	0	0	0	0	0	0
chr19:4292600:C:T	3	2	8	2	6	2	1	2
chr19:4511338:T:A	1	0	1	1	0	1	1	0
chr19:4511441:G:A	1	1	2	0	2	2	0	2
chr19:4511513:A:G	1	1	2	0	2	2	0	2
chr19:4511635:C:G	1	1	2	0	2	2	0	2
chr19:4511713:T:C	1	1	1	0	1	1	0	1
chr19:4511718:T:C	1	1	2	0	2	2	0	2
chr19:4511943:T:C	1	1	2	0	2	2	0	2
chr19:4513547:A:G	6	1	7	5	2	1.0	1.0	0.0
chr19:4538587:G:A	0	0	0	0	0	0	0	0
chr19:4818366:T:C	10	3	13	7	6	1.0	1.0	0.0
chr19:4929401:T:C	2	0	2	2	0	1.0	1.0	0.0
chr19:4929461:A:G	2	0	2	2	0	1.0	1.0	0.0
chr19:4954442:C:T	1	0	1	1	0	1	1	0
chr19:4954443:G:A	1	1	2	0	2	2	0	2
chr19:5210751:G:A	2	1	3	1	2	1.5	0.5	1.0
chr19:5210771:G:A	2	1	3	1	2	1.5	0.5	1.0
chr19:5212369:C:T	5	3	8	2	6	2	0	2
chr19:5218825:G:A	0	0	0	0	0	0	0	0
chr19:5273560:T:G	14	7	23	7	16	1.5	0.5	1.0
chr19:5455600:C:T	0	0	0	0	0	0	0	0
chr19:5455724:G:A	0	0	0	0	0	0	0	0
chr19:5455785:A:G	0	0	0	0	0	0	0	0
chr19:5455960:G:T	0	0	0	0	0	0	0	0
chr19:5455967:T:C	0	0	0	0	0	0	0	0
chr19:5455979:G:A	0	0	0	0	0	0	0	0
chr19:5456439:T:C	0	0	0	0	0	0	0	0
chr19:5562104:G:A	4	0	4	4	0	1.0	1.0	0.0
chr19:5664142:C:T	198	106	323	101	222	2.0	0.0	2.0
chr19:5696135:G:A	39	20	59	19	40	2	0	2
chr19:5866574:C:T	3	1	4	2	2	1	1	0
chr19:5867737:G:T	3	1	4	2	2	1	1	0
chr19:6042048:C:T	0	0	0	0	0	0	0	0
chr19:6156472:T:C	0	0	0	0	0	0	0	0
chr19:6422412:C:A	9	8	17	1	16	2	0	2
chr19:6466471:A:G	10	7	16	3	13	2.0	0.0	2.0
chr19:6468137:G:A	3	0	3	3	0	1	1	0
chr19:6468320:T:C	67	30	99	39	60	1	1	0
chr19:6583268:T:A	2	0	2	2	0	1.0	1.0	0.0
chr19:6586257:G:A	151	145	359	7	352	2	0	2
chr19:6677788:G:A	0	0	0	0	0	0	0	0
chr19:6681980:G:A	0	0	0	0	0	0	0	0
chr19:6710937:G:A	0	0	0	0	0	0	0	0
chr19:6713280:C:T	0	0	0	0	0	0	0	0
chr19:6731046:T:C	394	196	628	220	408	2.0	1.0	0.0
chr19:6737470:T:C	260	129	406	138	268	1.5	1.0	0.0
chr19:6737498:G:A	259	128	404	138	266	1	1	0
chr19:6743388:A:T	3	1	4	2	2	1	1	0
chr19:6754177:T:C	8	8	15	0	15	2.0	0.0	2.0
chr19:6754996:T:C	38	20	61	19	42	2.0	0.0	2.0
chr19:6919613:A:C	0	0	0	0	0	0	0	0
chr19:6919742:A:G	0	0	0	0	0	0	0	0
chr19:7075012:C:T	85	39	131	47	84	1	1	0
chr19:7152692:C:T	0	0	0	0	0	0	0	0
chr19:7163054:G:A	0	0	0	0	0	0	0	0
chr19:7166377:G:A	0	0	0	0	0	0	0	0
chr19:7557340:G:A	43	25	68	18	50	2	0	2
chr19:7616465:G:A	1	0	1	1	0	1	1	0
chr19:7620957:G:A	85	43	129	43	86	2	0	2
chr19:7645383:A:G	1	0	1	1	0	1	1	0
chr19:7647307:G:A	63	28	95	35	60	1	1	0
chr19:7647391:A:G	527	275	878	294	584	2	1	2
chr19:7647588:G:A	48	23	72	26	46	1.5	1.0	0.0
chr19:7647699:T:G	65	32	97	33	64	1	1	0
chr19:7698817:A:G	1994	1314	6117	1962	4155	2.0	1.0	2.0
chr19:7699855:G:A	325	178	541	169	372	2	0	2
chr19:7699886:T:C	323	179	540	167	373	2	0	2
chr19:7870830:G:A	0	0	0	0	0	0	0	0
chr19:7871322:A:G	0	0	0	0	0	0	0	0
chr19:7899091:T:C	0	0	0	0	0	0	0	0
chr19:7900325:G:A	0	0	0	0	0	0	0	0
chr19:7921753:C:G	139	54	209	93	116	1	1	0
chr19:8073170:C:A	0	0	0	0	0	0	0	0
chr19:8081037:C:T	0	0	0	0	0	0	0	0
chr19:8090106:C:T	0	0	0	0	0	0	0	0
chr19:8094478:G:T	0	0	0	0	0	0	0	0
chr19:8094525:G:T	0	0	0	0	0	0	0	0
chr19:8096013:G:C	0	0	0	0	0	0	0	0
chr19:8103661:C:T	0	0	0	0	0	0	0	0
chr19:8111685:G:A	0	0	0	0	0	0	0	0
chr19:8111756:C:T	0	0	0	0	0	0	0	0
chr19:8112035:C:T	0	0	0	0	0	0	0	0
chr19:8126517:G:A	0	0	0	0	0	0	0	0
chr19:8131624:G:C	0	0	0	0	0	0	0	0
chr19:8131759:G:A	0	0	0	0	0	0	0	0
chr19:8133099:G:A	0	0	0	0	0	0	0	0
chr19:8136395:C:T	0	0	0	0	0	0	0	0
chr19:8138304:G:A	0	0	0	0	0	0	0	0
chr19:8138444:G:A	0	0	0	0	0	0	0	0
chr19:8257062:T:C	62	21	86	42	44	1.0	1.0	0.0
chr19:8257085:C:T	0	0	0	0	0	0	0	0
chr19:8321422:G:A	3	1	5	3	2	2	1	0
chr19:8324521:G:A	5	2	7	3	4	1	1	0
chr19:8324636:C:T	6	4	10	2	8	2.0	0.0	2.0
chr19:8333122:C:T	1	1	2	0	2	2	0	2
chr19:8333830:A:G	0	0	0	0	0	0	0	0
chr19:8334091:C:T	1	0	1	1	0	1	1	0
chr19:8334388:G:A	1	1	2	0	2	2	0	2
chr19:8371280:C:T	2	0	2	2	0	1.0	1.0	0.0
chr19:8422000:G:A	494	281	874	268	606	2.0	0.0	2.0
chr19:8430881:G:A	32	18	50	14	36	2.0	0.0	2.0
chr19:8438461:G:C	464	218	778	292	486	2.0	1.0	0.0
chr19:8511423:A:G	71	43	120	34	86	2	0	2
chr19:8511584:A:C	17	12	30	6	24	2	0	2
chr19:8511978:G:C	15	12	27	3	24	2	0	2
chr19:8512004:C:G	14	11	25	3	22	2.0	0.0	2.0
chr19:8513116:G:A	167	99	276	76	200	2	0	2
chr19:8513234:A:G	162	90	261	81	180	2.0	0.0	2.0
chr19:8513315:T:C	160	93	263	75	188	2.0	0.0	2.0
chr19:8514127:T:C	312	202	538	127	411	2.0	0.0	2.0
chr19:8554577:A:G	35	22	58	15	43	2	0	2
chr19:8577276:T:C	8	5	13	3	10	2.0	0.0	2.0
chr19:8586678:A:G	0	0	0	0	0	0	0	0
chr19:8592987:G:C	0	0	0	0	0	0	0	0
chr19:8698023:T:G	0	0	0	0	0	0	0	0
chr19:8698550:G:A	0	0	0	0	0	0	0	0
chr19:8698592:G:A	0	0	0	0	0	0	0	0
chr19:8731196:C:T	0	0	0	0	0	0	0	0
chr19:8843125:T:C	0	0	0	0	0	0	0	0
chr19:8843246:C:T	0	0	0	0	0	0	0	0
chr19:8851305:C:G	0	0	0	0	0	0	0	0
chr19:8895043:A:G	0	0	0	0	0	0	0	0
chr19:8908929:C:G	0	0	0	0	0	0	0	0
chr19:8909477:CA:TG	0	0	0	0	0	0	0	0
chr19:8937644:C:T	0	0	0	0	0	0	0	0
chr19:8937666:C:T	0	0	0	0	0	0	0	0
chr19:8937745:T:C	0	0	0	0	0	0	0	0
chr19:8939234:C:T	0	0	0	0	0	0	0	0
chr19:8946306:G:A	0	0	0	0	0	0	0	0
chr19:8946313:C:G	0	0	0	0	0	0	0	0
chr19:8947948:G:A	0	0	0	0	0	0	0	0
chr19:8948231:G:C	0	0	0	0	0	0	0	0
chr19:8949409:C:T	0	0	0	0	0	0	0	0
chr19:8949865:C:T	0	0	0	0	0	0	0	0
chr19:8949896:G:A	0	0	0	0	0	0	0	0
chr19:8949980:C:T	0	0	0	0	0	0	0	0
chr19:8950883:C:G	0	0	0	0	0	0	0	0
chr19:8951739:T:G	0	0	0	0	0	0	0	0
chr19:8953002:T:G	0	0	0	0	0	0	0	0
chr19:8953259:G:A	0	0	0	0	0	0	0	0
chr19:8954956:T:C	0	0	0	0	0	0	0	0
chr19:8956198:G:T	0	0	0	0	0	0	0	0
chr19:8959116:G:A	0	0	0	0	0	0	0	0
chr19:8959216:A:C	0	0	0	0	0	0	0	0
chr19:8961545:G:A	0	0	0	0	0	0	0	0
chr19:8961637:A:G	0	0	0	0	0	0	0	0
chr19:8962199:G:A	0	0	0	0	0	0	0	0
chr19:8962299:G:A	0	0	0	0	0	0	0	0
chr19:8963397:G:A	0	0	0	0	0	0	0	0
chr19:8964274:G:T	0	0	0	0	0	0	0	0
chr19:8964541:T:A	0	0	0	0	0	0	0	0
chr19:8964670:T:A	0	0	0	0	0	0	0	0
chr19:8964908:T:A	0	0	0	0	0	0	0	0
chr19:8964959:G:A	0	0	0	0	0	0	0	0
chr19:8965061:T:C	0	0	0	0	0	0	0	0
chr19:8965293:C:T	0	0	0	0	0	0	0	0
chr19:8966052:C:T	0	0	0	0	0	0	0	0
chr19:8966253:T:G	0	0	0	0	0	0	0	0
chr19:8966274:C:A	0	0	0	0	0	0	0	0
chr19:8966315:C:T	0	0	0	0	0	0	0	0
chr19:8966384:C:T	0	0	0	0	0	0	0	0
chr19:8966588:T:G	0	0	0	0	0	0	0	0
chr19:8966760:G:A	0	0	0	0	0	0	0	0
chr19:8966905:G:T	0	0	0	0	0	0	0	0
chr19:8967099:A:C	0	0	0	0	0	0	0	0
chr19:8972448:G:A	0	0	0	0	0	0	0	0
chr19:8972751:A:G	0	0	0	0	0	0	0	0
chr19:8972781:C:T	0	0	0	0	0	0	0	0
chr19:8973507:G:A	0	0	0	0	0	0	0	0
chr19:8973623:T:C	0	0	0	0	0	0	0	0
chr19:8974967:A:G	0	0	0	0	0	0	0	0
chr19:8975642:G:A	0	0	0	0	0	0	0	0
chr19:8976143:G:A	0	0	0	0	0	0	0	0
chr19:8977082:G:A	0	0	0	0	0	0	0	0
chr19:8977341:T:G	0	0	0	0	0	0	0	0
chr19:8977654:G:A	0	0	0	0	0	0	0	0
chr19:8978096:T:C	0	0	0	0	0	0	0	0
chr19:9093631:A:G	0	0	0	0	0	0	0	0
chr19:9156643:G:T	65	36	104	32	72	2	0	2
chr19:9185988:T:C	0	0	0	0	0	0	0	0
chr19:9214440:G:A	0	0	0	0	0	0	0	0
chr19:9610725:A:T	36	17	61	19	42	1.0	1.0	0.0
chr19:9757602:T:C	18	6	24	12	12	1.0	1.0	0.0
chr19:9757728:C:T	15	5	20	10	10	1	1	0
chr19:9960387:T:C	0	0	0	0	0	0	0	0
chr19:9960671:C:T	0	0	0	0	0	0	0	0
chr19:9966743:C:G	0	0	0	0	0	0	0	0
chr19:9968417:C:T	0	0	0	0	0	0	0	0
chr19:9973616:C:G	0	0	0	0	0	0	0	0
chr19:9974378:G:A	0	0	0	0	0	0	0	0
chr19:9977595:C:G	0	0	0	0	0	0	0	0
chr19:9996260:G:C	0	0	0	0	0	0	0	0
chr19:10003576:C:G	0	0	0	0	0	0	0	0
chr19:10004064:T:A	2	1	3	1	2	1.5	0.5	1.0
chr19:10013372:A:G	0	0	0	0	0	0	0	0
chr19:10018876:C:G	0	0	0	0	0	0	0	0
chr19:10021614:C:T	0	0	0	0	0	0	0	0
chr19:10090085:C:G	16	11	29	5	24	2.0	0.0	2.0
chr19:10092495:A:G	492	233	794	303	491	2.0	1.0	0.0
chr19:10107848:C:G	172	103	288	76	212	2.0	0.0	2.0
chr19:10110475:C:G	20	12	32	8	24	2.0	0.0	2.0
chr19:10113850:C:T	4	2	6	2	4	1.5	0.5	1.0
chr19:10115006:G:C	41	19	61	23	38	1	1	0
chr19:10115101:A:G	2850	1895	7994	2622	5372	2.0	1.0	2.0
chr19:10115580:A:G	2816	1862	7868	2597	5271	2.0	1.0	2.0
chr19:10259866:C:T	632	340	1106	363	743	2.0	1.0	2.0
chr19:10285007:A:G	2	1	3	1	2	1.5	0.5	1.0
chr19:10291016:G:A	0	0	0	0	0	0	0	0
chr19:10292262:G:A	0	0	0	0	0	0	0	0
chr19:10292692:G:A	0	0	0	0	0	0	0	0
chr19:10315952:T:C	236	112	359	129	230	1.0	1.0	0.0
chr19:10321658:T:G	2	1	3	1	2	1.5	0.5	1.0
chr19:10334150:G:A	1	1	2	0	2	2	0	2
chr19:10338716:A:G	1601	916	3224	1086	2138	2	1	2
chr19:10352442:G:C	121	59	184	66	118	2	1	0
chr19:10354011:A:G	10	4	14	6	8	1.0	1.0	0.0
chr19:10364976:C:A	12	8	20	4	16	2.0	0.0	2.0
chr19:10489289:G:A	43	17	64	28	36	1	1	0
chr19:10489766:G:C	33	13	48	22	26	1	1	0
chr19:10553956:A:G	165	92	271	83	188	2	0	2
chr19:10557707:T:C	26	11	36	15	21	1.0	1.0	0.0
chr19:10557776:A:G	53	25	78	28	50	1	1	0
chr19:10559508:C:G	54	27	82	28	54	2.0	0.5	1.0
chr19:10560316:C:T	94	49	148	50	98	2.0	0.0	2.0
chr19:10561817:C:T	170	88	266	88	178	2.0	0.0	2.0
chr19:10565861:C:A	6	6	12	0	12	2.0	0.0	2.0
chr19:10677169:A:G	759	413	1321	421	900	2	1	2
chr19:10919590:C:T	8	4	12	4	8	1.5	0.5	1.0
chr19:11018924:C:T	0	0	0	0	0	0	0	0
chr19:11100403:C:T	0	0	0	0	0	0	0	0
chr19:11113589:A:G	0	0	0	0	0	0	0	0
chr19:11116124:C:T	0	0	0	0	0	0	0	0
chr19:11131368:G:A	0	0	0	0	0	0	0	0
chr19:11248024:T:C	13	8	21	5	16	2	0	2
chr19:11252470:A:T	11	4	15	7	8	1	1	0
chr19:11296276:A:G	0	0	0	0	0	0	0	0
chr19:11301192:C:A	4	3	9	1	8	2.0	0.0	2.0
chr19:11397501:G:A	1	1	2	0	2	2	0	2
chr19:11416083:G:A	0	0	0	0	0	0	0	0
chr19:11416089:T:G	0	0	0	0	0	0	0	0
chr19:11448343:A:G	3	3	6	0	6	2	0	2
chr19:11458582:G:A	0	0	0	0	0	0	0	0
chr19:11487668:T:C	11	6	17	5	12	2	0	2
chr19:11487785:C:T	11	6	17	5	12	2	0	2
chr19:11507951:A:C	62	30	95	33	62	1.5	1.0	0.0
chr19:11507968:T:C	63	31	97	33	64	2	1	0
chr19:11538877:T:G	0	0	0	0	0	0	0	0
chr19:11549398:C:T	0	0	0	0	0	0	0	0
chr19:11549496:G:A	0	0	0	0	0	0	0	0
chr19:11614598:G:A	33	17	50	16	34	2	0	2
chr19:11780188:G:A	22	13	35	9	26	2.0	0.0	2.0
chr19:11830406:T:A	15	8	23	7	16	2	0	2
chr19:11831547:A:G	12	5	17	7	10	1.0	1.0	0.0
chr19:11831800:A:C	9	3	12	6	6	1	1	0
chr19:11831956:G:A	9	3	12	6	6	1	1	0
chr19:11832898:G:A	2	1	3	1	2	1.5	0.5	1.0
chr19:12076806:T:C	33	21	54	12	42	2	0	2
chr19:12391487:G:A	10	4	14	6	8	1.0	1.0	0.0
chr19:12391973:G:A	21	8	30	13	17	1	1	0
chr19:12465235:G:A	18	7	26	12	14	1.0	1.0	0.0
chr19:12643315:T:C	38	29	66	9	57	2.0	0.0	2.0
chr19:12643323:A:G	37	26	63	11	52	2	0	2
chr19:12657577:G:A	30	12	43	19	24	1.0	1.0	0.0
chr19:12766150:G:C	7	4	11	3	8	2	0	2
chr19:12828978:T:C	0	0	0	0	0	0	0	0
chr19:12847883:T:C	0	0	0	0	0	0	0	0
chr19:12852329:T:C	1	1	2	0	2	2	0	2
chr19:12874762:A:G	0	0	0	0	0	0	0	0
chr19:12878746:G:A	298	151	471	161	310	2.0	1.0	2.0
chr19:12896283:G:A	203	89	307	124	183	1	1	0
chr19:12899706:A:G	170	82	265	95	170	2.0	1.0	0.0
chr19:13245336:T:G	0	0	0	0	0	0	0	0
chr19:13262663:A:G	0	0	0	0	0	0	0	0
chr19:13283523:A:G	0	0	0	0	0	0	0	0
chr19:13286746:C:T	0	0	0	0	0	0	0	0
chr19:13334330:C:T	0	0	0	0	0	0	0	0
chr19:13334394:C:T	0	0	0	0	0	0	0	0
chr19:13756204:C:G	608	308	1005	339	666	2.0	1.0	2.0
chr19:13759339:C:A	152	82	238	72	166	2.0	0.0	2.0
chr19:13768530:G:A	58	38	103	23	80	2.0	0.0	2.0
chr19:13799725:G:A	8	3	12	6	6	1.5	1.0	0.0
chr19:13830145:G:C	1	1	2	0	2	2	0	2
chr19:13877602:A:G	0	0	0	0	0	0	0	0
chr19:13889357:T:C	0	0	0	0	0	0	0	0
chr19:13889587:A:G	0	0	0	0	0	0	0	0
chr19:13890057:C:T	0	0	0	0	0	0	0	0
chr19:13905961:G:A	1	0	1	1	0	1	1	0
chr19:13906020:A:G	1	0	1	1	0	1	1	0
chr19:13919876:T:C	43	20	68	24	44	1	1	0
chr19:13927289:G:A	33	14	51	23	28	1	1	0
chr19:13927978:C:T	31	17	48	14	34	2	0	2
chr19:13930083:G:A	40	17	58	24	34	1.0	1.0	0.0
chr19:13972949:T:C	4	3	7	1	6	2.0	0.0	2.0
chr19:14028192:A:G	1	0	1	1	0	1	1	0
chr19:14151608:G:A	0	0	0	0	0	0	0	0
chr19:14396316:C:T	6	0	6	6	0	1.0	1.0	0.0
chr19:14397573:G:A	36	18	54	18	36	1.5	0.5	1.0
chr19:14471727:C:T	356	193	605	193	412	2.0	0.0	2.0
chr19:14472770:C:T	0	0	0	0	0	0	0	0
chr19:14478566:C:T	116	47	164	70	94	1.0	1.0	0.0
chr19:14563291:A:G	0	0	0	0	0	0	0	0
chr19:14610207:C:T	97	45	151	57	94	2	1	0
chr19:14668738:C:A	0	0	0	0	0	0	0	0
chr19:14752338:G:A	0	0	0	0	0	0	0	0
chr19:14776784:A:G	1	1	2	0	2	2	0	2
chr19:14799398:C:G	0	0	0	0	0	0	0	0
chr19:14799509:A:G	0	0	0	0	0	0	0	0
chr19:14799842:T:C	0	0	0	0	0	0	0	0
chr19:14827609:C:G	0	0	0	0	0	0	0	0
chr19:14841086:G:T	0	0	0	0	0	0	0	0
chr19:14841205:T:A	0	0	0	0	0	0	0	0
chr19:14841426:A:G	0	0	0	0	0	0	0	0
chr19:14841748:G:T	0	0	0	0	0	0	0	0
chr19:14881219:A:G	0	0	0	0	0	0	0	0
chr19:14961975:A:T	0	0	0	0	0	0	0	0
chr19:15020518:G:A	0	0	0	0	0	0	0	0
chr19:15022950:G:C	0	0	0	0	0	0	0	0
chr19:15022975:C:A	0	0	0	0	0	0	0	0
chr19:15023114:C:A	0	0	0	0	0	0	0	0
chr19:15087213:A:T	0	0	0	0	0	0	0	0
chr19:15087630:G:T	0	0	0	0	0	0	0	0
chr19:15087696:T:C	0	0	0	0	0	0	0	0
chr19:15087795:C:T	0	0	0	0	0	0	0	0
chr19:15087940:T:C	0	0	0	0	0	0	0	0
chr19:15088040:A:T	0	0	0	0	0	0	0	0
chr19:15115800:C:A	4	1	5	3	2	1.0	1.0	0.0
chr19:15116219:G:A	71	31	103	41	62	1	1	0
chr19:15119182:A:G	57	29	85	28	57	1	0	1
chr19:15122770:C:A	65	27	91	38	53	1	1	0
chr19:15122820:G:A	10	2	12	8	4	1.0	1.0	0.0
chr19:15160960:G:A	0	0	0	0	0	0	0	0
chr19:15162410:T:C	1	0	1	1	0	1	1	0
chr19:15162420:A:G	1	0	1	1	0	1	1	0
chr19:15162437:A:C	1	0	1	1	0	1	1	0
chr19:15174241:T:C	0	0	0	0	0	0	0	0
chr19:15178802:A:T	0	0	0	0	0	0	0	0
chr19:15179314:G:A	0	0	0	0	0	0	0	0
chr19:15181626:T:C	0	0	0	0	0	0	0	0
chr19:15184323:G:A	0	0	0	0	0	0	0	0
chr19:15192033:T:C	0	0	0	0	0	0	0	0
chr19:15192152:G:A	0	0	0	0	0	0	0	0
chr19:15454235:G:A	110	53	168	60	108	1.5	1.0	0.0
chr19:15537904:G:A	0	0	0	0	0	0	0	0
chr19:15615749:G:T	0	0	0	0	0	0	0	0
chr19:15628274:T:C	0	0	0	0	0	0	0	0
chr19:15628464:C:T	0	0	0	0	0	0	0	0
chr19:15628505:T:C	0	0	0	0	0	0	0	0
chr19:15628787:A:C	0	0	0	0	0	0	0	0
chr19:15629410:C:T	0	0	0	0	0	0	0	0
chr19:15629458:C:G	0	0	0	0	0	0	0	0
chr19:15629465:G:A	0	0	0	0	0	0	0	0
chr19:15647117:T:C	0	0	0	0	0	0	0	0
chr19:15650071:C:A	0	0	0	0	0	0	0	0
chr19:15652911:G:A	0	0	0	0	0	0	0	0
chr19:15678447:T:C	0	0	0	0	0	0	0	0
chr19:15680322:T:A	0	0	0	0	0	0	0	0
chr19:15728358:C:T	0	0	0	0	0	0	0	0
chr19:15728364:C:T	0	0	0	0	0	0	0	0
chr19:15807624:C:A	0	0	0	0	0	0	0	0
chr19:15807690:G:C	0	0	0	0	0	0	0	0
chr19:16067777:A:C	0	0	0	0	0	0	0	0
chr19:16164844:C:T	3	1	4	2	2	1	1	0
chr19:16226612:T:C	0	0	0	0	0	0	0	0
chr19:16228904:C:T	49	24	75	25	50	1	1	0
chr19:16436967:C:T	184	95	293	103	190	2.0	1.0	2.0
chr19:16482762:G:A	1	1	2	0	2	2	0	2
chr19:16490383:C:T	1	0	1	1	0	1	1	0
chr19:16501167:T:C	16	11	27	5	22	2.0	0.0	2.0
chr19:16501200:T:C	16	11	27	5	22	2.0	0.0	2.0
chr19:16520336:G:A	8	3	11	5	6	1.0	1.0	0.0
chr19:16520511:T:C	7	3	10	4	6	1	1	0
chr19:16520965:G:C	11	4	15	7	8	1	1	0
chr19:16680632:T:C	48	24	74	24	50	1.5	0.5	1.0
chr19:16744454:A:G	0	0	0	0	0	0	0	0
chr19:16815256:A:T	0	0	0	0	0	0	0	0
chr19:16957811:C:G	0	0	0	0	0	0	0	0
chr19:16997325:C:T	0	0	0	0	0	0	0	0
chr19:17000487:A:G	0	0	0	0	0	0	0	0
chr19:17052851:C:T	93	42	143	51	92	1	1	0
chr19:17060075:C:T	155	75	241	87	154	2	1	0
chr19:17102179:CCCC:TCCT	288	141	451	165	286	2.0	1.0	0.0
chr19:17163083:G:T	53	27	80	26	54	2	0	2
chr19:17200417:G:A	26	13	40	14	26	1.5	1.0	1.0
chr19:17263917:G:C	0	0	0	0	0	0	0	0
chr19:17282085:G:A	3	2	5	1	4	2	0	2
chr19:17282721:T:A	3	2	5	1	4	2	0	2
chr19:17283116:C:A	0	0	0	0	0	0	0	0
chr19:17283315:T:G	3	2	5	1	4	2	0	2
chr19:17292605:C:G	87	53	143	35	108	2	0	2
chr19:17301557:G:A	66	30	96	36	60	1.0	1.0	0.0
chr19:17301590:G:A	66	30	96	36	60	1.0	1.0	0.0
chr19:17306271:C:T	873	536	1662	446	1216	2	0	2
chr19:17325042:G:T	1	1	2	0	2	2	0	2
chr19:17331100:T:G	1	1	2	0	2	2	0	2
chr19:17338348:C:G	1	1	2	0	2	2	0	2
chr19:17338793:C:T	1	1	2	0	2	2	0	2
chr19:17338890:A:G	1	1	2	0	2	2	0	2
chr19:17341718:G:T	40	27	72	14	58	2.0	0.0	2.0
chr19:17366124:G:T	1	1	2	0	2	2	0	2
chr19:17377332:A:C	0	0	0	0	0	0	0	0
chr19:17420641:G:A	13	6	22	8	14	2	1	0
chr19:17422317:A:G	12	7	20	5	15	2.0	0.0	2.0
chr19:17517778:A:G	2123	1389	6014	1861	4153	2	1	2
chr19:17527312:G:A	1633	955	4055	1507	2548	2	1	2
chr19:17543372:C:T	236	127	392	118	274	2.0	0.0	2.0
chr19:17617763:C:T	0	0	0	0	0	0	0	0
chr19:17626626:A:G	0	0	0	0	0	0	0	0
chr19:17630238:A:G	0	0	0	0	0	0	0	0
chr19:17632813:C:A	0	0	0	0	0	0	0	0
chr19:17726134:C:T	14	8	22	6	16	2.0	0.0	2.0
chr19:17727172:A:G	7	3	10	4	6	1	1	0
chr19:17774461:A:G	35	16	55	19	36	1	1	0
chr19:17774499:G:A	7	3	12	4	8	1	1	0
chr19:17774516:A:C	6	2	10	4	6	1.0	1.0	0.0
chr19:17776131:G:A	36	16	53	21	32	1.0	1.0	0.0
chr19:17821381:T:C	3	2	5	1	4	2	0	2
chr19:17862080:C:T	26	18	44	8	36	2.0	0.0	2.0
chr19:17936474:T:G	809	403	1372	510	862	2	1	0
chr19:18008590:G:A	1	1	2	0	2	2	0	2
chr19:18008869:C:A	2	2	4	0	4	2.0	0.0	2.0
chr19:18012929:T:C	43	14	57	29	28	1	1	0
chr19:18031141:T:C	2	2	4	0	4	2.0	0.0	2.0
chr19:18031187:C:T	2	2	4	0	4	2.0	0.0	2.0
chr19:18031872:T:C	1	1	2	0	2	2	0	2
chr19:18134702:C:T	6	4	10	2	8	2.0	0.0	2.0
chr19:18137336:T:C	9	4	13	5	8	1	1	0
chr19:18144549:G:A	17	11	29	7	22	2	0	2
chr19:18146940:C:T	17	5	23	13	10	1	1	0
chr19:18162237:T:C	7	3	10	4	6	1	1	0
chr19:18162600:A:G	5	3	8	2	6	2	0	2
chr19:18168828:T:C	8	4	13	5	8	2.0	0.5	1.0
chr19:18173841:G:T	216	98	371	155	216	2.0	1.0	0.0
chr19:18174941:G:C	2	1	3	1	2	1.5	0.5	1.0
chr19:18177259:A:G	245	113	425	169	256	2	1	0
chr19:18178000:A:G	249	115	436	172	264	2	1	0
chr19:18195014:C:T	102	53	158	52	106	2.0	1.0	2.0
chr19:18196057:C:G	89	43	133	47	86	1	1	0
chr19:18202705:C:T	1	1	2	0	2	2	0	2
chr19:18386214:G:C	0	0	0	0	0	0	0	0
chr19:18386331:T:A	0	0	0	0	0	0	0	0
chr19:18388428:G:T	1	0	1	1	0	1	1	0
chr19:18391881:A:C	5	3	8	2	6	2	0	2
chr19:18391918:C:A	5	3	8	2	6	2	0	2
chr19:18392025:G:A	5	3	8	2	6	2	0	2
chr19:18589180:T:C	405	191	648	241	407	1	1	0
chr19:18592267:T:C	1571	770	3091	1267	1824	2	1	0
chr19:18664267:C:T	10	5	15	5	10	1.5	0.5	1.0
chr19:18667635:C:G	1	0	2	2	0	2	2	0
chr19:18856921:G:A	9	3	14	6	8	1	1	0
chr19:18900435:T:C	2531	1667	6622	2128	4494	2	1	2
chr19:18905641:G:A	19	8	27	11	16	1	1	0
chr19:18911161:T:C	10	6	16	4	12	2.0	0.0	2.0
chr19:18913044:T:C	2518	1633	6487	2089	4398	2.0	1.0	2.0
chr19:18938389:G:A	130	19	168	128	40	1.0	1.0	0.0
chr19:18994322:G:A	39	17	58	22	36	1	1	0
chr19:18994450:G:A	79	35	120	46	74	1	1	0
chr19:19025732:C:T	224	102	352	134	218	1.0	1.0	0.0
chr19:19101849:G:A	128	66	202	66	136	2.0	0.5	2.0
chr19:19133224:C:T	0	0	0	0	0	0	0	0
chr19:19626877:C:T	113	57	172	56	116	2	0	2
chr19:19647381:T:C	13	3	18	12	6	1	1	0
chr19:20776313:T:G	636	363	1097	318	779	2.0	0.0	2.0
chr19:20776335:C:G	656	372	1135	333	802	2.0	0.0	2.0
chr19:20805831:G:A	55	26	82	30	52	1	1	0
chr19:21294629:T:C	415	218	706	232	474	2	1	2
chr19:21361769:G:A	385	245	691	163	528	2	0	2
chr19:21505800:C:G	328	172	549	166	383	2.0	0.0	2.0
chr19:21536599:T:C	48	19	73	33	40	1.0	1.0	0.0
chr19:23362448:A:G	483	208	753	308	445	1	1	0
chr19:23827519:C:T	163	15	186	156	30	1	1	0
chr19:29606361:C:G	349	174	574	199	375	2	1	0
chr19:29702814:G:A	232	141	388	98	290	2.0	0.0	2.0
chr19:29923665:C:G	0	0	0	0	0	0	0	0
chr19:29923680:G:T	0	0	0	0	0	0	0	0
chr19:31278095:C:T	0	0	0	0	0	0	0	0
chr19:31278857:G:A	0	0	0	0	0	0	0	0
chr19:31279103:C:T	0	0	0	0	0	0	0	0
chr19:32607726:G:C	10	5	15	5	10	1.5	0.5	1.0
chr19:32615715:C:T	19	12	31	7	24	2	0	2
chr19:32619298:T:C	9	4	13	5	8	1	1	0
chr19:32626760:T:C	16	10	28	6	22	2.0	0.0	2.0
chr19:32676973:G:A	0	0	0	0	0	0	0	0
chr19:32830541:A:G	3	1	4	2	2	1	1	0
chr19:32864163:A:G	0	0	0	0	0	0	0	0
chr19:32864175:G:A	0	0	0	0	0	0	0	0
chr19:32879164:A:G	17	7	26	10	16	1	1	0
chr19:32879178:T:A	17	7	26	10	16	1	1	0
chr19:32879255:A:C	17	7	26	10	16	1	1	0
chr19:32899890:G:A	11	6	18	6	12	2	0	2
chr19:32953801:C:T	147	71	234	82	152	2	1	0
chr19:32976451:G:A	27	14	41	13	28	2	0	2
chr19:32976670:G:A	33	18	51	15	36	2	0	2
chr19:32976714:T:C	33	18	52	16	36	2	0	2
chr19:32979968:A:G	22	6	28	16	12	1.0	1.0	0.0
chr19:32996165:G:C	14	8	22	6	16	2.0	0.0	2.0
chr19:33008072:A:G	20	7	27	13	14	1.0	1.0	0.0
chr19:33211339:A:G	0	0	0	0	0	0	0	0
chr19:33211353:A:G	0	0	0	0	0	0	0	0
chr19:33391316:G:A	596	299	972	352	620	2.0	1.0	2.0
chr19:33391349:G:A	594	339	1013	307	706	2.0	0.0	2.0
chr19:33462925:T:C	5	2	7	3	4	1	1	0
chr19:33811375:C:G	0	0	0	0	0	0	0	0
chr19:34221749:C:T	43	31	74	12	62	2	0	2
chr19:34379593:T:C	3	1	5	3	2	2	1	0
chr19:34684687:G:A	26	19	45	7	38	2.0	0.0	2.0
chr19:34684844:C:G	25	17	42	8	34	2	0	2
chr19:34943334:A:G	11	8	19	3	16	2	0	2
chr19:34943608:T:C	6	5	11	1	10	2.0	0.0	2.0
chr19:34944102:G:A	5	3	8	2	6	2	0	2
chr19:34944165:A:G	7	5	12	2	10	2	0	2
chr19:34944685:C:T	11	8	19	3	16	2	0	2
chr19:34944872:G:A	24	18	46	6	40	2.0	0.0	2.0
chr19:34957899:C:A	3	1	4	2	2	1	1	0
chr19:34958178:G:A	2	0	2	2	0	1.0	1.0	0.0
chr19:34959325:C:T	3	2	5	1	4	2	0	2
chr19:34963670:T:C	4	2	6	2	4	1.5	0.5	1.0
chr19:34996221:G:A	0	0	0	0	0	0	0	0
chr19:35015718:G:T	4	2	6	2	4	1.5	0.5	1.0
chr19:35015825:G:A	23	11	36	12	24	1	1	0
chr19:35019198:G:C	38	21	62	18	44	2.0	0.0	2.0
chr19:35033920:T:C	0	0	0	0	0	0	0	0
chr19:35039833:T:C	98	95	199	4	195	2.0	0.0	2.0
chr19:35121255:C:G	0	0	0	0	0	0	0	0
chr19:35121264:T:A	0	0	0	0	0	0	0	0
chr19:35121382:A:G	0	0	0	0	0	0	0	0
chr19:35122719:G:A	0	0	0	0	0	0	0	0
chr19:35125112:G:A	0	0	0	0	0	0	0	0
chr19:35125182:C:T	0	0	0	0	0	0	0	0
chr19:35125183:G:A	0	0	0	0	0	0	0	0
chr19:35125411:GC:AT	0	0	0	0	0	0	0	0
chr19:35125560:G:C	0	0	0	0	0	0	0	0
chr19:35126218:A:G	0	0	0	0	0	0	0	0
chr19:35126366:T:C	0	0	0	0	0	0	0	0
chr19:35126609:G:C	0	0	0	0	0	0	0	0
chr19:35126735:C:G	0	0	0	0	0	0	0	0
chr19:35133986:C:T	0	0	0	0	0	0	0	0
chr19:35166448:A:C	9	4	15	5	10	1	1	0
chr19:35169605:G:A	2625	1618	7127	2545	4582	2	1	2
chr19:35309986:G:A	0	0	0	0	0	0	0	0
chr19:35345627:G:A	64	43	110	21	89	2.0	0.0	2.0
chr19:35359024:G:A	0	0	0	0	0	0	0	0
chr19:35524750:C:T	0	0	0	0	0	0	0	0
chr19:35527026:G:C	0	0	0	0	0	0	0	0
chr19:35542558:C:T	7	2	9	5	4	1	1	0
chr19:35546623:G:A	30	15	49	15	34	1.5	0.5	1.0
chr19:35547319:T:C	19	14	34	6	28	2	0	2
chr19:35716608:G:A	279	139	531	207	324	2	1	0
chr19:35806608:G:A	0	0	0	0	0	0	0	0
chr19:35861033:G:T	1	1	2	0	2	2	0	2
chr19:36058788:C:T	3	3	6	0	6	2	0	2
chr19:36083161:C:T	0	0	0	0	0	0	0	0
chr19:36084743:G:A	1	0	1	1	0	1	1	0
chr19:36092749:G:A	0	0	0	0	0	0	0	0
chr19:36099427:T:C	0	0	0	0	0	0	0	0
chr19:36103161:C:T	0	0	0	0	0	0	0	0
chr19:36103757:A:T	3	2	5	1	4	2	0	2
chr19:36111195:C:T	0	0	0	0	0	0	0	0
chr19:36114745:T:C	169	118	328	58	270	2	0	2
chr19:36114892:C:T	597	158	903	551	352	1	1	0
chr19:36449858:G:T	42	11	53	31	22	1.0	1.0	0.0
chr19:36514036:T:C	6	1	9	7	2	1.5	1.0	0.0
chr19:36547190:T:C	8	4	12	4	8	1.5	0.5	1.0
chr19:36627537:C:T	7	3	10	4	6	1	1	0
chr19:36719627:A:G	21	7	29	15	14	1	1	0
chr19:36750239:A:G	3	2	7	1	6	2	0	2
chr19:36773115:C:T	0	0	0	0	0	0	0	0
chr19:36773288:G:A	5	0	6	6	0	1	1	0
chr19:37153149:T:C	4	2	6	2	4	1.5	0.5	1.0
chr19:37185626:G:A	14	7	21	7	14	1.5	0.5	1.0
chr19:37186846:T:A	10	6	16	4	12	2.0	0.0	2.0
chr19:37537055:A:G	9	4	13	5	8	1	1	0
chr19:37564710:A:T	23	15	42	10	32	2	0	2
chr19:37565861:C:G	29	11	40	18	22	1	1	0
chr19:37586573:G:A	18	8	26	10	16	1.0	1.0	0.0
chr19:37601031:A:T	90	41	145	57	88	1.5	1.0	0.0
chr19:37698539:T:C	1	1	2	0	2	2	0	2
chr19:37885098:T:C	0	0	0	0	0	0	0	0
chr19:37885463:A:G	0	0	0	0	0	0	0	0
chr19:37887133:G:A	0	0	0	0	0	0	0	0
chr19:37888806:C:T	0	0	0	0	0	0	0	0
chr19:37891688:C:T	0	0	0	0	0	0	0	0
chr19:38315691:G:C	3	2	5	1	4	2	0	2
chr19:38337320:T:C	62	24	89	41	48	1.0	1.0	0.0
chr19:38356791:T:C	14	9	23	5	18	2.0	0.0	2.0
chr19:38358221:C:G	6	5	11	1	10	2.0	0.0	2.0
chr19:38359606:G:A	1	0	1	1	0	1	1	0
chr19:38370693:G:A	5	2	7	3	4	1	1	0
chr19:38382138:C:T	2199	1333	4935	1697	3238	2	1	2
chr19:38466163:G:A	0	0	0	0	0	0	0	0
chr19:38466199:C:T	0	0	0	0	0	0	0	0
chr19:38469040:C:T	0	0	0	0	0	0	0	0
chr19:38570618:C:G	0	0	0	0	0	0	0	0
chr19:38816972:C:G	2	2	4	0	4	2.0	0.0	2.0
chr19:38817285:C:T	4	1	5	3	2	1.0	1.0	0.0
chr19:38831447:T:G	1629	1009	3485	1055	2430	2	1	2
chr19:38837505:A:C	5	2	7	3	4	1	1	0
chr19:38847485:G:A	11	4	15	7	8	1	1	0
chr19:38847502:A:G	11	4	15	7	8	1	1	0
chr19:38869957:C:T	267	143	442	134	308	2	0	2
chr19:38876471:T:C	107	51	163	59	104	1	1	0
chr19:38907776:A:G	100	49	150	52	98	1.5	1.0	0.0
chr19:38911815:C:G	1	1	2	0	2	2	0	2
chr19:38915527:C:G	51	24	78	28	50	1	1	0
chr19:38926247:C:T	49	24	77	27	50	2	1	0
chr19:39025299:T:C	20	15	35	5	30	2.0	0.0	2.0
chr19:39100315:G:A	0	0	0	0	0	0	0	0
chr19:39176653:C:T	3	2	4	1	3	1	0	1
chr19:39244094:T:C	0	0	0	0	0	0	0	0
chr19:39269551:A:G	0	0	0	0	0	0	0	0
chr19:39397809:C:T	18	11	31	7	24	2.0	0.0	2.0
chr19:39417934:C:T	8	4	12	4	8	1.5	0.5	1.0
chr19:39424108:G:A	7	4	11	3	8	2	0	2
chr19:39424997:G:A	33	17	52	16	36	2	0	2
chr19:39425118:C:G	42	21	65	21	44	1.5	0.5	1.0
chr19:39433312:G:A	4394	4287	86773	29262	57511	18.0	6.0	12.0
chr19:39433489:T:C	33	17	51	17	34	2	0	2
chr19:39445862:G:A	893	448	1565	577	988	2	1	2
chr19:39453442:C:T	341	169	547	191	356	2	1	0
chr19:39485824:C:G	4	4	8	0	8	2.0	0.0	2.0
chr19:39504071:T:C	0	0	0	0	0	0	0	0
chr19:39505387:C:T	0	0	0	0	0	0	0	0
chr19:39532668:A:G	149	88	242	65	177	2	0	2
chr19:39705971:C:T	0	0	0	0	0	0	0	0
chr19:39707284:T:C	0	0	0	0	0	0	0	0
chr19:39709274:C:G	0	0	0	0	0	0	0	0
chr19:39734329:C:T	0	0	0	0	0	0	0	0
chr19:39734346:A:G	0	0	0	0	0	0	0	0
chr19:39784545:G:A	0	0	0	0	0	0	0	0
chr19:39863427:T:C	45	37	94	12	82	2	0	2
chr19:39867043:T:G	16	15	34	2	32	2.0	0.0	2.0
chr19:39873276:C:T	0	0	0	0	0	0	0	0
chr19:39875600:G:A	1	0	1	1	0	1	1	0
chr19:39886277:GGTGGGC:AGGGGTG	1	0	1	1	0	1	1	0
chr19:39894010:G:A	0	0	0	0	0	0	0	0
chr19:39894014:C:T	0	0	0	0	0	0	0	0
chr19:39899634:CGA:TGC	0	0	0	0	0	0	0	0
chr19:39927135:G:A	0	0	0	0	0	0	0	0
chr19:39943284:T:C	20	17	38	3	35	2.0	0.0	2.0
chr19:39974594:C:T	825	485	1552	464	1088	2	1	2
chr19:39980229:G:A	23	10	33	13	20	1	1	0
chr19:39980558:C:G	28	12	40	16	24	1.0	1.0	0.0
chr19:40013998:G:C	30	14	45	17	28	1.5	1.0	0.0
chr19:40035132:C:T	8	4	12	4	8	1.5	0.5	1.0
chr19:40213503:C:T	3	2	5	1	4	2	0	2
chr19:40233814:G:T	45	23	72	22	50	2	0	2
chr19:40236413:T:C	1	1	2	0	2	2	0	2
chr19:40369893:C:G	1	1	2	0	2	2	0	2
chr19:40369903:C:G	1	1	2	0	2	2	0	2
chr19:40395104:G:C	0	0	0	0	0	0	0	0
chr19:40398695:G:A	0	0	0	0	0	0	0	0
chr19:40441541:A:G	279	125	450	172	278	1	1	0
chr19:40441844:G:A	269	121	428	168	260	1	1	0
chr19:40458488:C:T	309	164	515	167	348	2	1	2
chr19:40502142:A:G	0	0	0	0	0	0	0	0
chr19:40506283:C:T	0	0	0	0	0	0	0	0
chr19:40532667:G:A	0	0	0	0	0	0	0	0
chr19:40576962:T:C	211	107	328	112	216	2	1	2
chr19:40577538:C:T	12	6	20	6	14	1.5	0.5	1.0
chr19:40590283:A:G	264	129	411	151	260	2.0	1.0	0.0
chr19:40605163:G:A	1	1	2	0	2	2	0	2
chr19:40610491:G:A	1	0	1	1	0	1	1	0
chr19:40611963:A:G	3	1	4	2	2	1	1	0
chr19:40612150:A:G	5	1	8	4	4	1	1	0
chr19:40622404:C:T	27	13	44	16	28	2	1	0
chr19:40623937:C:T	34	17	52	18	34	2.0	0.5	1.0
chr19:40705151:T:C	49	24	74	26	48	2	1	0
chr19:40714623:TC:TT	113	0	116	116	0	1	1	0
chr19:40800457:G:A	182	90	276	94	182	1.0	1.0	0.0
chr19:40806707:G:C	2	2	4	0	4	2.0	0.0	2.0
chr19:40807297:C:A	3	2	5	1	4	2	0	2
chr19:40822291:C:T	0	0	0	0	0	0	0	0
chr19:40875866:T:A	0	0	0	0	0	0	0	0
chr19:41116284:G:A	0	0	0	0	0	0	0	0
chr19:41121963:G:A	0	0	0	0	0	0	0	0
chr19:41128168:CT:TC	0	0	0	0	0	0	0	0
chr19:41352971:C:G	372	199	626	205	421	2.0	1.0	2.0
chr19:41363487:T:C	169	83	270	92	178	2	1	0
chr19:41433432:G:A	149	86	242	68	174	2	0	2
chr19:41577321:T:C	62	20	82	42	40	1.0	1.0	0.0
chr19:41579520:G:A	61	16	77	45	32	1	1	0
chr19:41625899:C:T	0	0	0	0	0	0	0	0
chr19:41686928:T:A	0	0	0	0	0	0	0	0
chr19:41838245:G:A	0	0	0	0	0	0	0	0
chr19:41850561:C:T	0	0	0	0	0	0	0	0
chr19:41959295:C:T	2714	1963	7903	2107	5796	2.0	1.0	2.0
chr19:41966898:G:C	46	25	71	21	50	2.0	0.0	2.0
chr19:42287928:C:T	3	2	5	1	4	2	0	2
chr19:42294897:C:T	62	32	104	32	72	2.0	0.5	2.0
chr19:42336299:C:T	0	0	0	0	0	0	0	0
chr19:42729245:A:T	0	0	0	0	0	0	0	0
chr19:42739065:AA:GG	0	0	0	0	0	0	0	0
chr19:42845142:A:G	0	0	0	0	0	0	0	0
chr19:42845161:T:C	0	0	0	0	0	0	0	0
chr19:42867005:C:G	0	0	0	0	0	0	0	0
chr19:42868926:C:G	0	0	0	0	0	0	0	0
chr19:42878216:T:G	0	0	0	0	0	0	0	0
chr19:42878222:C:G	0	0	0	0	0	0	0	0
chr19:42916112:C:T	0	0	0	0	0	0	0	0
chr19:42916299:G:C	0	0	0	0	0	0	0	0
chr19:42929369:C:T	0	0	0	0	0	0	0	0
chr19:42929418:A:C	0	0	0	0	0	0	0	0
chr19:42929653:A:G	0	0	0	0	0	0	0	0
chr19:42935542:G:A	0	0	0	0	0	0	0	0
chr19:42935587:T:C	0	0	0	0	0	0	0	0
chr19:43015210:C:T	0	0	0	0	0	0	0	0
chr19:43018759:A:C	0	0	0	0	0	0	0	0
chr19:43024874:CA:TG	0	0	0	0	0	0	0	0
chr19:43071753:C:T	0	0	0	0	0	0	0	0
chr19:43072483:C:T	0	0	0	0	0	0	0	0
chr19:43072536:C:T	0	0	0	0	0	0	0	0
chr19:43075527:T:A	0	0	0	0	0	0	0	0
chr19:43080959:C:G	0	0	0	0	0	0	0	0
chr19:43081173:G:A	0	0	0	0	0	0	0	0
chr19:43082512:C:G	0	0	0	0	0	0	0	0
chr19:43175258:A:G	0	0	0	0	0	0	0	0
chr19:43175885:T:A	0	0	0	0	0	0	0	0
chr19:43175899:C:T	0	0	0	0	0	0	0	0
chr19:43176117:G:C	0	0	0	0	0	0	0	0
chr19:43186354:G:C	0	0	0	0	0	0	0	0
chr19:43194607:G:A	0	0	0	0	0	0	0	0
chr19:43195184:T:C	0	0	0	0	0	0	0	0
chr19:43204093:G:C	0	0	0	0	0	0	0	0
chr19:43258907:C:T	0	0	0	0	0	0	0	0
chr19:43360396:C:A	0	0	0	0	0	0	0	0
chr19:43463540:T:C	0	0	0	0	0	0	0	0
chr19:43475437:G:T	45	22	71	23	48	1	1	0
chr19:43494810:C:T	15	7	22	8	14	1	1	0
chr19:43497193:C:T	31	13	45	19	26	1	1	0
chr19:43527172:C:T	319	165	604	208	396	2	1	2
chr19:43543398:T:C	140	64	218	86	132	2.0	1.0	0.0
chr19:43553075:T:C	119	65	199	60	139	2	0	2
chr19:43578793:T:C	1	0	1	1	0	1	1	0
chr19:43648948:A:G	1	0	1	1	0	1	1	0
chr19:43769364:T:C	14	6	20	8	12	1.0	1.0	0.0
chr19:43798472:T:C	0	0	0	0	0	0	0	0
chr19:43798914:C:G	1	0	1	1	0	1	1	0
chr19:43802330:C:T	0	0	0	0	0	0	0	0
chr19:43802424:G:T	0	0	0	0	0	0	0	0
chr19:43848536:G:A	1	0	1	1	0	1	1	0
chr19:43872529:G:T	12	9	23	3	20	2.0	0.0	2.0
chr19:43873517:G:A	4	3	7	1	6	2.0	0.0	2.0
chr19:43913423:A:G	19	5	24	14	10	1	1	0
chr19:43913925:C:T	8	2	10	6	4	1.0	1.0	0.0
chr19:43914191:C:T	9	2	11	7	4	1	1	0
chr19:43914392:A:G	5	2	7	3	4	1	1	0
chr19:43914528:G:C	4	2	6	2	4	1.5	0.5	1.0
chr19:43914541:T:C	4	2	6	2	4	1.5	0.5	1.0
chr19:43997475:T:C	4	1	5	3	2	1.0	1.0	0.0
chr19:44060828:G:A	22	14	38	8	30	2.0	0.0	2.0
chr19:44066398:G:A	15	10	25	5	20	2	0	2
chr19:44086405:C:T	6	4	10	2	8	2.0	0.0	2.0
chr19:44087207:G:A	0	0	0	0	0	0	0	0
chr19:44106512:A:G	22	14	36	8	28	2.0	0.0	2.0
chr19:44106645:A:T	21	13	36	8	28	2	0	2
chr19:44106689:AC:GT	21	13	36	8	28	2	0	2
chr19:44106913:T:C	22	13	39	9	30	2.0	0.0	2.0
chr19:44107267:A:G	11	5	16	6	10	1	1	0
chr19:44107852:A:G	24	11	36	13	23	1.0	1.0	0.0
chr19:44107861:A:T	25	11	38	14	24	1	1	0
chr19:44108078:A:G	25	12	39	13	26	1	1	0
chr19:44148801:G:A	100	53	157	49	108	2.0	0.0	2.0
chr19:44156814:A:G	18	10	29	9	20	2.0	0.5	2.0
chr19:44157768:C:T	17	6	23	11	12	1	1	0
chr19:44235246:T:C	23	11	34	12	22	1	1	0
chr19:44274252:A:C	16	7	26	10	16	1.5	1.0	0.0
chr19:44288548:T:G	7	4	11	3	8	2	0	2
chr19:44613853:C:T	0	0	0	0	0	0	0	0
chr19:44658921:C:A	0	0	0	0	0	0	0	0
chr19:44672756:C:T	0	0	0	0	0	0	0	0
chr19:44703425:G:A	0	0	0	0	0	0	0	0
chr19:44819487:A:G	0	0	0	0	0	0	0	0
chr19:44892457:T:C	372	185	582	200	382	2.0	1.0	0.0
chr19:44949078:T:C	0	0	0	0	0	0	0	0
chr19:44987312:A:G	96	43	144	56	88	1.0	1.0	0.0
chr19:44987378:T:C	97	55	157	45	112	2	0	2
chr19:44990377:C:G	3	2	5	1	4	2	0	2
chr19:45306777:A:G	0	0	0	0	0	0	0	0
chr19:45315577:A:G	1	1	2	0	2	2	0	2
chr19:45553823:A:G	86	41	132	48	84	2.0	1.0	0.0
chr19:45591339:G:A	0	0	0	0	0	0	0	0
chr19:45678134:G:C	3	1	4	2	2	1	1	0
chr19:45681959:C:A	0	0	0	0	0	0	0	0
chr19:45713384:G:T	26	15	41	11	30	2.0	0.0	2.0
chr19:45823795:C:T	43	19	62	24	38	1	1	0
chr19:45823927:G:C	4	1	5	3	2	1.0	1.0	0.0
chr19:45828936:C:T	7	3	10	4	6	1	1	0
chr19:45838566:C:T	35	15	52	20	32	1	1	0
chr19:45848864:A:G	30	13	43	17	26	1.0	1.0	0.0
chr19:45854553:C:A	13	7	20	6	14	2	0	2
chr19:45872521:C:T	0	0	0	0	0	0	0	0
chr19:46023040:T:G	0	0	0	0	0	0	0	0
chr19:46040308:C:T	0	0	0	0	0	0	0	0
chr19:46230152:G:A	0	0	0	0	0	0	0	0
chr19:46308727:A:G	0	0	0	0	0	0	0	0
chr19:46312242:T:C	0	0	0	0	0	0	0	0
chr19:46320445:A:G	0	0	0	0	0	0	0	0
chr19:46320494:C:T	0	0	0	0	0	0	0	0
chr19:46412445:C:T	0	0	0	0	0	0	0	0
chr19:46471049:A:C	0	0	0	0	0	0	0	0
chr19:46471050:C:T	0	0	0	0	0	0	0	0
chr19:46471067:A:G	0	0	0	0	0	0	0	0
chr19:46605894:G:C	2	1	3	1	2	1.5	0.5	1.0
chr19:46621457:T:G	2	1	3	1	2	1.5	0.5	1.0
chr19:46621700:G:A	0	0	0	0	0	0	0	0
chr19:46624067:C:G	1	1	2	0	2	2	0	2
chr19:46624118:G:A	1	1	2	0	2	2	0	2
chr19:46634202:C:T	7	1	10	8	2	1	1	0
chr19:46648467:A:G	0	0	0	0	0	0	0	0
chr19:46710950:C:T	31	14	47	17	30	1	1	0
chr19:46720692:G:A	15	9	26	6	20	2	0	2
chr19:46755417:C:T	18	8	26	10	16	1.0	1.0	0.0
chr19:46755585:C:T	11	7	18	4	14	2	0	2
chr19:46775602:C:G	27	15	44	12	32	2	0	2
chr19:46784682:T:C	1	1	2	0	2	2	0	2
chr19:47475482:C:T	56	31	88	26	62	2.0	0.0	2.0
chr19:47740937:A:G	0	0	0	0	0	0	0	0
chr19:47741144:G:A	0	0	0	0	0	0	0	0
chr19:47741312:G:A	0	0	0	0	0	0	0	0
chr19:47751135:T:C	29	14	43	15	28	1	1	0
chr19:47751450:T:C	32	16	48	17	31	1.5	1.0	0.5
chr19:47752547:A:G	3907	3082	18656	6698	11958	4	1	2
chr19:48014281:G:A	0	0	0	0	0	0	0	0
chr19:48030484:T:G	0	0	0	0	0	0	0	0
chr19:48034328:A:G	0	0	0	0	0	0	0	0
chr19:48040666:C:A	0	0	0	0	0	0	0	0
chr19:48048289:A:T	3	1	4	2	2	1	1	0
chr19:48095566:A:G	7	5	12	2	10	2	0	2
chr19:48137550:C:T	6	1	7	5	2	1.0	1.0	0.0
chr19:48194704:C:T	27	14	43	13	30	2	0	2
chr19:48204144:G:T	6	1	11	5	6	1.0	1.0	0.0
chr19:48211896:T:C	39	21	61	19	42	2	0	2
chr19:48218923:C:T	59	28	88	31	57	1	1	0
chr19:48234449:A:T	116	53	176	68	108	1.0	1.0	0.0
chr19:48234507:A:G	117	64	191	55	136	2	0	2
chr19:48297076:G:A	1	1	2	0	2	2	0	2
chr19:48297081:A:G	1	0	1	1	0	1	1	0
chr19:48297657:G:A	1	0	1	1	0	1	1	0
chr19:48302837:C:T	0	0	0	0	0	0	0	0
chr19:48329297:A:G	93	59	161	37	124	2	0	2
chr19:48333416:G:T	11	5	16	6	10	1	1	0
chr19:48390418:C:T	7	3	10	4	6	1	1	0
chr19:48592808:C:T	0	0	0	0	0	0	0	0
chr19:48599142:C:T	0	0	0	0	0	0	0	0
chr19:48601051:C:T	0	0	0	0	0	0	0	0
chr19:48613298:A:G	0	0	0	0	0	0	0	0
chr19:48663618:G:A	1	0	1	1	0	1	1	0
chr19:48680448:G:A	8	5	13	3	10	2.0	0.0	2.0
chr19:48703160:A:G	3	1	4	2	2	1	1	0
chr19:48703205:C:T	3	1	4	2	2	1	1	0
chr19:48703346:C:T	2	1	3	1	2	1.5	0.5	1.0
chr19:48703417:G:A	2	1	3	1	2	1.5	0.5	1.0
chr19:48703728:G:A	2	1	3	1	2	1.5	0.5	1.0
chr19:48703949:A:G	2	1	3	1	2	1.5	0.5	1.0
chr19:48703998:ATT:GTC	2	1	3	1	2	1.5	0.5	1.0
chr19:48725015:T:C	0	0	0	0	0	0	0	0
chr19:48740962:CG:AA	0	0	0	0	0	0	0	0
chr19:48750132:C:T	0	0	0	0	0	0	0	0
chr19:48756272:A:G	0	0	0	0	0	0	0	0
chr19:48758010:C:T	0	0	0	0	0	0	0	0
chr19:48797348:T:C	2	0	2	2	0	1.0	1.0	0.0
chr19:48867562:G:T	0	0	0	0	0	0	0	0
chr19:48873325:G:A	1739	1036	4119	1427	2692	2	1	2
chr19:48873829:T:C	1539	848	3409	1284	2125	2	1	2
chr19:48874062:A:G	774	408	1370	474	896	2.0	1.0	2.0
chr19:48874179:G:C	766	400	1360	476	884	2.0	1.0	2.0
chr19:49036303:T:C	0	0	0	0	0	0	0	0
chr19:49054315:T:C	0	0	0	0	0	0	0	0
chr19:49069988:C:G	0	0	0	0	0	0	0	0
chr19:49335634:C:A	500	180	767	375	392	1.0	1.0	0.0
chr19:49335758:T:C	4144	3591	34248	12022	22226	7.0	2.0	4.0
chr19:49337797:G:T	19	8	29	11	18	1	1	0
chr19:49364656:G:A	10	3	13	7	6	1.0	1.0	0.0
chr19:49390895:C:T	0	0	0	0	0	0	0	0
chr19:49398061:T:C	0	0	0	0	0	0	0	0
chr19:49417548:A:G	1	1	2	0	2	2	0	2
chr19:49446395:G:A	623	327	1101	380	721	2	1	2
chr19:49447041:C:T	604	314	1056	362	694	2.0	1.0	2.0
chr19:49447099:C:G	602	308	1044	369	675	2.0	1.0	2.0
chr19:49447156:C:G	7	4	11	3	8	2	0	2
chr19:49451546:CCCAT:TCCAG	789	416	1413	491	922	2	1	2
chr19:49451759:G:T	770	398	1357	482	875	2.0	1.0	2.0
chr19:49461720:C:G	18	9	27	9	18	1.5	0.5	1.0
chr19:49464724:T:G	51	24	75	27	48	1	1	0
chr19:49465828:C:T	69	32	103	37	66	1	1	0
chr19:49496390:C:G	194	122	352	82	270	2.0	0.0	2.0
chr19:49514467:C:T	1634	898	3253	1182	2071	2.0	1.0	2.0
chr19:49524783:T:C	26	12	39	15	24	1.5	1.0	0.0
chr19:49542621:C:T	32	14	50	20	30	1.0	1.0	0.0
chr19:49542659:T:C	33	15	52	20	32	1	1	0
chr19:49543108:T:C	35	18	56	18	38	2	0	2
chr19:49543180:C:T	35	18	56	18	38	2	0	2
chr19:49543216:A:C	35	18	55	18	37	2	0	1
chr19:49556725:C:G	2525	1992	8161	1452	6709	2	0	2
chr19:49583369:T:C	0	0	0	0	0	0	0	0
chr19:49588541:G:T	6	3	9	3	6	1.5	0.5	1.0
chr19:49594527:T:C	17	8	26	10	16	2	1	0
chr19:49596165:C:T	5	4	9	1	8	2	0	2
chr19:49597009:C:G	9	6	15	3	12	2	0	2
chr19:49597038:A:G	10	4	14	6	8	1.0	1.0	0.0
chr19:49659652:C:G	900	550	1680	455	1225	2.0	0.0	2.0
chr19:49802941:G:T	0	0	0	0	0	0	0	0
chr19:49805636:T:C	3	3	6	0	6	2	0	2
chr19:49809396:C:T	180	80	279	105	174	1.0	1.0	0.0
chr19:49812516:T:A	7	4	11	3	8	2	0	2
chr19:49854876:T:G	80	35	120	50	70	1.0	1.0	0.0
chr19:49854913:T:C	0	0	0	0	0	0	0	0
chr19:49854926:C:A	0	0	0	0	0	0	0	0
chr19:49859918:A:G	40	15	59	25	34	1.0	1.0	0.0
chr19:49901682:T:G	1	0	1	1	0	1	1	0
chr19:49950060:C:T	0	0	0	0	0	0	0	0
chr19:49971857:G:C	0	0	0	0	0	0	0	0
chr19:49971917:A:C	0	0	0	0	0	0	0	0
chr19:49971951:CGGTGGGG:TGGGGGGA	0	0	0	0	0	0	0	0
chr19:49972002:G:C	0	0	0	0	0	0	0	0
chr19:49978975:C:T	6	4	10	2	8	2.0	0.0	2.0
chr19:50015974:T:C	14	9	23	5	18	2.0	0.0	2.0
chr19:50015992:C:T	14	9	23	5	18	2.0	0.0	2.0
chr19:50163132:G:A	0	0	0	0	0	0	0	0
chr19:50259161:A:G	0	0	0	0	0	0	0	0
chr19:50268352:G:A	0	0	0	0	0	0	0	0
chr19:50293648:G:A	0	0	0	0	0	0	0	0
chr19:50308964:A:G	0	0	0	0	0	0	0	0
chr19:50378912:A:G	15	6	22	10	12	1	1	0
chr19:50406508:C:T	2	0	2	2	0	1.0	1.0	0.0
chr19:50416540:C:T	9	4	13	5	8	1	1	0
chr19:50462015:T:C	1	0	1	1	0	1	1	0
chr19:50480673:C:T	274	120	414	162	252	1.0	1.0	0.0
chr19:50512147:T:C	3	1	4	2	2	1	1	0
chr19:50512317:G:C	3	1	4	2	2	1	1	0
chr19:50514578:G:A	2	0	2	2	0	1.0	1.0	0.0
chr19:50630099:C:G	0	0	0	0	0	0	0	0
chr19:50820217:C:G	467	284	896	232	664	2	0	2
chr19:50820245:A:G	468	286	900	232	668	2.0	0.0	2.0
chr19:50858681:G:A	0	0	0	0	0	0	0	0
chr19:50860192:A:G	0	0	0	0	0	0	0	0
chr19:50876637:C:T	171	93	281	87	194	2	0	2
chr19:50876854:T:A	37	22	60	16	44	2	0	2
chr19:50906915:G:A	4	2	6	2	4	1.5	0.5	1.0
chr19:50909410:C:A	1	1	2	0	2	2	0	2
chr19:51014707:C:A	0	0	0	0	0	0	0	0
chr19:51014792:C:T	0	0	0	0	0	0	0	0
chr19:51016090:G:C	0	0	0	0	0	0	0	0
chr19:51056659:G:A	0	0	0	0	0	0	0	0
chr19:51125272:A:G	0	0	0	0	0	0	0	0
chr19:51127225:C:A	0	0	0	0	0	0	0	0
chr19:51225385:A:G	1	1	3	0	3	3	0	3
chr19:51338163:C:T	4	4	8	0	8	2.0	0.0	2.0
chr19:51340554:C:T	1	1	2	0	2	2	0	2
chr19:51341724:G:T	1	1	2	0	2	2	0	2
chr19:51342117:T:G	0	0	0	0	0	0	0	0
chr19:51347036:G:A	1840	1133	4249	1449	2800	2.0	1.0	2.0
chr19:51414481:G:A	55	27	82	28	54	1	1	0
chr19:51415106:A:G	21	12	32	9	23	2	0	2
chr19:51415886:G:A	1	1	2	0	2	2	0	2
chr19:51416253:T:C	2	1	3	1	2	1.5	0.5	1.0
chr19:51416744:T:C	43	21	64	22	42	1	1	0
chr19:51416986:G:T	3	3	8	0	8	2	0	2
chr19:51417359:C:T	41	20	62	22	40	2	1	0
chr19:51498231:G:A	0	0	0	0	0	0	0	0
chr19:51586761:C:T	4	2	6	2	4	1.5	0.5	1.0
chr19:51612392:G:C	14	14	28	0	28	2.0	0.0	2.0
chr19:51627535:G:A	14	0	14	14	0	1.0	1.0	0.0
chr19:51627672:G:A	13	0	13	13	0	1	1	0
chr19:51645551:A:C	0	0	0	0	0	0	0	0
chr19:51746419:A:C	0	0	0	0	0	0	0	0
chr19:51746963:A:G	0	0	0	0	0	0	0	0
chr19:51873254:T:C	8	4	12	4	8	1.5	0.5	1.0
chr19:51873699:T:A	15	11	26	4	22	2	0	2
chr19:51877428:T:A	3	2	5	1	4	2	0	2
chr19:51964950:T:A	26	13	41	13	28	1.5	0.5	1.0
chr19:51965334:G:T	16	8	26	8	18	1.5	0.5	1.0
chr19:51965745:A:G	30	16	48	14	34	2.0	0.0	2.0
chr19:51968516:C:T	6	2	8	4	4	1.0	1.0	0.0
chr19:51968532:T:A	6	2	8	4	4	1.0	1.0	0.0
chr19:51968560:T:C	6	2	8	4	4	1.0	1.0	0.0
chr19:51968619:A:G	296	142	479	175	304	2.0	1.0	0.0
chr19:51969042:A:G	281	144	464	157	307	2	1	2
chr19:51993997:G:A	7	5	12	2	10	2	0	2
chr19:52016355:C:T	14	5	19	9	10	1.0	1.0	0.0
chr19:52017354:C:T	76	37	120	40	80	1.0	1.0	0.0
chr19:52034323:T:G	10	7	17	3	14	2.0	0.0	2.0
chr19:52366799:C:G	2	2	4	0	4	2.0	0.0	2.0
chr19:52384174:A:C	164	162	334	2	332	2.0	0.0	2.0
chr19:52384184:A:C	164	162	336	2	334	2.0	0.0	2.0
chr19:52384651:T:C	154	152	316	2	314	2.0	0.0	2.0
chr19:52384957:T:C	20	19	41	1	40	2.0	0.0	2.0
chr19:52384992:A:G	20	19	40	2	38	2.0	0.0	2.0
chr19:52385367:T:G	12	12	26	0	26	2.0	0.0	2.0
chr19:52512131:A:G	0	0	0	0	0	0	0	0
chr19:52574158:T:C	163	80	260	92	168	2	1	0
chr19:52582406:C:T	76	39	117	39	78	2.0	0.5	2.0
chr19:52582871:C:A	30	17	47	13	34	2.0	0.0	2.0
chr19:52614278:C:T	56	19	76	38	38	1.0	1.0	0.0
chr19:52614556:C:A	104	36	147	71	76	1.0	1.0	0.0
chr19:52841666:T:G	37	19	58	18	40	2	0	2
chr19:52907120:A:G	1	1	2	0	2	2	0	2
chr19:52907913:A:C	18	11	31	7	24	2.0	0.0	2.0
chr19:53068053:T:C	20	11	31	9	22	2.0	0.0	2.0
chr19:53069241:G:T	14	9	23	5	18	2.0	0.0	2.0
chr19:53109058:T:C	7	0	7	7	0	1	1	0
chr19:53129643:G:A	6	3	9	3	6	1.5	0.5	1.0
chr19:53164551:C:T	7	5	13	3	10	2	0	2
chr19:53164660:A:G	6	3	9	3	6	1.5	0.5	1.0
chr19:53166239:A:G	30	22	54	8	46	2.0	0.0	2.0
chr19:53224391:T:C	0	0	0	0	0	0	0	0
chr19:53237815:C:T	0	0	0	0	0	0	0	0
chr19:53267511:G:A	0	0	0	0	0	0	0	0
chr19:53315220:C:T	0	0	0	0	0	0	0	0
chr19:53351144:G:C	35	15	51	21	30	1	1	0
chr19:53381159:G:A	19	10	29	9	20	2	0	2
chr19:53490807:A:G	19	9	28	10	18	1	1	0
chr19:53491548:A:T	5	3	8	2	6	2	0	2
chr19:54058538:G:A	1	0	2	2	0	2	2	0
chr19:54095957:G:T	0	0	0	0	0	0	0	0
chr19:54103097:T:C	9	5	14	4	10	2	0	2
chr19:54106863:C:T	1698	979	3494	1160	2334	2.0	1.0	2.0
chr19:54122676:G:C	4	2	6	2	4	1.5	0.5	1.0
chr19:54148468:C:T	23	11	36	12	24	1	1	0
chr19:54207582:C:G	4398	4295	113990	45923	68067	24.0	9.0	14.0
chr19:54257144:C:G	0	0	0	0	0	0	0	0
chr19:54307623:C:A	0	0	0	0	0	0	0	0
chr19:54337413:A:G	228	73	404	240	164	1.0	1.0	0.0
chr19:54338192:C:T	176	54	297	175	122	1.0	1.0	0.0
chr19:54338671:A:G	182	54	300	178	122	1.0	1.0	0.0
chr19:54458618:C:G	50	25	79	28	51	2.0	0.5	0.5
chr19:54575308:T:C	1	1	2	0	2	2	0	2
chr19:54664289:T:C	115	74	226	60	166	2	0	2
chr19:54666711:A:G	189	84	360	142	218	2	1	0
chr19:54667913:G:A	226	94	428	182	246	2.0	1.0	0.0
chr19:54726231:C:T	0	0	0	0	0	0	0	0
chr19:54769863:G:T	0	0	0	0	0	0	0	0
chr19:54804874:A:G	0	0	0	0	0	0	0	0
chr19:54814000:G:A	0	0	0	0	0	0	0	0
chr19:54818581:G:A	0	0	0	0	0	0	0	0
chr19:54819832:G:T	0	0	0	0	0	0	0	0
chr19:54819907:C:T	0	0	0	0	0	0	0	0
chr19:54819917:T:G	0	0	0	0	0	0	0	0
chr19:54821568:C:T	0	0	0	0	0	0	0	0
chr19:54832784:T:G	1	0	1	1	0	1	1	0
chr19:54852249:G:A	0	0	0	0	0	0	0	0
chr19:54853865:G:T	0	0	0	0	0	0	0	0
chr19:54885501:G:A	0	0	0	0	0	0	0	0
chr19:54906373:A:G	7	7	14	0	14	2	0	2
chr19:54906696:C:A	65	65	136	0	136	2	0	2
chr19:54909442:A:C	61	61	130	0	130	2	0	2
chr19:55076454:G:A	0	0	0	0	0	0	0	0
chr19:55082049:C:T	0	0	0	0	0	0	0	0
chr19:55083628:C:G	1	0	1	1	0	1	1	0
chr19:55112438:C:T	0	0	0	0	0	0	0	0
chr19:55198706:G:A	0	0	0	0	0	0	0	0
chr19:55202167:G:A	0	0	0	0	0	0	0	0
chr19:55203974:C:T	0	0	0	0	0	0	0	0
chr19:55205432:A:G	0	0	0	0	0	0	0	0
chr19:55227378:G:A	14	6	20	8	12	1.0	1.0	0.0
chr19:55228237:C:T	3	1	4	2	2	1	1	0
chr19:55228321:G:A	3	2	5	1	4	2	0	2
chr19:55228445:G:A	2	1	3	1	2	1.5	0.5	1.0
chr19:55245612:A:G	17	13	30	4	26	2	0	2
chr19:55279723:C:T	4	2	6	2	4	1.5	0.5	1.0
chr19:55360823:G:A	0	0	0	0	0	0	0	0
chr19:55362274:C:T	0	0	0	0	0	0	0	0
chr19:55368504:C:T	0	0	0	0	0	0	0	0
chr19:55377617:G:A	0	0	0	0	0	0	0	0
chr19:55388234:C:T	389	170	599	237	362	1	1	0
chr19:55391573:G:A	103	42	159	65	94	1	1	0
chr19:55401578:T:G	1244	700	2432	818	1614	2.0	1.0	2.0
chr19:55455604:C:T	3	2	5	1	4	2	0	2
chr19:55482873:C:T	1	1	2	0	2	2	0	2
chr19:55483905:G:A	41	24	67	18	49	2	0	2
chr19:55518264:C:T	0	0	0	0	0	0	0	0
chr19:55518642:C:T	0	0	0	0	0	0	0	0
chr19:55541034:G:T	0	0	0	0	0	0	0	0
chr19:55577987:C:T	82	48	132	34	98	2.0	0.0	2.0
chr19:55578710:G:T	56	33	89	23	66	2.0	0.0	2.0
chr19:55738306:A:G	0	0	0	0	0	0	0	0
chr19:55796217:A:G	0	0	0	0	0	0	0	0
chr19:55857948:G:A	2	1	3	1	2	1.5	0.5	1.0
chr19:55861524:C:T	0	0	0	0	0	0	0	0
chr19:55878871:A:T	0	0	0	0	0	0	0	0
chr19:55881509:T:G	0	0	0	0	0	0	0	0
chr19:55898856:C:T	0	0	0	0	0	0	0	0
chr19:55962094:T:C	0	0	0	0	0	0	0	0
chr19:55966321:A:G	0	0	0	0	0	0	0	0
chr19:55973711:A:G	0	0	0	0	0	0	0	0
chr19:55976237:A:G	0	0	0	0	0	0	0	0
chr19:55987913:G:C	0	0	0	0	0	0	0	0
chr19:55987979:A:G	0	0	0	0	0	0	0	0
chr19:56027918:G:A	0	0	0	0	0	0	0	0
chr19:56038144:T:C	0	0	0	0	0	0	0	0
chr19:56061466:G:A	0	0	0	0	0	0	0	0
chr19:56103283:G:A	3	2	4	1	3	1	0	1
chr19:56182251:C:G	0	0	0	0	0	0	0	0
chr19:56183136:C:T	0	0	0	0	0	0	0	0
chr19:56244167:C:T	1	0	1	1	0	1	1	0
chr19:56244191:T:A	1	1	2	0	2	2	0	2
chr19:56244401:G:A	1	0	1	1	0	1	1	0
chr19:56246783:C:G	0	0	0	0	0	0	0	0
chr19:56272792:C:A	2	1	3	1	2	1.5	0.5	1.0
chr19:56424158:A:G	8	4	14	4	10	1.5	0.5	1.0
chr19:56442594:G:A	41	17	61	25	36	1	1	0
chr19:56525284:G:A	7	3	10	4	6	1	1	0
chr19:56525309:G:A	7	3	10	4	6	1	1	0
chr19:56525699:G:A	3	2	5	1	4	2	0	2
chr19:56547629:C:G	55	31	89	25	64	2	0	2
chr19:56621600:G:A	23	11	34	12	22	1	1	0
chr19:56664116:A:G	0	0	0	0	0	0	0	0
chr19:56664830:T:G	0	0	0	0	0	0	0	0
chr19:56664936:T:G	0	0	0	0	0	0	0	0
chr19:56665114:C:T	1	0	1	1	0	1	1	0
chr19:56813715:C:T	0	0	0	0	0	0	0	0
chr19:56823654:G:A	0	0	0	0	0	0	0	0
chr19:57138532:C:T	0	0	0	0	0	0	0	0
chr19:57329179:A:G	21	11	32	10	22	2	0	2
chr19:57351781:T:G	35	16	52	20	32	1	1	0
chr19:57390054:G:T	161	72	236	92	144	1	1	0
chr19:57419935:C:A	33	20	53	13	40	2	0	2
chr19:57420659:C:T	19	8	27	11	16	1	1	0
chr19:57443876:A:G	6	4	10	2	8	2.0	0.0	2.0
chr19:57445460:T:G	7	5	12	2	10	2	0	2
chr19:57455681:G:T	96	69	173	27	146	2.0	0.0	2.0
chr19:57455765:G:A	9	5	16	4	12	2	0	2
chr19:57473550:A:G	4	3	7	1	6	2.0	0.0	2.0
chr19:57490144:T:A	3	0	3	3	0	1	1	0
chr19:57491596:G:C	68	21	93	51	42	1.0	1.0	0.0
chr19:57500053:G:T	69	34	111	39	72	2	1	0
chr19:57507480:A:G	19	10	33	9	24	2	0	2
chr19:57547168:A:G	15	6	21	9	12	1	1	0
chr19:57573562:G:A	30	16	48	16	32	2.0	0.0	2.0
chr19:57605855:T:A	17	4	24	14	10	1	1	0
chr19:58054063:C:T	0	0	0	0	0	0	0	0
chr19:58061591:G:A	167	67	249	105	144	1	1	0
chr19:58087303:C:T	4	3	7	1	6	2.0	0.0	2.0
chr19:58088681:C:T	343	177	550	177	373	2	1	2
chr19:58206902:G:A	121	56	190	68	122	1	1	0
chr19:58294717:T:C	19	12	31	7	24	2	0	2
chr19:58295307:G:A	23	14	37	9	28	2	0	2
chr19:58357114:G:T	1	0	1	1	0	1	1	0
chr19:58368293:T:C	39	19	59	21	38	2	1	0
chr19:58368649:G:C	39	19	59	21	38	2	1	0
chr19:58368817:T:C	38	18	57	21	36	1.5	1.0	0.0
chr19:58368875:T:C	37	18	56	20	36	2	1	0
chr19:58388099:A:G	16	4	20	12	8	1.0	1.0	0.0
chr19:58393029:G:A	4353	4261	101433	35004	66429	21	7	14
chr19:58394796:T:C	4366	4272	101195	35691	65504	21.0	7.0	14.0
chr19:58480271:C:T	42	29	72	14	58	2.0	0.0	2.0
chr19:58548362:G:A	49	29	80	20	60	2	0	2
chr20:276086:T:A	106	63	189	53	136	2.0	0.0	2.0
chr20:277092:A:G	108	60	182	55	127	2.0	0.0	2.0
chr20:648569:T:C	1	0	1	1	0	1	1	0
chr20:761203:A:G	0	0	0	0	0	0	0	0
chr20:765454:G:A	0	0	0	0	0	0	0	0
chr20:874297:T:C	0	0	0	0	0	0	0	0
chr20:1312345:C:T	20	9	32	12	20	1.5	1.0	0.0
chr20:1443658:G:A	612	336	1032	330	702	2.0	1.0	2.0
chr20:1445748:C:T	542	296	902	288	614	2.0	1.0	2.0
chr20:1477265:C:A	0	0	0	0	0	0	0	0
chr20:1551949:T:C	0	0	0	0	0	0	0	0
chr20:1566265:C:G	0	0	0	0	0	0	0	0
chr20:1570839:C:T	1	1	2	0	2	2	0	2
chr20:1571784:T:C	1	1	2	0	2	2	0	2
chr20:1619878:T:C	0	0	0	0	0	0	0	0
chr20:1630293:G:A	0	0	0	0	0	0	0	0
chr20:1635313:T:C	0	0	0	0	0	0	0	0
chr20:1635560:A:G	0	0	0	0	0	0	0	0
chr20:1636423:A:G	0	0	0	0	0	0	0	0
chr20:1649260:C:T	0	0	0	0	0	0	0	0
chr20:1937659:G:A	2	2	4	0	4	2.0	0.0	2.0
chr20:2207297:GC:TT	0	0	0	0	0	0	0	0
chr20:2340459:G:C	0	0	0	0	0	0	0	0
chr20:2394616:A:G	0	0	0	0	0	0	0	0
chr20:2417371:G:A	0	0	0	0	0	0	0	0
chr20:2432674:T:C	0	0	0	0	0	0	0	0
chr20:2470805:G:T	162	121	308	44	264	2.0	0.0	2.0
chr20:2558741:G:A	0	0	0	0	0	0	0	0
chr20:2610586:C:T	0	0	0	0	0	0	0	0
chr20:2613217:T:C	0	0	0	0	0	0	0	0
chr20:2641352:T:C	0	0	0	0	0	0	0	0
chr20:2656425:T:C	505	279	883	272	611	2	0	2
chr20:2815361:G:A	0	0	0	0	0	0	0	0
chr20:2816369:G:A	0	0	0	0	0	0	0	0
chr20:2836175:C:T	128	59	203	75	128	1.0	1.0	0.0
chr20:2860127:C:T	24	13	37	11	26	2.0	0.0	2.0
chr20:3044461:C:T	1	0	1	1	0	1	1	0
chr20:3166822:G:A	0	0	0	0	0	0	0	0
chr20:3190639:G:A	538	296	918	285	633	2.0	1.0	2.0
chr20:3213196:C:A	755	357	1285	503	782	2	1	0
chr20:3213332:G:A	781	381	1334	509	825	2	1	0
chr20:3218727:G:A	36	19	62	20	42	2.0	0.0	2.0
chr20:3223438:G:A	969	536	1850	618	1232	2	1	2
chr20:3223585:G:A	985	545	1898	639	1259	2	1	2
chr20:3230418:A:C	0	0	0	0	0	0	0	0
chr20:3233935:C:T	2	1	3	1	2	1.5	0.5	1.0
chr20:3237988:G:C	0	0	0	0	0	0	0	0
chr20:3252445:C:A	8	4	12	4	8	1.5	0.5	1.0
chr20:3252496:C:G	6	3	9	3	6	1.5	0.5	1.0
chr20:3381386:T:C	135	52	192	86	106	1	1	0
chr20:3644183:G:A	1	1	2	0	2	2	0	2
chr20:3660176:C:T	0	0	0	0	0	0	0	0
chr20:3671095:C:G	0	0	0	0	0	0	0	0
chr20:3671118:C:T	0	0	0	0	0	0	0	0
chr20:3673062:C:A	0	0	0	0	0	0	0	0
chr20:3674438:C:T	0	0	0	0	0	0	0	0
chr20:3751986:C:T	1	0	1	1	0	1	1	0
chr20:3857794:C:G	44	24	73	21	52	2.0	0.0	2.0
chr20:4725072:C:T	0	0	0	0	0	0	0	0
chr20:4725110:T:C	0	0	0	0	0	0	0	0
chr20:5773219:C:A	299	153	488	162	326	2	1	2
chr20:5863166:T:C	57	33	92	26	66	2	0	2
chr20:6084063:A:G	0	0	0	0	0	0	0	0
chr20:6085082:CTT:TTC	0	0	0	0	0	0	0	0
chr20:6119441:A:G	1	1	2	0	2	2	0	2
chr20:7982394:C:T	188	97	305	97	208	2.0	1.0	2.0
chr20:7999743:C:T	624	320	1043	369	674	2.0	1.0	2.0
chr20:8757087:G:A	0	0	0	0	0	0	0	0
chr20:8774596:T:C	0	0	0	0	0	0	0	0
chr20:9539362:C:T	0	0	0	0	0	0	0	0
chr20:9563034:C:T	0	0	0	0	0	0	0	0
chr20:10038445:A:G	10	10	20	0	20	2.0	0.0	2.0
chr20:10296804:A:C	0	0	0	0	0	0	0	0
chr20:10296973:C:T	0	0	0	0	0	0	0	0
chr20:10622678:A:G	63	27	95	39	56	1	1	0
chr20:10623102:G:A	64	27	96	40	56	1.0	1.0	0.0
chr20:10645156:T:G	1	1	2	0	2	2	0	2
chr20:13715033:C:T	50	23	75	27	48	1.0	1.0	0.0
chr20:13849533:G:A	0	0	0	0	0	0	0	0
chr20:14326307:G:T	0	0	0	0	0	0	0	0
chr20:16378922:A:G	13	8	21	5	16	2	0	2
chr20:16506053:G:A	9	4	13	5	8	1	1	0
chr20:16749877:T:C	0	0	0	0	0	0	0	0
chr20:17494323:T:C	0	0	0	0	0	0	0	0
chr20:17614084:G:A	114	42	164	80	84	1.0	1.0	0.0
chr20:17615510:C:A	176	81	274	104	170	1.0	1.0	0.0
chr20:17619712:G:A	153	94	259	65	194	2	0	2
chr20:18041718:G:T	2	2	4	0	4	2.0	0.0	2.0
chr20:18142378:T:C	224	119	362	114	248	2.0	0.0	2.0
chr20:18181837:C:G	15	11	26	4	22	2	0	2
chr20:18412668:C:G	18	11	32	8	24	2.0	0.0	2.0
chr20:18433712:A:G	4	4	8	0	8	2.0	0.0	2.0
chr20:19280979:G:A	0	0	0	0	0	0	0	0
chr20:19889694:G:A	0	0	0	0	0	0	0	0
chr20:20052354:T:C	315	153	497	175	322	2	1	0
chr20:20052493:T:A	3	3	6	0	6	2	0	2
chr20:20052598:A:T	2	1	3	1	2	1.5	0.5	1.0
chr20:20171818:A:C	0	0	0	0	0	0	0	0
chr20:20277314:C:T	0	0	0	0	0	0	0	0
chr20:21513546:C:T	0	0	0	0	0	0	0	0
chr20:23048087:G:A	0	0	0	0	0	0	0	0
chr20:23084572:G:A	0	0	0	0	0	0	0	0
chr20:24949449:G:A	203	119	476	163	313	2	1	2
chr20:24958954:G:C	216	122	530	177	353	2.0	1.0	2.0
chr20:25013653:C:T	17	10	27	7	20	2	0	2
chr20:25023069:A:C	11	9	20	3	17	2	0	2
chr20:25057848:G:T	90	41	131	50	81	1.0	1.0	0.0
chr20:25078806:C:T	0	0	0	0	0	0	0	0
chr20:25082079:C:A	0	0	0	0	0	0	0	0
chr20:25196219:G:C	9	6	16	4	12	2	0	2
chr20:25213313:G:A	19	6	26	14	12	1	1	0
chr20:25278370:G:T	14	6	21	9	12	1.5	1.0	0.0
chr20:25282133:G:A	5	3	8	2	6	2	0	2
chr20:25489208:A:G	0	0	0	0	0	0	0	0
chr20:30550231:G:A	0	0	0	0	0	0	0	0
chr20:30720026:G:A	0	0	0	0	0	0	0	0
chr20:31377211:T:C	0	0	0	0	0	0	0	0
chr20:31476528:A:G	0	0	0	0	0	0	0	0
chr20:31482436:C:A	0	0	0	0	0	0	0	0
chr20:31644870:G:A	0	0	0	0	0	0	0	0
chr20:31794512:A:G	2	0	2	2	0	1.0	1.0	0.0
chr20:31821649:T:C	0	0	0	0	0	0	0	0
chr20:31845549:C:T	0	0	0	0	0	0	0	0
chr20:31861522:C:G	2	0	2	2	0	1.0	1.0	0.0
chr20:31869936:C:T	0	0	0	0	0	0	0	0
chr20:32165467:T:C	49	27	81	23	58	2	0	2
chr20:32208016:T:C	121	66	194	58	136	2	0	2
chr20:32231047:C:T	15	5	20	10	10	1	1	0
chr20:32327658:T:C	4	2	6	2	4	1.5	0.5	1.0
chr20:32331380:A:G	6	4	12	2	10	2.0	0.0	2.0
chr20:32431221:C:T	18	10	30	8	22	2.0	0.0	2.0
chr20:32451579:G:A	0	0	0	0	0	0	0	0
chr20:32650825:C:T	2	2	4	0	4	2.0	0.0	2.0
chr20:32795432:G:A	0	0	0	0	0	0	0	0
chr20:32917383:C:T	0	0	0	0	0	0	0	0
chr20:33011091:G:T	0	0	0	0	0	0	0	0
chr20:33034277:G:A	0	0	0	0	0	0	0	0
chr20:33039485:A:G	0	0	0	0	0	0	0	0
chr20:33083793:A:G	0	0	0	0	0	0	0	0
chr20:33083857:T:C	0	0	0	0	0	0	0	0
chr20:33086040:A:G	0	0	0	0	0	0	0	0
chr20:33088998:A:C	0	0	0	0	0	0	0	0
chr20:33090728:T:C	0	0	0	0	0	0	0	0
chr20:33309748:G:C	0	0	0	0	0	0	0	0
chr20:34882891:C:T	75	35	119	45	74	2	1	0
chr20:34921720:C:T	1	1	2	0	2	2	0	2
chr20:34986962:T:C	0	0	0	0	0	0	0	0
chr20:34994152:G:A	5	5	10	0	10	2	0	2
chr20:34996486:C:T	0	0	0	0	0	0	0	0
chr20:34998390:C:T	0	0	0	0	0	0	0	0
chr20:34999395:G:C	0	0	0	0	0	0	0	0
chr20:35001304:G:A	6	4	10	2	8	2.0	0.0	2.0
chr20:35115804:C:T	234	111	356	130	226	1.0	1.0	0.0
chr20:35174686:C:T	5	4	9	1	8	2	0	2
chr20:35176829:C:G	22	8	30	14	16	1.0	1.0	0.0
chr20:35246905:G:A	2	0	2	2	0	1.0	1.0	0.0
chr20:35284508:G:C	59	33	97	29	68	2	0	2
chr20:35286917:C:T	0	0	0	0	0	0	0	0
chr20:35292343:T:A	0	0	0	0	0	0	0	0
chr20:35306660:A:G	0	0	0	0	0	0	0	0
chr20:35437976:G:A	0	0	0	0	0	0	0	0
chr20:35502691:G:A	11	3	14	8	6	1	1	0
chr20:35528453:T:C	0	0	0	0	0	0	0	0
chr20:35554899:T:G	13	6	20	8	12	2	1	0
chr20:36500348:G:A	224	96	338	139	199	1.0	1.0	0.0
chr20:36786365:C:T	2	1	3	1	2	1.5	0.5	1.0
chr20:36786502:G:T	2	1	3	1	2	1.5	0.5	1.0
chr20:36839310:G:A	3	1	4	2	2	1	1	0
chr20:37137934:A:G	4	2	6	2	4	1.5	0.5	1.0
chr20:37236651:C:T	866	463	1516	506	1010	2.0	1.0	2.0
chr20:38213354:T:C	0	0	0	0	0	0	0	0
chr20:38213512:G:A	0	0	0	0	0	0	0	0
chr20:38217336:C:T	0	0	0	0	0	0	0	0
chr20:38260619:T:G	0	0	0	0	0	0	0	0
chr20:38354288:C:A	0	0	0	0	0	0	0	0
chr20:38748496:C:T	61	27	90	34	56	1	1	0
chr20:38754997:T:C	49	23	72	26	46	1	1	0
chr20:38767477:A:G	31	11	42	20	22	1	1	0
chr20:39038539:C:T	17	14	33	3	30	2	0	2
chr20:41165849:G:A	1	1	2	0	2	2	0	2
chr20:41168825:T:C	5	1	6	4	2	1	1	0
chr20:43536082:T:C	0	0	0	0	0	0	0	0
chr20:43699999:T:C	3	1	4	2	2	1	1	0
chr20:44118589:C:T	0	0	0	0	0	0	0	0
chr20:44118614:G:A	0	0	0	0	0	0	0	0
chr20:44197289:C:T	557	292	956	315	641	2	1	2
chr20:44197710:A:C	497	257	836	283	553	2	1	2
chr20:44279349:T:C	1	1	2	0	2	2	0	2
chr20:44720094:C:A	0	0	0	0	0	0	0	0
chr20:44727515:C:T	0	0	0	0	0	0	0	0
chr20:44750129:A:G	0	0	0	0	0	0	0	0
chr20:44750813:T:C	0	0	0	0	0	0	0	0
chr20:45094986:T:C	1	1	2	0	2	2	0	2
chr20:45297933:C:T	0	0	0	0	0	0	0	0
chr20:45304523:T:C	0	0	0	0	0	0	0	0
chr20:45424352:G:A	224	124	357	105	252	2.0	0.0	2.0
chr20:45424429:T:C	4	3	7	1	6	2.0	0.0	2.0
chr20:45425709:T:C	238	127	381	119	262	2.0	0.0	2.0
chr20:45512691:A:G	0	0	0	0	0	0	0	0
chr20:45545784:G:A	0	0	0	0	0	0	0	0
chr20:45610102:T:G	0	0	0	0	0	0	0	0
chr20:45630910:G:A	0	0	0	0	0	0	0	0
chr20:45631034:G:T	0	0	0	0	0	0	0	0
chr20:45684762:G:A	0	0	0	0	0	0	0	0
chr20:45723981:G:A	0	0	0	0	0	0	0	0
chr20:45725733:G:A	0	0	0	0	0	0	0	0
chr20:45789004:A:G	0	0	0	0	0	0	0	0
chr20:45789036:G:C	0	0	0	0	0	0	0	0
chr20:45789925:A:G	0	0	0	0	0	0	0	0
chr20:45897980:G:T	6	4	10	2	8	2.0	0.0	2.0
chr20:46118343:T:C	587	369	1088	278	810	2	0	2
chr20:46186653:C:T	0	0	0	0	0	0	0	0
chr20:46566265:C:G	0	0	0	0	0	0	0	0
chr20:46575627:G:A	0	0	0	0	0	0	0	0
chr20:47089315:C:T	0	0	0	0	0	0	0	0
chr20:47736827:A:G	12	7	20	6	14	2.0	0.0	2.0
chr20:47736892:C:T	12	7	20	6	14	2.0	0.0	2.0
chr20:48636612:T:C	14	7	21	7	14	1.5	0.5	1.0
chr20:49640612:C:T	1	0	1	1	0	1	1	0
chr20:49642497:A:G	1	0	1	1	0	1	1	0
chr20:50129652:C:T	46	26	74	20	54	2.0	0.0	2.0
chr20:50278219:C:T	0	0	0	0	0	0	0	0
chr20:50278382:C:T	0	0	0	0	0	0	0	0
chr20:50579747:C:T	215	113	348	114	234	2	1	2
chr20:50593173:C:T	18	6	24	12	12	1.0	1.0	0.0
chr20:50597619:A:G	7	4	10	3	7	1	0	1
chr20:50750539:T:G	1	1	2	0	2	2	0	2
chr20:50891355:T:G	68	39	112	32	80	2.0	0.0	2.0
chr20:50959380:T:G	14	8	22	6	16	2.0	0.0	2.0
chr20:51004246:G:T	12	9	21	3	18	2.0	0.0	2.0
chr20:51004612:T:C	7	7	14	0	14	2	0	2
chr20:51004862:G:C	0	0	0	0	0	0	0	0
chr20:51524088:G:C	17	7	25	11	14	1	1	0
chr20:51790446:G:A	0	0	0	0	0	0	0	0
chr20:51790623:T:C	0	0	0	0	0	0	0	0
chr20:51790963:A:C	0	0	0	0	0	0	0	0
chr20:51791427:C:T	0	0	0	0	0	0	0	0
chr20:52152644:G:A	10	7	17	3	14	2.0	0.0	2.0
chr20:52152840:C:T	6	2	8	4	4	1.0	1.0	0.0
chr20:52153010:A:G	6	2	8	4	4	1.0	1.0	0.0
chr20:53185593:T:C	0	0	0	0	0	0	0	0
chr20:53576098:T:C	33	18	51	15	36	2	0	2
chr20:53576493:C:T	23	12	35	11	24	2	0	2
chr20:53576549:C:T	21	10	31	11	20	1	1	0
chr20:56386407:T:C	4	2	6	2	4	1.5	0.5	1.0
chr20:56386485:A:T	3	2	5	1	4	2	0	2
chr20:56437262:G:A	33	11	47	23	24	1	1	0
chr20:56634201:T:C	0	0	0	0	0	0	0	0
chr20:57173150:G:A	0	0	0	0	0	0	0	0
chr20:58470611:T:C	0	0	0	0	0	0	0	0
chr20:58470709:A:G	0	0	0	0	0	0	0	0
chr20:58715352:G:A	245	109	375	149	226	1	1	0
chr20:58903752:C:T	2034	1589	5546	903	4643	2.0	0.0	2.0
chr20:58909186:C:T	2271	1719	6372	1209	5163	2	0	2
chr20:58910757:C:T	3039	2280	10519	2633	7886	3	1	2
chr20:61934151:C:T	0	0	0	0	0	0	0	0
chr20:61936970:G:C	0	0	0	0	0	0	0	0
chr20:62193441:C:T	85	65	154	21	133	2	0	2
chr20:62197985:G:C	3	0	3	3	0	1	1	0
chr20:62200866:C:T	148	24	182	132	50	1.0	1.0	0.0
chr20:62201126:G:A	147	125	287	25	262	2	0	2
chr20:62281978:G:A	16	8	24	8	16	1.5	0.5	1.0
chr20:62291679:C:G	6	6	12	0	12	2.0	0.0	2.0
chr20:62308217:A:C	16	7	23	9	14	1.0	1.0	0.0
chr20:62309283:G:A	124	72	208	58	150	2.0	0.0	2.0
chr20:62310372:C:A	6	2	8	4	4	1.0	1.0	0.0
chr20:62312525:G:A	2	1	3	1	2	1.5	0.5	1.0
chr20:62320641:C:T	2	1	4	2	2	2.0	1.0	1.0
chr20:62322431:C:T	1	0	2	2	0	2	2	0
chr20:62322432:G:A	1	1	4	0	4	4	0	4
chr20:62322716:T:C	0	0	0	0	0	0	0	0
chr20:62324126:C:T	0	0	0	0	0	0	0	0
chr20:62324150:C:T	0	0	0	0	0	0	0	0
chr20:62328363:C:T	5	3	8	2	6	2	0	2
chr20:62338071:A:G	10	4	17	7	10	1.5	1.0	0.0
chr20:62345831:G:A	22	13	35	9	26	2.0	0.0	2.0
chr20:62352356:G:A	7	4	11	3	8	2	0	2
chr20:62362541:A:G	8	5	13	3	10	2.0	0.0	2.0
chr20:62387999:T:C	100	54	157	47	110	2.0	0.0	2.0
chr20:62393540:A:G	6	5	11	1	10	2.0	0.0	2.0
chr20:62410963:A:C	0	0	0	0	0	0	0	0
chr20:62412681:C:T	0	0	0	0	0	0	0	0
chr20:62414129:C:T	0	0	0	0	0	0	0	0
chr20:62464902:T:C	0	0	0	0	0	0	0	0
chr20:62465397:C:G	0	0	0	0	0	0	0	0
chr20:62465895:C:T	0	0	0	0	0	0	0	0
chr20:62565060:T:C	0	0	0	0	0	0	0	0
chr20:62570676:G:A	0	0	0	0	0	0	0	0
chr20:62570727:T:C	0	0	0	0	0	0	0	0
chr20:62888636:A:G	20	10	32	10	22	1.5	0.5	1.0
chr20:62896722:T:C	32	17	49	15	34	2.0	0.0	2.0
chr20:62896919:C:T	26	16	42	10	32	2.0	0.0	2.0
chr20:62896954:A:G	25	15	40	10	30	2	0	2
chr20:62956807:A:G	7	3	10	4	6	1	1	0
chr20:62964284:C:T	2	2	6	0	6	3.0	0.0	3.0
chr20:62967547:A:G	2	0	3	3	0	1.5	1.5	0.0
chr20:63202740:G:A	33	13	50	20	30	1	1	0
chr20:63203343:G:A	31	13	44	18	26	1	1	0
chr20:63236102:A:G	0	0	0	0	0	0	0	0
chr20:63247598:A:C	0	0	0	0	0	0	0	0
chr20:63248817:T:G	0	0	0	0	0	0	0	0
chr20:63249944:A:G	0	0	0	0	0	0	0	0
chr20:63276630:C:T	38	20	59	19	40	2.0	0.0	2.0
chr20:63286073:G:A	1	0	1	1	0	1	1	0
chr20:63286284:T:C	3	1	4	2	2	1	1	0
chr20:63319440:C:T	0	0	0	0	0	0	0	0
chr20:63325430:T:C	0	0	0	0	0	0	0	0
chr20:63328290:G:A	0	0	0	0	0	0	0	0
chr20:63349639:T:C	0	0	0	0	0	0	0	0
chr20:63350202:C:A	0	0	0	0	0	0	0	0
chr20:63350772:A:G	0	0	0	0	0	0	0	0
chr20:63356470:C:T	0	0	0	0	0	0	0	0
chr20:63359587:G:A	0	0	0	0	0	0	0	0
chr20:63359789:G:A	0	0	0	0	0	0	0	0
chr20:63690099:C:T	0	0	0	0	0	0	0	0
chr20:63975412:C:T	5	2	7	3	4	1	1	0
chr20:63975807:C:T	5	2	7	3	4	1	1	0
chr20:64033012:C:T	182	85	273	103	170	1.0	1.0	0.0
chr20:64036201:G:C	1	1	2	0	2	2	0	2
chr20:64072137:C:T	52	26	80	28	52	2.0	0.5	1.0
chr21:10413594:T:C	0	0	0	0	0	0	0	0
chr21:10516432:G:A	0	0	0	0	0	0	0	0
chr21:13384473:G:A	0	0	0	0	0	0	0	0
chr21:14109044:G:T	8	4	12	4	8	1.5	0.5	1.0
chr21:18341504:C:T	0	0	0	0	0	0	0	0
chr21:18383723:C:G	0	0	0	0	0	0	0	0
chr21:25724742:G:T	3	2	5	1	4	2	0	2
chr21:25725147:G:A	8	5	13	3	10	2.0	0.0	2.0
chr21:26844355:G:C	0	0	0	0	0	0	0	0
chr21:26844571:G:A	0	0	0	0	0	0	0	0
chr21:26924005:A:G	0	0	0	0	0	0	0	0
chr21:26930036:A:G	0	0	0	0	0	0	0	0
chr21:28960589:C:T	19	11	32	10	22	2	0	2
chr21:28969569:A:G	258	139	404	124	280	2.0	0.0	2.0
chr21:29073640:G:A	733	386	1284	438	846	2	1	2
chr21:29342455:T:C	82	40	128	44	84	1.5	1.0	0.0
chr21:30215475:A:G	0	0	0	0	0	0	0	0
chr21:30337373:G:A	0	0	0	0	0	0	0	0
chr21:30371809:A:T	0	0	0	0	0	0	0	0
chr21:30430450:G:A	0	0	0	0	0	0	0	0
chr21:30440454:C:A	0	0	0	0	0	0	0	0
chr21:30487358:G:A	0	0	0	0	0	0	0	0
chr21:30496968:T:C	0	0	0	0	0	0	0	0
chr21:30592597:A:C	0	0	0	0	0	0	0	0
chr21:30601197:T:A	0	0	0	0	0	0	0	0
chr21:30881194:A:T	0	0	0	0	0	0	0	0
chr21:31696624:C:A	22	10	33	13	20	1.5	1.0	0.0
chr21:31995875:T:C	0	0	0	0	0	0	0	0
chr21:31999227:T:G	0	0	0	0	0	0	0	0
chr21:32316554:A:G	17	9	26	8	18	2	0	2
chr21:32345568:G:A	3	1	4	2	2	1	1	0
chr21:32347091:A:G	2	1	3	1	2	1.5	0.5	1.0
chr21:32383454:G:A	28	12	41	17	24	1.0	1.0	0.0
chr21:32385638:A:T	36	16	55	23	32	2.0	1.0	0.0
chr21:32467787:C:T	0	0	0	0	0	0	0	0
chr21:32514821:G:A	0	0	0	0	0	0	0	0
chr21:32602012:G:A	29	17	50	12	38	2	0	2
chr21:33027093:A:G	1	0	1	1	0	1	1	0
chr21:33296442:A:G	317	148	497	182	315	1	1	0
chr21:33415005:A:G	1312	757	2737	889	1848	2.0	1.0	2.0
chr21:33465316:C:A	51	28	79	23	56	2	0	2
chr21:33511311:T:C	64	31	95	33	62	1.0	1.0	0.0
chr21:33551937:T:C	36	23	61	13	48	2.0	0.0	2.0
chr21:33553383:G:A	253	125	392	136	256	2	1	0
chr21:33553954:C:T	494	263	810	259	551	2.0	0.0	2.0
chr21:33573415:T:C	166	89	259	79	180	2.0	0.0	2.0
chr21:33575762:T:C	13	6	20	8	12	2	1	0
chr21:33888177:T:C	0	0	0	0	0	0	0	0
chr21:33909089:A:G	2291	1481	5735	1747	3988	2	1	2
chr21:34670280:C:G	0	0	0	0	0	0	0	0
chr21:34670285:G:A	0	0	0	0	0	0	0	0
chr21:34707992:C:T	0	0	0	0	0	0	0	0
chr21:36070429:C:T	10	2	14	10	4	1.0	1.0	0.0
chr21:36237273:T:C	7	3	11	5	6	2	1	0
chr21:36461009:C:T	0	0	0	0	0	0	0	0
chr21:36461453:G:A	0	0	0	0	0	0	0	0
chr21:36699688:A:G	0	0	0	0	0	0	0	0
chr21:36709262:T:G	0	0	0	0	0	0	0	0
chr21:36709277:C:G	0	0	0	0	0	0	0	0
chr21:36744739:G:A	1	1	2	0	2	2	0	2
chr21:36745204:C:T	1	1	2	0	2	2	0	2
chr21:37072590:A:G	54	30	87	27	60	2.0	0.0	2.0
chr21:37072695:A:G	42	26	71	19	52	2.0	0.0	2.0
chr21:37088188:T:A	1	1	2	0	2	2	0	2
chr21:37096658:A:G	8	2	10	6	4	1.0	1.0	0.0
chr21:37153056:T:C	124	55	190	74	116	1.0	1.0	0.0
chr21:37195708:G:C	114	64	193	53	140	2.0	0.0	2.0
chr21:37196007:C:T	135	69	221	69	152	2	0	2
chr21:37486636:G:A	20	7	27	13	14	1.0	1.0	0.0
chr21:37625399:G:A	0	0	0	0	0	0	0	0
chr21:38299554:G:A	0	0	0	0	0	0	0	0
chr21:39499884:T:C	15	12	27	3	24	2	0	2
chr21:39765572:A:G	0	0	0	0	0	0	0	0
chr21:39771013:G:A	0	0	0	0	0	0	0	0
chr21:39793535:C:A	0	0	0	0	0	0	0	0
chr21:41348652:G:A	0	0	0	0	0	0	0	0
chr21:41443734:A:T	105	47	159	61	98	1	1	0
chr21:41473456:A:G	0	0	0	0	0	0	0	0
chr21:41810915:A:G	7	3	10	4	6	1	1	0
chr21:41847151:C:T	49	24	74	26	48	2	1	0
chr21:41889082:A:G	8	3	11	5	6	1.0	1.0	0.0
chr21:41899071:T:C	3	2	5	1	4	2	0	2
chr21:41899105:C:T	3	2	5	1	4	2	0	2
chr21:41899315:C:T	3	2	5	1	4	2	0	2
chr21:41907684:C:T	11	4	15	7	8	1	1	0
chr21:41907747:A:G	10	6	16	4	12	2.0	0.0	2.0
chr21:41942159:C:T	53	21	77	33	44	1	1	0
chr21:42126399:G:A	0	0	0	0	0	0	0	0
chr21:42137449:T:A	0	0	0	0	0	0	0	0
chr21:42137626:G:A	0	0	0	0	0	0	0	0
chr21:42366497:G:A	0	0	0	0	0	0	0	0
chr21:42434957:A:C	0	0	0	0	0	0	0	0
chr21:42496229:G:A	2	0	2	2	0	1.0	1.0	0.0
chr21:42760333:C:T	0	0	0	0	0	0	0	0
chr21:42768375:T:A	0	0	0	0	0	0	0	0
chr21:42769056:T:C	0	0	0	0	0	0	0	0
chr21:42769062:A:C	0	0	0	0	0	0	0	0
chr21:42853748:G:A	91	63	159	29	130	2	0	2
chr21:42863464:C:T	88	29	123	63	60	1.0	1.0	0.0
chr21:42873634:C:G	90	62	157	29	128	2.0	0.0	2.0
chr21:43028653:G:C	2	2	4	0	4	2.0	0.0	2.0
chr21:43028665:G:A	2	2	4	0	4	2.0	0.0	2.0
chr21:43658154:C:T	1	1	2	0	2	2	0	2
chr21:43676325:G:A	375	178	576	214	362	1	1	0
chr21:43686905:T:G	272	145	445	137	308	2.0	0.5	2.0
chr21:43687681:T:C	49	24	74	27	47	2	1	0
chr21:43756077:T:C	118	75	201	48	153	2.0	0.0	2.0
chr21:43797678:T:C	94	48	149	51	98	2.0	1.0	2.0
chr21:43798048:T:C	96	48	151	53	98	2.0	1.0	1.0
chr21:43799643:T:C	97	49	153	53	100	2	1	2
chr21:43800602:A:G	99	51	157	53	104	2	1	2
chr21:44288394:C:T	0	0	0	0	0	0	0	0
chr21:44289685:C:T	0	0	0	0	0	0	0	0
chr21:44297667:T:C	2	1	3	1	2	1.5	0.5	1.0
chr21:44305832:A:G	2	1	3	1	2	1.5	0.5	1.0
chr21:44312233:C:T	47	26	75	21	54	2	0	2
chr21:44314028:G:A	3	2	5	1	4	2	0	2
chr21:44325099:C:G	2	2	4	0	4	2.0	0.0	2.0
chr21:44330463:C:A	33	6	40	28	12	1	1	0
chr21:44558708:G:A	0	0	0	0	0	0	0	0
chr21:44574966:G:C	0	0	0	0	0	0	0	0
chr21:44580521:C:T	0	0	0	0	0	0	0	0
chr21:44627501:C:T	0	0	0	0	0	0	0	0
chr21:44627716:A:G	0	0	0	0	0	0	0	0
chr21:44627940:C:T	0	0	0	0	0	0	0	0
chr21:44628008:G:T	0	0	0	0	0	0	0	0
chr21:44628054:T:C	0	0	0	0	0	0	0	0
chr21:44637476:T:A	0	0	0	0	0	0	0	0
chr21:44637889:G:A	0	0	0	0	0	0	0	0
chr21:44637945:T:G	0	0	0	0	0	0	0	0
chr21:44638041:C:T	0	0	0	0	0	0	0	0
chr21:44638143:C:T	0	0	0	0	0	0	0	0
chr21:44646847:C:T	0	0	0	0	0	0	0	0
chr21:44647263:C:T	0	0	0	0	0	0	0	0
chr21:44654285:A:G	0	0	0	0	0	0	0	0
chr21:44658029:A:G	0	0	0	0	0	0	0	0
chr21:44658303:T:C	0	0	0	0	0	0	0	0
chr21:44666460:A:G	0	0	0	0	0	0	0	0
chr21:44666801:GA:CG	0	0	0	0	0	0	0	0
chr21:44666840:GC:AT	0	0	0	0	0	0	0	0
chr21:44681773:C:T	0	0	0	0	0	0	0	0
chr21:44771341:C:A	385	198	632	207	425	2	1	2
chr21:44813948:G:C	9	6	15	3	12	2	0	2
chr21:44851545:T:C	60	26	90	36	54	1.0	1.0	0.0
chr21:44888885:C:T	4	2	6	2	4	1.5	0.5	1.0
chr21:44893527:G:T	5	2	7	3	4	1	1	0
chr21:44910713:C:T	0	0	0	0	0	0	0	0
chr21:44973175:C:T	0	0	0	0	0	0	0	0
chr21:45222053:G:A	0	0	0	0	0	0	0	0
chr21:45285706:G:A	92	48	144	46	98	2.0	0.0	2.0
chr21:45456646:G:A	0	0	0	0	0	0	0	0
chr21:45507575:A:G	0	0	0	0	0	0	0	0
chr21:45511195:G:A	0	0	0	0	0	0	0	0
chr21:45909438:T:C	6	6	12	0	12	2.0	0.0	2.0
chr21:45914381:T:C	0	0	0	0	0	0	0	0
chr21:45987448:C:T	0	0	0	0	0	0	0	0
chr21:45991017:T:C	0	0	0	0	0	0	0	0
chr21:46003595:C:T	0	0	0	0	0	0	0	0
chr21:46119046:G:A	0	0	0	0	0	0	0	0
chr21:46122138:C:T	0	0	0	0	0	0	0	0
chr21:46126166:G:A	0	0	0	0	0	0	0	0
chr21:46129596:G:C	0	0	0	0	0	0	0	0
chr21:46132471:C:T	0	0	0	0	0	0	0	0
chr21:46136879:C:T	2	0	2	2	0	1.0	1.0	0.0
chr21:46136968:G:A	2	0	2	2	0	1.0	1.0	0.0
chr21:46138638:G:A	1	0	1	1	0	1	1	0
chr21:46151931:C:T	0	0	0	0	0	0	0	0
chr21:46152330:G:A	0	0	0	0	0	0	0	0
chr21:46194555:A:C	3	2	5	1	4	2	0	2
chr21:46215262:T:C	6	2	8	4	4	1.0	1.0	0.0
chr21:46215713:C:G	6	2	8	4	4	1.0	1.0	0.0
chr21:46221786:G:T	2	0	2	2	0	1.0	1.0	0.0
chr21:46221880:C:T	7	1	8	6	2	1	1	0
chr21:46222695:G:A	6	1	7	5	2	1.0	1.0	0.0
chr21:46227468:T:A	14	5	20	10	10	1.0	1.0	0.0
chr21:46256797:G:A	30	21	51	9	42	2.0	0.0	2.0
chr21:46266025:A:G	9	5	15	5	10	2	0	2
chr21:46267230:G:A	8	5	13	3	10	2.0	0.0	2.0
chr21:46283735:G:A	18	10	30	8	22	2.0	0.0	2.0
chr21:46284982:G:A	98	46	152	56	96	1.5	1.0	0.0
chr21:46285323:T:C	129	65	204	68	136	2	1	2
chr21:46314745:G:A	10	6	16	4	12	2.0	0.0	2.0
chr21:46346736:G:A	1	0	1	1	0	1	1	0
chr21:46353189:C:A	32	17	49	15	34	2.0	0.0	2.0
chr21:46391357:C:T	7	5	12	2	10	2	0	2
chr21:46416739:C:T	1	1	2	0	2	2	0	2
chr21:46430570:G:C	3	0	3	3	0	1	1	0
chr21:46431839:A:G	3	0	3	3	0	1	1	0
chr21:46443816:G:A	6	4	10	2	8	2.0	0.0	2.0
chr21:46443844:A:C	6	2	8	4	4	1.0	1.0	0.0
chr21:46490610:A:G	45	19	64	26	38	1	1	0
chr21:46539779:G:A	15	5	20	10	10	1	1	0
chr21:46539785:C:T	15	5	20	10	10	1	1	0
chr21:46541798:G:A	15	8	23	7	16	2	0	2
chr21:46550668:G:A	9	2	11	7	4	1	1	0
chr21:46602317:C:G	1	0	1	1	0	1	1	0
chr21:46602462:C:A	0	0	0	0	0	0	0	0
chr22:16390407:A:G	0	0	0	0	0	0	0	0
chr22:16390737:A:G	0	0	0	0	0	0	0	0
chr22:16591593:A:G	0	0	0	0	0	0	0	0
chr22:16592176:A:G	0	0	0	0	0	0	0	0
chr22:16694664:G:A	0	0	0	0	0	0	0	0
chr22:16695138:G:T	0	0	0	0	0	0	0	0
chr22:16697294:T:C	0	0	0	0	0	0	0	0
chr22:16697314:G:A	0	0	0	0	0	0	0	0
chr22:16697323:A:G	0	0	0	0	0	0	0	0
chr22:16697442:G:T	0	0	0	0	0	0	0	0
chr22:16697711:G:A	0	0	0	0	0	0	0	0
chr22:16784304:G:A	0	0	0	0	0	0	0	0
chr22:16966101:C:T	0	0	0	0	0	0	0	0
chr22:17149596:C:A	124	50	175	75	100	1.0	1.0	0.0
chr22:17191614:T:A	1	0	1	1	0	1	1	0
chr22:17209540:C:G	224	117	359	116	243	2.0	0.0	2.0
chr22:17511820:G:A	0	0	0	0	0	0	0	0
chr22:17524315:G:A	0	0	0	0	0	0	0	0
chr22:17549561:C:T	0	0	0	0	0	0	0	0
chr22:17696093:C:T	0	0	0	0	0	0	0	0
chr22:17726847:A:G	23	10	35	13	22	1	1	0
chr22:17727154:C:T	17	10	28	8	20	2	0	2
chr22:17739497:A:G	1	0	1	1	0	1	1	0
chr22:17790697:G:A	4	3	7	1	6	2.0	0.0	2.0
chr22:18625125:T:C	0	0	0	0	0	0	0	0
chr22:18625145:A:G	0	0	0	0	0	0	0	0
chr22:18625154:G:A	0	0	0	0	0	0	0	0
chr22:18625183:T:C	0	0	0	0	0	0	0	0
chr22:18625200:C:T	0	0	0	0	0	0	0	0
chr22:19132032:C:T	0	0	0	0	0	0	0	0
chr22:19132173:C:T	0	0	0	0	0	0	0	0
chr22:19132238:C:T	0	0	0	0	0	0	0	0
chr22:19132425:G:A	0	0	0	0	0	0	0	0
chr22:19135152:C:T	62	30	93	33	60	1.5	1.0	0.0
chr22:19763250:T:C	0	0	0	0	0	0	0	0
chr22:19788842:G:A	123	74	211	51	160	2	0	2
chr22:19821335:C:T	82	32	120	54	66	1.0	1.0	0.0
chr22:19880248:C:T	54	29	83	25	58	2.0	0.0	2.0
chr22:19880695:A:G	50	25	75	25	50	1.5	0.5	1.0
chr22:19883574:C:G	2	2	4	0	4	2.0	0.0	2.0
chr22:19911314:A:G	7	4	11	3	8	2	0	2
chr22:19911363:C:T	7	4	11	3	8	2	0	2
chr22:19962712:C:T	894	488	1580	500	1080	2.0	1.0	2.0
chr22:19963748:G:A	911	492	1612	520	1092	2	1	2
chr22:19971950:C:T	2	1	3	1	2	1.5	0.5	1.0
chr22:19981448:G:A	0	0	0	0	0	0	0	0
chr22:19981552:A:G	0	0	0	0	0	0	0	0
chr22:19981583:A:G	0	0	0	0	0	0	0	0
chr22:20106740:C:T	1	0	1	1	0	1	1	0
chr22:20115227:C:T	2	0	2	2	0	1.0	1.0	0.0
chr22:20140031:A:G	0	0	0	0	0	0	0	0
chr22:20145449:A:G	51	26	79	27	52	2	0	2
chr22:20148740:G:A	0	0	0	0	0	0	0	0
chr22:20319733:G:A	680	315	1077	417	660	1.0	1.0	0.0
chr22:20400808:A:G	2	1	3	1	2	1.5	0.5	1.0
chr22:20407094:C:A	8	5	13	3	10	2.0	0.0	2.0
chr22:20574999:C:G	9	5	14	4	10	2	0	2
chr22:20586725:C:T	142	67	218	82	136	2.0	1.0	0.0
chr22:20667992:C:T	1	0	1	1	0	1	1	0
chr22:20670592:A:G	0	0	0	0	0	0	0	0
chr22:20707980:G:T	199	106	329	109	220	2	1	2
chr22:20710068:A:C	10	5	15	5	10	1.5	0.5	1.0
chr22:20710913:A:G	11	7	18	4	14	2	0	2
chr22:20733858:C:G	2	2	4	0	4	2.0	0.0	2.0
chr22:20787012:T:C	2	1	3	1	2	1.5	0.5	1.0
chr22:20813499:G:A	15	5	22	12	10	1	1	0
chr22:20859092:C:T	380	135	558	270	288	1.0	1.0	0.0
chr22:20859128:A:G	397	148	588	274	314	1	1	0
chr22:20870634:A:G	22	8	34	16	18	1.0	1.0	0.0
chr22:20974279:G:A	0	0	0	0	0	0	0	0
chr22:20977629:C:G	0	0	0	0	0	0	0	0
chr22:20980635:G:C	0	0	0	0	0	0	0	0
chr22:20980970:C:A	0	0	0	0	0	0	0	0
chr22:20983036:G:A	61	27	92	36	56	1	1	0
chr22:20990595:C:T	0	0	0	0	0	0	0	0
chr22:20990616:A:G	0	0	0	0	0	0	0	0
chr22:20990631:G:C	0	0	0	0	0	0	0	0
chr22:20992430:A:C	0	0	0	0	0	0	0	0
chr22:20992853:C:T	2	1	3	1	2	1.5	0.5	1.0
chr22:20996172:A:G	1	0	1	1	0	1	1	0
chr22:20996647:G:A	0	0	0	0	0	0	0	0
chr22:21015165:A:G	0	0	0	0	0	0	0	0
chr22:21018116:G:T	0	0	0	0	0	0	0	0
chr22:21031696:C:T	0	0	0	0	0	0	0	0
chr22:21695587:C:G	8	5	13	3	10	2.0	0.0	2.0
chr22:22245125:G:A	1	0	2	2	0	2	2	0
chr22:22245352:A:G	1	0	2	2	0	2	2	0
chr22:22245396:T:C	1	0	2	2	0	2	2	0
chr22:22487881:C:T	5	5	10	0	10	2	0	2
chr22:22488793:T:C	6	3	9	3	6	1.5	0.5	1.0
chr22:22550972:A:T	0	0	0	0	0	0	0	0
chr22:22556814:A:G	0	0	0	0	0	0	0	0
chr22:22556943:GA:AG	0	0	0	0	0	0	0	0
chr22:22633504:A:G	0	0	0	0	0	0	0	0
chr22:23059687:G:T	0	0	0	0	0	0	0	0
chr22:23285182:A:G	4	2	8	2	6	1.5	0.5	1.0
chr22:23290478:C:A	2	0	2	2	0	1.0	1.0	0.0
chr22:23312806:A:G	1	1	2	0	2	2	0	2
chr22:23315548:G:A	21	9	32	12	20	1	1	0
chr22:23632013:A:G	0	0	0	0	0	0	0	0
chr22:23693783:C:T	0	0	0	0	0	0	0	0
chr22:23695119:T:G	27	18	45	9	36	2	0	2
chr22:23696660:T:C	3	0	4	4	0	1	1	0
chr22:23743920:A:G	5	0	5	5	0	1	1	0
chr22:23764487:G:A	4	2	7	3	4	2.0	0.5	1.0
chr22:23780312:G:A	0	0	0	0	0	0	0	0
chr22:23816708:A:G	6	3	9	3	6	1.5	0.5	1.0
chr22:23825326:G:A	2046	1215	5057	1861	3196	2.0	1.0	2.0
chr22:23836945:G:A	138	42	198	110	88	1.0	1.0	0.0
chr22:23837537:G:C	7	5	12	2	10	2	0	2
chr22:23838262:C:T	24	6	32	18	14	1.0	1.0	0.0
chr22:23882468:GGCTC:AGCTA	306	163	508	158	350	2.0	0.0	2.0
chr22:23884055:A:G	3	1	4	2	2	1	1	0
chr22:23895034:C:G	479	301	934	234	700	2	0	2
chr22:24182997:G:A	0	0	0	0	0	0	0	0
chr22:24184929:C:T	2	2	4	0	4	2.0	0.0	2.0
chr22:24232940:G:A	0	0	0	0	0	0	0	0
chr22:24260886:T:C	0	0	0	0	0	0	0	0
chr22:24495387:A:T	1	0	1	1	0	1	1	0
chr22:24586237:G:A	4	2	7	3	4	1.5	1.0	1.0
chr22:24589774:C:A	2	1	3	1	2	1.5	0.5	1.0
chr22:24621069:C:T	3	1	4	2	2	1	1	0
chr22:24749504:A:G	0	0	0	0	0	0	0	0
chr22:24762359:A:G	0	0	0	0	0	0	0	0
chr22:25181721:G:A	0	0	0	0	0	0	0	0
chr22:25181766:T:C	0	0	0	0	0	0	0	0
chr22:25231637:G:A	0	0	0	0	0	0	0	0
chr22:25357264:G:A	130	65	200	66	134	2.0	0.5	1.0
chr22:25770044:C:A	0	0	0	0	0	0	0	0
chr22:25823638:G:A	0	0	0	0	0	0	0	0
chr22:26433948:T:C	38	13	54	26	28	1.0	1.0	0.0
chr22:26434350:G:A	41	15	59	27	32	1	1	0
chr22:26466075:G:A	3	0	3	3	0	1	1	0
chr22:26512467:C:T	112	40	156	76	80	1.0	1.0	0.0
chr22:27982363:C:T	7	1	8	6	2	1	1	0
chr22:29050623:A:C	9	5	14	4	10	2	0	2
chr22:29260400:G:T	24	10	37	15	22	1.0	1.0	0.0
chr22:29264007:T:C	11	5	16	6	10	1	1	0
chr22:29308135:C:T	0	0	0	0	0	0	0	0
chr22:29311966:A:T	0	0	0	0	0	0	0	0
chr22:29331877:C:T	67	32	99	35	64	1	1	0
chr22:29359899:T:C	127	57	190	73	117	1	1	0
chr22:29437650:C:G	0	0	0	0	0	0	0	0
chr22:29438777:A:G	0	0	0	0	0	0	0	0
chr22:29439071:T:C	0	0	0	0	0	0	0	0
chr22:29485839:C:T	1	1	2	0	2	2	0	2
chr22:29489484:C:T	0	0	0	0	0	0	0	0
chr22:29489872:T:C	0	0	0	0	0	0	0	0
chr22:29490054:A:C	0	0	0	0	0	0	0	0
chr22:29490424:A:G	0	0	0	0	0	0	0	0
chr22:29517283:C:T	41	13	55	29	26	1	1	0
chr22:29570094:C:T	1	0	1	1	0	1	1	0
chr22:29683224:T:C	1	0	1	1	0	1	1	0
chr22:29729607:C:T	0	0	0	0	0	0	0	0
chr22:29729631:G:A	0	0	0	0	0	0	0	0
chr22:29731378:G:T	2	2	4	0	4	2.0	0.0	2.0
chr22:29767537:A:G	2389	1570	6558	2071	4487	2	1	2
chr22:29822281:T:C	26	17	50	10	40	2.0	0.0	2.0
chr22:29825837:T:A	7	3	10	4	6	1	1	0
chr22:30003011:A:G	1	0	1	1	0	1	1	0
chr22:30009162:T:C	24	11	35	13	22	1.0	1.0	0.0
chr22:30016770:T:C	8	6	14	2	12	2.0	0.0	2.0
chr22:30018102:C:T	16	5	21	11	10	1.0	1.0	0.0
chr22:30022172:A:C	5	3	8	2	6	2	0	2
chr22:30287296:C:G	0	0	0	0	0	0	0	0
chr22:30292670:C:T	88	46	139	45	94	2.0	0.5	2.0
chr22:30304618:T:G	48	23	74	26	48	1.0	1.0	0.0
chr22:30337122:C:A	190	94	295	103	192	2.0	1.0	0.0
chr22:30356707:G:T	178	91	281	93	188	2.0	1.0	2.0
chr22:30365951:G:C	2	2	4	0	4	2.0	0.0	2.0
chr22:30366151:G:A	8	4	12	4	8	1.5	0.5	1.0
chr22:30369513:G:A	0	0	0	0	0	0	0	0
chr22:30371547:T:G	0	0	0	0	0	0	0	0
chr22:30371740:A:G	0	0	0	0	0	0	0	0
chr22:30371792:C:T	0	0	0	0	0	0	0	0
chr22:30373912:G:C	0	0	0	0	0	0	0	0
chr22:30373917:T:C	0	0	0	0	0	0	0	0
chr22:30374168:T:C	0	0	0	0	0	0	0	0
chr22:30375469:T:C	7	4	11	3	8	2	0	2
chr22:30376697:C:T	14	8	22	6	16	2.0	0.0	2.0
chr22:30379686:G:A	5	3	8	2	6	2	0	2
chr22:30380106:C:T	11	7	19	5	14	2	0	2
chr22:30386100:A:G	9	5	15	5	10	2	1	2
chr22:30397148:G:A	1	0	1	1	0	1	1	0
chr22:30427078:G:A	2	0	2	2	0	1.0	1.0	0.0
chr22:30427209:T:C	68	34	107	39	68	1.5	1.0	1.0
chr22:30461386:A:C	0	0	0	0	0	0	0	0
chr22:30461461:A:G	0	0	0	0	0	0	0	0
chr22:30468830:A:G	0	0	0	0	0	0	0	0
chr22:30468910:A:T	0	0	0	0	0	0	0	0
chr22:30524978:T:C	0	0	0	0	0	0	0	0
chr22:30557308:C:T	2	1	3	1	2	1.5	0.5	1.0
chr22:30579132:C:A	6	4	11	3	8	2.0	0.0	2.0
chr22:30615363:C:T	0	0	0	0	0	0	0	0
chr22:30617562:G:A	0	0	0	0	0	0	0	0
chr22:30626474:A:G	0	0	0	0	0	0	0	0
chr22:30636849:G:A	6	4	11	3	8	2.0	0.5	2.0
chr22:30636933:A:G	6	3	10	4	6	1.5	1.0	1.0
chr22:30694196:C:A	4	0	4	4	0	1.0	1.0	0.0
chr22:30906246:T:C	2	2	4	0	4	2.0	0.0	2.0
chr22:30937644:T:C	5	1	6	4	2	1	1	0
chr22:31095309:G:C	3	2	5	1	4	2	0	2
chr22:31101068:A:C	0	0	0	0	0	0	0	0
chr22:31101124:G:T	0	0	0	0	0	0	0	0
chr22:31105072:G:A	1398	741	2599	939	1660	2.0	1.0	2.0
chr22:31105802:T:C	44	24	69	21	48	2.0	0.0	2.0
chr22:31125864:A:C	0	0	0	0	0	0	0	0
chr22:31133477:C:A	0	0	0	0	0	0	0	0
chr22:31140147:A:C	0	0	0	0	0	0	0	0
chr22:31267856:C:G	10	5	15	5	10	1.5	0.5	1.0
chr22:31345081:G:A	8	2	10	6	4	1.0	1.0	0.0
chr22:31442099:G:A	10	7	17	3	14	2.0	0.0	2.0
chr22:31602626:G:A	14	9	23	5	18	2.0	0.0	2.0
chr22:31606308:T:C	26	16	43	11	32	2.0	0.0	2.0
chr22:32190867:C:T	0	0	0	0	0	0	0	0
chr22:32190888:GCAA:ACAG	0	0	0	0	0	0	0	0
chr22:32190939:T:C	0	0	0	0	0	0	0	0
chr22:32191036:CGTGG:GGTGC	0	0	0	0	0	0	0	0
chr22:32193036:C:T	0	0	0	0	0	0	0	0
chr22:32193047:T:C	0	0	0	0	0	0	0	0
chr22:32193103:C:T	0	0	0	0	0	0	0	0
chr22:32194462:G:A	0	0	0	0	0	0	0	0
chr22:32229223:C:T	0	0	0	0	0	0	0	0
chr22:32387917:T:C	426	231	701	215	486	2.0	0.0	2.0
chr22:32399654:C:T	358	186	570	188	382	2.0	1.0	2.0
chr22:32399764:A:G	14	7	22	8	14	1.5	1.0	1.0
chr22:32475378:G:A	486	263	823	259	564	2.0	1.0	2.0
chr22:32479203:G:A	332	169	534	176	358	2.0	1.0	2.0
chr22:32491011:T:C	4	3	7	1	6	2.0	0.0	2.0
chr22:32491163:C:T	299	147	479	169	310	2	1	0
chr22:33274598:G:A	0	0	0	0	0	0	0	0
chr22:35067232:C:T	0	0	0	0	0	0	0	0
chr22:35264882:G:T	430	210	700	250	450	2.0	1.0	0.0
chr22:35287245:T:C	7	5	14	2	12	2	0	2
chr22:35346932:T:G	121	47	176	80	96	1	1	0
chr22:35347131:G:C	133	48	188	90	98	1	1	0
chr22:35610998:G:A	0	0	0	0	0	0	0	0
chr22:35611028:C:T	0	0	0	0	0	0	0	0
chr22:36141715:C:T	43	11	54	32	22	1	1	0
chr22:36265284:G:A	15	13	28	2	26	2	0	2
chr22:36265600:G:A	14	12	26	2	24	2.0	0.0	2.0
chr22:36265796:G:A	9	7	16	2	14	2	0	2
chr22:36800827:G:A	0	0	0	0	0	0	0	0
chr22:36937752:A:G	1	0	1	1	0	1	1	0
chr22:37002154:C:T	0	0	0	0	0	0	0	0
chr22:37002160:C:A	0	0	0	0	0	0	0	0
chr22:37011023:C:T	129	36	184	104	80	1	1	0
chr22:37018427:T:G	122	91	233	37	196	2.0	0.0	2.0
chr22:37084229:A:G	0	0	0	0	0	0	0	0
chr22:37103346:C:T	0	0	0	0	0	0	0	0
chr22:37103652:A:G	0	0	0	0	0	0	0	0
chr22:37182174:T:C	21	7	31	15	16	1	1	0
chr22:37182539:C:T	16	4	20	12	8	1.0	1.0	0.0
chr22:37185382:G:C	14	10	24	4	20	2.0	0.0	2.0
chr22:37206563:C:T	1	0	1	1	0	1	1	0
chr22:37206982:G:A	3	2	5	1	4	2	0	2
chr22:37207012:C:T	3	2	5	1	4	2	0	2
chr22:37207351:C:T	2	1	3	1	2	1.5	0.5	1.0
chr22:37207705:C:T	3	2	6	2	4	2	0	2
chr22:37226775:A:G	1586	954	3764	1236	2528	2.0	1.0	2.0
chr22:37303336:T:C	38	13	53	27	26	1.0	1.0	0.0
chr22:37311921:C:T	1	0	1	1	0	1	1	0
chr22:37311963:T:C	1	0	1	1	0	1	1	0
chr22:37374590:G:A	1	1	2	0	2	2	0	2
chr22:37655992:C:T	310	146	489	179	310	1.0	1.0	0.0
chr22:37678427:G:A	21	8	36	14	22	1	1	0
chr22:37701352:C:G	9	5	14	4	10	2	0	2
chr22:37723206:G:A	3	0	3	3	0	1	1	0
chr22:37723862:G:A	0	0	0	0	0	0	0	0
chr22:37725145:C:A	2	2	4	0	4	2.0	0.0	2.0
chr22:37726115:T:C	0	0	0	0	0	0	0	0
chr22:37726441:C:T	0	0	0	0	0	0	0	0
chr22:37733325:G:A	0	0	0	0	0	0	0	0
chr22:37768099:C:T	33	18	51	15	36	2	0	2
chr22:37808082:C:T	15	4	19	11	8	1	1	0
chr22:37809982:T:C	2	2	4	0	4	2.0	0.0	2.0
chr22:37816755:A:G	13	5	19	9	10	1	1	0
chr22:37848209:C:T	65	28	94	38	56	1	1	0
chr22:37849434:C:T	994	533	1852	632	1220	2.0	1.0	2.0
chr22:37877742:T:C	1189	700	2294	716	1578	2	1	2
chr22:37886890:C:T	4	2	6	2	4	1.5	0.5	1.0
chr22:37927500:G:T	11	5	16	6	10	1	1	0
chr22:37945127:T:C	10	5	15	5	10	1.5	0.5	1.0
chr22:37973969:A:G	0	0	0	0	0	0	0	0
chr22:38067645:T:G	35	21	57	14	43	2	0	2
chr22:38071777:G:C	3	1	4	2	2	1	1	0
chr22:38078689:A:G	0	0	0	0	0	0	0	0
chr22:38081268:G:A	0	0	0	0	0	0	0	0
chr22:38081923:G:A	0	0	0	0	0	0	0	0
chr22:38427131:T:C	0	0	0	0	0	0	0	0
chr22:38481456:T:G	31	9	39	22	17	1	1	0
chr22:38493652:C:T	177	90	281	91	190	2	1	2
chr22:38668204:G:A	2	1	3	1	2	1.5	0.5	1.0
chr22:38670815:C:T	8	2	11	7	4	1.0	1.0	0.0
chr22:38673176:T:C	56	21	80	36	44	1.0	1.0	0.0
chr22:38738710:T:C	39	17	56	22	34	1	1	0
chr22:38985821:A:G	7	4	11	3	8	2	0	2
chr22:38985994:T:C	11	4	18	8	10	1	1	0
chr22:38986074:C:A	11	4	18	8	10	1	1	0
chr22:38991553:C:T	10	4	18	8	10	1.5	1.0	0.0
chr22:39032391:C:G	115	57	177	61	116	2	1	0
chr22:39044144:C:T	44	22	71	26	45	2.0	1.0	0.5
chr22:39045091:G:T	113	56	176	58	118	2	1	0
chr22:39045198:C:T	96	50	151	46	105	2.0	0.0	2.0
chr22:39049549:G:A	45	20	68	26	42	1	1	0
chr22:39052706:C:A	63	28	98	40	58	2	1	0
chr22:39052745:T:C	69	31	107	43	64	2	1	0
chr22:39081118:T:C	1545	943	3613	1213	2400	2	1	2
chr22:39102033:G:C	121	63	204	70	134	2	1	2
chr22:39103758:T:C	130	67	221	79	142	2.0	1.0	2.0
chr22:39134127:C:A	3	2	5	1	4	2	0	2
chr22:39313004:G:A	18	5	23	13	10	1.0	1.0	0.0
chr22:39313771:T:C	17	8	25	10	15	1	1	0
chr22:39314239:G:A	8	3	11	5	6	1.0	1.0	0.0
chr22:39318485:C:T	4377	4327	149697	48593	101104	33	10	22
chr22:39658943:T:C	0	0	0	0	0	0	0	0
chr22:39661268:T:C	0	0	0	0	0	0	0	0
chr22:39875610:C:G	0	0	0	0	0	0	0	0
chr22:39887423:A:G	0	0	0	0	0	0	0	0
chr22:40021567:G:A	0	0	0	0	0	0	0	0
chr22:40021776:C:T	0	0	0	0	0	0	0	0
chr22:40021816:A:G	0	0	0	0	0	0	0	0
chr22:40156115:G:A	1236	678	1548	737	811	1.0	1.0	1.0
chr22:40301373:A:G	9	4	15	5	10	1	1	0
chr22:40361224:A:C	5	3	8	2	6	2	0	2
chr22:40418496:T:C	10	3	13	7	6	1.0	1.0	0.0
chr22:40682015:C:T	0	0	0	0	0	0	0	0
chr22:41330049:G:A	61	33	94	28	66	2	0	2
chr22:41356743:G:A	3	3	6	0	6	2	0	2
chr22:41387655:C:T	5	4	9	1	8	2	0	2
chr22:41394175:G:A	5	1	6	4	2	1	1	0
chr22:41437112:C:T	89	43	140	50	90	1	1	0
chr22:41507809:A:C	160	65	230	98	132	1.0	1.0	0.0
chr22:41663764:G:T	825	446	1482	492	990	2	1	2
chr22:41693619:T:C	46	25	75	21	54	2.0	0.0	2.0
chr22:41694065:A:C	44	25	71	19	52	2.0	0.0	2.0
chr22:41763225:G:T	19	2	22	18	4	1	1	0
chr22:41781449:G:C	251	146	433	117	316	2	0	2
chr22:41794305:A:G	40	12	54	28	26	1.0	1.0	0.0
chr22:41825842:C:T	8	5	13	3	10	2.0	0.0	2.0
chr22:41880738:G:C	22	11	34	12	22	2.0	0.5	1.0
chr22:41905708:T:C	59	26	85	35	50	1	1	0
chr22:41938949:C:G	320	177	567	177	390	2.0	0.0	2.0
chr22:41945304:A:G	2	1	3	1	2	1.5	0.5	1.0
chr22:41947087:G:A	5	3	8	2	6	2	0	2
chr22:41996807:G:A	0	0	0	0	0	0	0	0
chr22:42027106:G:C	2	1	3	1	2	1.5	0.5	1.0
chr22:42061052:C:T	26	10	36	16	20	1.0	1.0	0.0
chr22:42067810:C:T	16	8	24	8	16	1.5	0.5	1.0
chr22:42077599:C:T	15	7	22	8	14	1	1	0
chr22:42078134:C:G	15	7	22	8	14	1	1	0
chr22:42079699:T:G	596	146	845	520	325	1.0	1.0	0.0
chr22:42090719:G:A	1333	738	2605	867	1738	2	1	2
chr22:42141587:G:A	5	3	8	2	6	2	0	2
chr22:42141618:TAC:CAG	5	3	8	2	6	2	0	2
chr22:42142019:G:A	6	3	9	3	6	1.5	0.5	1.0
chr22:42387064:G:A	0	0	0	0	0	0	0	0
chr22:42397867:A:G	6	4	10	2	8	2.0	0.0	2.0
chr22:42693049:G:C	0	0	0	0	0	0	0	0
chr22:43162920:A:G	2458	1661	7084	2247	4837	2.0	1.0	2.0
chr22:43162966:G:A	2462	1661	7093	2255	4838	2.0	1.0	2.0
chr22:43172506:C:T	4	3	7	1	6	2.0	0.0	2.0
chr22:43180874:C:A	13	6	19	7	12	1	1	0
chr22:43180898:G:A	13	7	20	6	14	2	0	2
chr22:43183043:T:C	9	3	12	6	6	1	1	0
chr22:43203911:T:C	0	0	0	0	0	0	0	0
chr22:43203985:C:T	0	0	0	0	0	0	0	0
chr22:43210137:C:T	0	0	0	0	0	0	0	0
chr22:43214100:C:T	0	0	0	0	0	0	0	0
chr22:43218310:C:G	0	0	0	0	0	0	0	0
chr22:43435076:C:T	0	0	0	0	0	0	0	0
chr22:43435136:C:T	0	0	0	0	0	0	0	0
chr22:43580516:G:A	0	0	0	0	0	0	0	0
chr22:43716965:C:T	2	1	3	1	2	1.5	0.5	1.0
chr22:43891749:G:A	0	0	0	0	0	0	0	0
chr22:43928847:CCCC:GCCT	0	0	0	0	0	0	0	0
chr22:44093988:T:C	105	65	197	55	142	2	0	2
chr22:44094016:T:C	106	65	198	56	142	2.0	0.0	2.0
chr22:44190642:C:T	626	368	1114	312	802	2.0	0.0	2.0
chr22:44198704:C:G	628	360	1109	327	782	2.0	0.0	2.0
chr22:44206349:A:C	645	314	1078	408	670	2	1	0
chr22:44679858:T:C	0	0	0	0	0	0	0	0
chr22:44825543:A:T	1	1	2	0	2	2	0	2
chr22:44859700:G:C	0	0	0	0	0	0	0	0
chr22:44859750:T:C	1	1	2	0	2	2	0	2
chr22:44859757:G:C	1	1	2	0	2	2	0	2
chr22:44862453:C:G	1	1	2	0	2	2	0	2
chr22:44862615:A:G	1	1	2	0	2	2	0	2
chr22:45171699:C:A	118	68	214	56	158	2.0	0.0	2.0
chr22:45181350:T:C	57	35	93	23	70	2	0	2
chr22:45287423:G:C	3	1	5	3	2	2	1	0
chr22:45355040:A:G	1	1	2	0	2	2	0	2
chr22:46248271:A:G	42	30	76	14	62	2.0	0.0	2.0
chr22:46256475:G:A	0	0	0	0	0	0	0	0
chr22:46256840:G:A	0	0	0	0	0	0	0	0
chr22:46257032:G:A	0	0	0	0	0	0	0	0
chr22:46257062:A:G	0	0	0	0	0	0	0	0
chr22:46258426:G:A	0	0	0	0	0	0	0	0
chr22:46259882:G:C	0	0	0	0	0	0	0	0
chr22:46260051:T:C	0	0	0	0	0	0	0	0
chr22:46260349:T:G	0	0	0	0	0	0	0	0
chr22:46260908:G:A	1	0	1	1	0	1	1	0
chr22:46261364:A:G	1	0	1	1	0	1	1	0
chr22:46261901:A:G	0	0	0	0	0	0	0	0
chr22:46287079:C:T	5	3	8	2	6	2	0	2
chr22:46289483:C:T	41	18	60	24	36	1	1	0
chr22:46308346:C:T	2	2	5	1	4	2.5	0.5	2.0
chr22:46308779:A:G	1	0	1	1	0	1	1	0
chr22:46313984:G:A	2	1	5	1	4	2.5	0.5	2.0
chr22:46316180:C:T	1	0	1	1	0	1	1	0
chr22:46323203:C:G	1	0	1	1	0	1	1	0
chr22:46335792:G:T	280	158	456	132	324	2.0	0.0	2.0
chr22:46335894:G:A	20	12	32	8	24	2.0	0.0	2.0
chr22:46353737:C:T	3	2	5	1	4	2	0	2
chr22:46356183:G:C	8	1	9	7	2	1.0	1.0	0.0
chr22:46364189:C:T	7	2	11	5	6	1	1	0
chr22:46364584:C:G	10	5	15	5	10	1.5	0.5	1.0
chr22:46365600:C:G	7	3	10	4	6	1	1	0
chr22:46381983:G:A	14	7	23	9	14	2.0	0.5	1.0
chr22:46384624:T:C	66	25	97	43	54	1.0	1.0	0.0
chr22:46389404:C:T	28	13	41	15	26	1.0	1.0	0.0
chr22:46390418:T:C	23	10	33	13	20	1	1	0
chr22:46391797:AGGA:GGGG	17	4	21	13	8	1	1	0
chr22:46409110:G:A	25	14	39	11	28	2	0	2
chr22:49962907:T:C	6	5	11	1	10	2.0	0.0	2.0
chr22:49963045:T:C	102	58	165	44	121	2.0	0.0	2.0
chr22:49963202:C:T	115	62	184	55	129	2	0	2
chr22:49997051:A:G	1	1	2	0	2	2	0	2
chr22:50041679:C:T	0	0	0	0	0	0	0	0
chr22:50061535:T:C	0	0	0	0	0	0	0	0
chr22:50061538:T:C	0	0	0	0	0	0	0	0
chr22:50076841:TGAG:CGAA	0	0	0	0	0	0	0	0
chr22:50077414:C:A	0	0	0	0	0	0	0	0
chr22:50090487:C:T	0	0	0	0	0	0	0	0
chr22:50117206:C:T	0	0	0	0	0	0	0	0
chr22:50120517:A:G	0	0	0	0	0	0	0	0
chr22:50145694:T:C	0	0	0	0	0	0	0	0
chr22:50161037:C:A	0	0	0	0	0	0	0	0
chr22:50179297:C:T	0	0	0	0	0	0	0	0
chr22:50194440:C:T	167	71	244	102	142	1	1	0
chr22:50221708:G:A	5	0	5	5	0	1	1	0
chr22:50226183:A:G	13	4	17	9	8	1	1	0
chr22:50245867:T:C	18	10	28	8	20	2.0	0.0	2.0
chr22:50249919:A:G	52	32	87	21	66	2.0	0.0	2.0
chr22:50250601:A:G	4	3	7	1	6	2.0	0.0	2.0
chr22:50255050:A:G	0	0	0	0	0	0	0	0
chr22:50255092:C:T	0	0	0	0	0	0	0	0
chr22:50255105:ACCCG:GCCCA	0	0	0	0	0	0	0	0
chr22:50255125:A:G	0	0	0	0	0	0	0	0
chr22:50255868:A:G	0	0	0	0	0	0	0	0
chr22:50256841:A:C	0	0	0	0	0	0	0	0
chr22:50277738:G:A	3	3	5	0	5	2	0	2
chr22:50278700:T:G	0	0	0	0	0	0	0	0
chr22:50280822:A:G	1	1	2	0	2	2	0	2
chr22:50281752:C:G	0	0	0	0	0	0	0	0
chr22:50282193:C:T	0	0	0	0	0	0	0	0
chr22:50283705:T:C	0	0	0	0	0	0	0	0
chr22:50435068:C:T	9	4	12	5	7	1	1	0
chr22:50439767:G:A	52	29	84	24	60	2.0	0.0	2.0
chr22:50447346:A:G	103	43	150	63	87	1	1	0
chr22:50455257:G:A	19	9	28	10	18	1	1	0
chr22:50489911:G:C	0	0	0	0	0	0	0	0
chr22:50503692:C:T	153	75	237	80	157	1	1	0
chr22:50504803:G:A	102	49	158	54	104	1.0	1.0	0.0
chr22:50505734:G:A	56	28	86	30	56	2.0	0.5	1.0
chr22:50523425:T:C	190	103	305	89	216	2.0	0.0	2.0
chr22:50523779:T:G	250	122	399	147	252	2.0	1.0	0.0
chr22:50524211:G:A	230	116	369	129	240	2.0	1.0	2.0
chr22:50524353:C:G	229	116	368	128	240	2	1	2
chr22:50528485:T:C	81	19	109	67	42	1	1	0
chr22:50549633:G:T	119	50	171	69	102	1	1	0
chr22:50549764:A:G	123	50	176	74	102	1	1	0
chr22:50571524:C:T	38	25	64	14	50	2.0	0.0	2.0
chr22:50576781:G:C	3	1	6	4	2	2	2	0
chr22:50582239:C:A	638	331	1051	359	692	2.0	1.0	2.0
chrX:284193:T:C	35	19	54	16	38	2	0	2
chrX:290695:C:T	34	20	56	14	42	2.0	0.0	2.0
chrX:334334:A:G	114	73	203	48	155	2.0	0.0	2.0
chrX:334362:C:T	112	72	203	47	156	2.0	0.0	2.0
chrX:334397:T:C	110	71	200	46	154	2.0	0.0	2.0
chrX:334496:A:G	109	70	196	46	150	2	0	2
chrX:338494:A:G	3	1	4	2	2	1	1	0
chrX:338625:GCA:ACG	86	52	149	39	110	2.0	0.0	2.0
chrX:338746:C:A	6	3	9	3	6	1.5	0.5	1.0
chrX:338856:A:G	71	45	125	31	94	2	0	2
chrX:341404:G:C	4	2	6	2	4	1.5	0.5	1.0
chrX:341798:A:G	4	2	6	2	4	1.5	0.5	1.0
chrX:345417:T:G	1	1	2	0	2	2	0	2
chrX:346642:C:T	0	0	0	0	0	0	0	0
chrX:361522:G:A	68	45	117	25	92	2.0	0.0	2.0
chrX:1190829:G:A	0	0	0	0	0	0	0	0
chrX:1190963:G:A	0	0	0	0	0	0	0	0
chrX:1191045:G:A	0	0	0	0	0	0	0	0
chrX:1348511:A:C	29	14	45	16	29	1	1	0
chrX:1412794:T:C	334	144	511	215	296	1.0	1.0	0.0
chrX:1412872:C:G	39	21	63	19	44	2	0	2
chrX:1412877:T:C	39	21	63	19	44	2	0	2
chrX:1412945:A:G	20	10	31	11	20	2.0	0.5	1.0
chrX:1418109:C:G	288	126	434	180	254	1.0	1.0	0.0
chrX:1418988:C:T	279	121	420	176	244	1	1	0
chrX:1427899:G:A	295	122	428	186	242	1	1	0
chrX:1427983:A:G	290	120	427	183	244	1.0	1.0	0.0
chrX:1435756:T:C	260	162	445	105	340	2.0	0.0	2.0
chrX:1442105:G:A	89	45	139	45	94	2	0	2
chrX:1599467:G:A	3	1	4	2	2	1	1	0
chrX:1601004:C:G	51	18	71	35	36	1	1	0
chrX:1615101:T:C	0	0	0	0	0	0	0	0
chrX:2221145:C:T	379	178	598	230	368	2	1	0
chrX:2221159:T:C	384	185	612	228	384	2.0	1.0	0.0
chrX:2243088:C:G	369	196	620	192	428	2	0	2
chrX:2425302:A:G	929	534	1696	501	1195	2	0	2
chrX:7843933:A:G	0	0	0	0	0	0	0	0
chrX:72572611:A:C	29	0	29	29	0	1	1	0
chrX:115190633:G:A	0	0	0	0	0	0	0	0
chrX:115190636:G:A	0	0	0	0	0	0	0	0
