Variant	Num_Cells	Total_Coverage	Ref_Count	Alt_Count	Median_Coverage	Median_Ref	Median_Alt
chr1:28150205:C:A	0	0	0	0	0	0	0
chr1:116398790:G:A	106	119	96	23	1.0	1.0	0.0
chr2:70088561:G:C	1479	2622	1271	1351	2	1	0
chr2:199911513:G:C	72	100	46	54	1.0	1.0	0.0
chr4:107908683:T:C	11	17	5	12	2	0	2
chr5:54518955:C:G	329	527	167	360	2	1	2
chr5:157361708:C:T	1	2	0	2	2	0	2
chr6:36978525:T:A	355	560	188	372	2	1	2
chr6:44260092:G:GAGTC	222	239	181	58	1.0	1.0	0.0
chr7:92671432:C:T	0	0	0	0	0	0	0
chr7:140781602:C:G	46	70	22	48	2.0	0.0	2.0
chr10:62813407:C:T	115	178	62	116	2	1	0
chr10:95860662:A:T	14	22	6	16	2.0	0.0	2.0
chr12:4613665:C:T	247	443	90	353	2	0	2
chr14:68790475:G:A	125	180	78	102	1	1	0
chr16:57113451:C:T	1	2	0	2	2	0	2
chr16:67656888:G:A	3	4	2	2	1	1	0
chr17:63827411:T:A	7	10	4	6	1	1	0
chr18:62147035:G:A	14	25	3	22	2.0	0.0	2.0
chr18:62147091:G:C	13	23	3	20	2	0	2
chr20:36916795:T:A	57	113	1	112	2	0	2
chr20:50749788:G:A	2	4	0	4	2.0	0.0	2.0
chr20:64016821:T:C	34	46	22	24	1.0	1.0	0.0
chrX:40072534:T:TG	48	48	3	45	1.0	0.0	1.0
chrX:101356176:C:G	253	497	40	457	2	0	2
